"","LSOA11NM","LSOA11CD","MSOA11CD","MSOA11NM","LAD11CD","LAD11NM","RGN11CD","RGN11NM","USUALRES","HHOLDRES","COMESTRES","POPDEN","HHOLDS","AVHHOLDSZ","LA.CODE","LA.NAME","X","IMD2007","INCOME2007","EMPLOYMENT2007","EDUCATION2007","IMD","Income","Employment","Education","dif_IMD","dif_income","dif_employ","dif_edu"
"971","City of London 001A","E01000001","E02000001","City of London 001","E09000001","City of London","E12000007","London",1465,1465,0,112.9,876,1.7,"00AA","City of London",NA,29006,32389,32371,30298,29111,32813,32716,32840,105,424,345,2542
"972","City of London 001B","E01000002","E02000001","City of London 001","E09000001","City of London","E12000007","London",1436,1436,0,62.9,830,1.7,"00AA","City of London",NA,31243,32410,32388,30171,28855,32780,32692,32836,-2388,370,304,2665
"973","City of London 001C","E01000003","E02000001","City of London 001","E09000001","City of London","E12000007","London",1346,1250,96,227.7,817,1.5,"00AA","City of London",NA,18799,19625,17867,25004,14621,17600,18133,22251,-4178,-2025,266,-2753
"974","City of London 001E","E01000005","E02000001","City of London 001","E09000001","City of London","E12000007","London",985,985,0,52,467,2.1,"00AA","City of London",NA,8162,3772,9524,14017,10285,7255,9641,17420,2123,3483,117,3403
"71","Barking and Dagenham 016A","E01000006","E02000017","Barking and Dagenham 016","E09000002","Barking and Dagenham","E12000007","London",1703,1699,4,116.2,543,3.1,"00AB","Barking and Dagenham",NA,13367,12586,18856,18749,12345,14190,16938,17806,-1022,1604,-1918,-943
"67","Barking and Dagenham 015A","E01000007","E02000016","Barking and Dagenham 015","E09000002","Barking and Dagenham","E12000007","London",1391,1391,0,69.6,612,2.3,"00AB","Barking and Dagenham",NA,4452,3961,9381,2757,3778,3337,4952,22384,-674,-624,-4429,19627
"68","Barking and Dagenham 015B","E01000008","E02000016","Barking and Dagenham 015","E09000002","Barking and Dagenham","E12000007","London",1544,1544,0,79.1,521,3,"00AB","Barking and Dagenham",NA,3291,1646,6564,6322,5028,3727,7233,9764,1737,2081,669,3442
"72","Barking and Dagenham 016B","E01000009","E02000017","Barking and Dagenham 016","E09000002","Barking and Dagenham","E12000007","London",1773,1773,0,138.6,638,2.8,"00AB","Barking and Dagenham",NA,7892,6612,10797,13873,6750,7136,10781,19103,-1142,524,-16,5230
"69","Barking and Dagenham 015C","E01000010","E02000016","Barking and Dagenham 015","E09000002","Barking and Dagenham","E12000007","London",2840,2840,0,80.7,1103,2.6,"00AB","Barking and Dagenham",NA,2913,2478,4868,8227,7796,8548,20399,18825,4883,6070,15531,10598
"73","Barking and Dagenham 016C","E01000011","E02000017","Barking and Dagenham 016","E09000002","Barking and Dagenham","E12000007","London",1634,1628,6,178.2,457,3.6,"00AB","Barking and Dagenham",NA,7492,3879,10933,14229,8209,8170,15348,13663,717,4291,4415,-566
"70","Barking and Dagenham 015D","E01000012","E02000016","Barking and Dagenham 015","E09000002","Barking and Dagenham","E12000007","London",1901,1895,6,136.8,698,2.7,"00AB","Barking and Dagenham",NA,5428,3174,9820,10607,5475,4886,12035,13286,47,1712,2215,2679
"57","Barking and Dagenham 013A","E01000013","E02000014","Barking and Dagenham 013","E09000002","Barking and Dagenham","E12000007","London",1660,1660,0,79.9,650,2.6,"00AB","Barking and Dagenham",NA,4324,5916,5782,2245,4416,5479,5910,8403,92,-437,128,6158
"58","Barking and Dagenham 013B","E01000014","E02000014","Barking and Dagenham 013","E09000002","Barking and Dagenham","E12000007","London",1656,1622,34,48.5,638,2.5,"00AB","Barking and Dagenham",NA,5603,5307,5329,3898,5014,5874,7634,6988,-589,567,2305,3090
"38","Barking and Dagenham 009A","E01000015","E02000010","Barking and Dagenham 009","E09000002","Barking and Dagenham","E12000007","London",2241,2241,0,79.9,836,2.7,"00AB","Barking and Dagenham",NA,5481,4284,6371,2316,4765,3588,6594,9297,-716,-696,223,6981
"39","Barking and Dagenham 009B","E01000016","E02000010","Barking and Dagenham 009","E09000002","Barking and Dagenham","E12000007","London",1637,1637,0,82.3,626,2.6,"00AB","Barking and Dagenham",NA,7400,6044,8700,4183,6446,5154,7129,8305,-954,-890,-1571,4122
"40","Barking and Dagenham 009C","E01000017","E02000010","Barking and Dagenham 009","E09000002","Barking and Dagenham","E12000007","London",1594,1594,0,100.6,609,2.6,"00AB","Barking and Dagenham",NA,6628,4669,6625,5992,4357,3642,4436,8614,-2271,-1027,-2189,2622
"41","Barking and Dagenham 009D","E01000018","E02000010","Barking and Dagenham 009","E09000002","Barking and Dagenham","E12000007","London",1597,1597,0,91.9,612,2.6,"00AB","Barking and Dagenham",NA,7112,5010,7987,5220,5631,4009,7042,7422,-1481,-1001,-945,2202
"105","Barking and Dagenham 023A","E01000019","E02006799","Barking and Dagenham 023","E09000002","Barking and Dagenham","E12000007","London",1407,1407,0,76.5,504,2.8,"00AB","Barking and Dagenham",NA,7386,7343,7127,7816,6307,4613,5950,9901,-1079,-2730,-1177,2085
"106","Barking and Dagenham 023B","E01000020","E02006799","Barking and Dagenham 023","E09000002","Barking and Dagenham","E12000007","London",1834,1773,61,98,650,2.7,"00AB","Barking and Dagenham",NA,5769,5546,7018,4907,6960,5974,7761,9672,1191,428,743,4765
"32","Barking and Dagenham 008A","E01000021","E02000009","Barking and Dagenham 008","E09000002","Barking and Dagenham","E12000007","London",1579,1579,0,93.3,593,2.7,"00AB","Barking and Dagenham",NA,6673,5329,10745,5553,4273,3978,6346,7746,-2400,-1351,-4399,2193
"33","Barking and Dagenham 008B","E01000022","E02000009","Barking and Dagenham 008","E09000002","Barking and Dagenham","E12000007","London",1314,1314,0,102.4,474,2.8,"00AB","Barking and Dagenham",NA,8106,5858,12993,5062,7478,7108,6947,8287,-628,1250,-6046,3225
"34","Barking and Dagenham 008C","E01000023","E02000009","Barking and Dagenham 008","E09000002","Barking and Dagenham","E12000007","London",1112,1112,0,53.7,500,2.2,"00AB","Barking and Dagenham",NA,9103,9881,15598,10742,4931,3447,10651,9077,-4172,-6434,-4947,-1665
"35","Barking and Dagenham 008D","E01000024","E02000009","Barking and Dagenham 008","E09000002","Barking and Dagenham","E12000007","London",1336,1325,11,103.9,456,2.9,"00AB","Barking and Dagenham",NA,8414,6954,10481,5941,7790,6690,9267,8242,-624,-264,-1214,2301
"36","Barking and Dagenham 008E","E01000025","E02000009","Barking and Dagenham 008","E09000002","Barking and Dagenham","E12000007","London",1609,1609,0,104.9,629,2.6,"00AB","Barking and Dagenham",NA,7514,6288,8272,3337,5772,5188,6574,8345,-1742,-1100,-1698,5008
"1","Barking and Dagenham 001A","E01000027","E02000002","Barking and Dagenham 001","E09000002","Barking and Dagenham","E12000007","London",1709,1688,21,11.6,641,2.6,"00AB","Barking and Dagenham",NA,2990,1987,5879,3155,3924,3530,6518,3828,934,1543,639,673
"2","Barking and Dagenham 001B","E01000028","E02000002","Barking and Dagenham 001","E09000002","Barking and Dagenham","E12000007","London",1549,1519,30,107.7,612,2.5,"00AB","Barking and Dagenham",NA,3656,1991,3629,4373,3617,2540,4211,9352,-39,549,582,4979
"3","Barking and Dagenham 001C","E01000029","E02000002","Barking and Dagenham 001","E09000002","Barking and Dagenham","E12000007","London",1602,1602,0,62.4,690,2.3,"00AB","Barking and Dagenham",NA,13953,14930,15815,11232,9890,13523,14189,14483,-4063,-1407,-1626,3251
"4","Barking and Dagenham 001D","E01000030","E02000002","Barking and Dagenham 001","E09000002","Barking and Dagenham","E12000007","London",1915,1915,0,66.9,770,2.5,"00AB","Barking and Dagenham",NA,2068,2228,4047,5666,4130,2853,6305,5743,2062,625,2258,77
"5","Barking and Dagenham 002A","E01000031","E02000003","Barking and Dagenham 002","E09000002","Barking and Dagenham","E12000007","London",1617,1617,0,19.2,598,2.7,"00AB","Barking and Dagenham",NA,10902,14101,12702,17382,10820,13154,12500,19106,-82,-947,-202,1724
"6","Barking and Dagenham 002B","E01000032","E02000003","Barking and Dagenham 002","E09000002","Barking and Dagenham","E12000007","London",1629,1629,0,43.4,631,2.6,"00AB","Barking and Dagenham",NA,8960,11231,12377,8822,8063,10212,10361,11620,-897,-1019,-2016,2798
"20","Barking and Dagenham 006A","E01000033","E02000007","Barking and Dagenham 006","E09000002","Barking and Dagenham","E12000007","London",1361,1361,0,93.7,533,2.6,"00AB","Barking and Dagenham",NA,4393,3417,5001,3642,4101,3477,4157,6261,-292,60,-844,2619
"11","Barking and Dagenham 003A","E01000034","E02000004","Barking and Dagenham 003","E09000002","Barking and Dagenham","E12000007","London",1444,1348,96,28.1,517,2.6,"00AB","Barking and Dagenham",NA,6714,4789,7326,6612,5459,4361,7056,7572,-1255,-428,-270,960
"43","Barking and Dagenham 010A","E01000035","E02000011","Barking and Dagenham 010","E09000002","Barking and Dagenham","E12000007","London",1610,1543,67,40.5,567,2.7,"00AB","Barking and Dagenham",NA,11084,12297,12997,10856,9728,8965,11546,12250,-1356,-3332,-1451,1394
"44","Barking and Dagenham 010B","E01000036","E02000011","Barking and Dagenham 010","E09000002","Barking and Dagenham","E12000007","London",1353,1353,0,32.3,469,2.9,"00AB","Barking and Dagenham",NA,13381,12229,16088,11238,13503,13220,15950,14656,122,991,-138,3418
"12","Barking and Dagenham 003B","E01000037","E02000004","Barking and Dagenham 003","E09000002","Barking and Dagenham","E12000007","London",1688,1547,141,72.3,579,2.7,"00AB","Barking and Dagenham",NA,11820,16761,7477,11303,14189,12774,8692,14137,2369,-3987,1215,2834
"13","Barking and Dagenham 003C","E01000038","E02000004","Barking and Dagenham 003","E09000002","Barking and Dagenham","E12000007","London",1447,1447,0,67.6,563,2.6,"00AB","Barking and Dagenham",NA,13110,13557,13726,9547,14938,13158,12448,14731,1828,-399,-1278,5184
"14","Barking and Dagenham 003D","E01000039","E02000004","Barking and Dagenham 003","E09000002","Barking and Dagenham","E12000007","London",1603,1595,8,10.5,659,2.4,"00AB","Barking and Dagenham",NA,14673,15007,20926,16365,11760,11851,14756,12295,-2913,-3156,-6170,-4070
"86","Barking and Dagenham 019A","E01000040","E02000020","Barking and Dagenham 019","E09000002","Barking and Dagenham","E12000007","London",1569,1569,0,91.9,640,2.5,"00AB","Barking and Dagenham",NA,4983,3794,5696,3647,6266,4744,5777,9773,1283,950,81,6126
"76","Barking and Dagenham 017A","E01000041","E02000018","Barking and Dagenham 017","E09000002","Barking and Dagenham","E12000007","London",1682,1682,0,110.2,607,2.8,"00AB","Barking and Dagenham",NA,7207,6334,9966,2921,6254,7487,8794,6004,-953,1153,-1172,3083
"77","Barking and Dagenham 017B","E01000042","E02000018","Barking and Dagenham 017","E09000002","Barking and Dagenham","E12000007","London",1788,1786,2,77.3,679,2.6,"00AB","Barking and Dagenham",NA,4698,3203,4544,8305,3446,2070,3127,7357,-1252,-1133,-1417,-948
"87","Barking and Dagenham 019B","E01000043","E02000020","Barking and Dagenham 019","E09000002","Barking and Dagenham","E12000007","London",1358,1356,2,51,461,2.9,"00AB","Barking and Dagenham",NA,9169,7190,12676,6198,6612,6127,8667,7784,-2557,-1063,-4009,1586
"74","Barking and Dagenham 016D","E01000044","E02000017","Barking and Dagenham 016","E09000002","Barking and Dagenham","E12000007","London",1798,1793,5,105.4,629,2.9,"00AB","Barking and Dagenham",NA,8084,7463,9886,10060,7728,8688,13483,12107,-356,1225,3597,2047
"78","Barking and Dagenham 017C","E01000045","E02000018","Barking and Dagenham 017","E09000002","Barking and Dagenham","E12000007","London",1650,1646,4,55.3,602,2.7,"00AB","Barking and Dagenham",NA,5380,5151,8679,3491,5172,4673,8662,9897,-208,-478,-17,6406
"79","Barking and Dagenham 017D","E01000046","E02000018","Barking and Dagenham 017","E09000002","Barking and Dagenham","E12000007","London",1779,1779,0,114.4,654,2.7,"00AB","Barking and Dagenham",NA,7879,6079,7174,8487,7720,6405,8972,8085,-159,326,1798,-402
"96","Barking and Dagenham 021B","E01000048","E02000022","Barking and Dagenham 021","E09000002","Barking and Dagenham","E12000007","London",1783,1783,0,275.6,644,2.8,"00AB","Barking and Dagenham",NA,682,147,1534,3619,2351,1149,2660,10440,1669,1002,1126,6821
"97","Barking and Dagenham 021C","E01000049","E02000022","Barking and Dagenham 021","E09000002","Barking and Dagenham","E12000007","London",1820,1820,0,85.8,643,2.8,"00AB","Barking and Dagenham",NA,2247,1035,4881,3593,4106,3191,7021,9141,1859,2156,2140,5548
"88","Barking and Dagenham 019C","E01000050","E02000020","Barking and Dagenham 019","E09000002","Barking and Dagenham","E12000007","London",1661,1661,0,120.6,615,2.7,"00AB","Barking and Dagenham",NA,7775,6709,8520,10546,5865,7662,10071,10451,-1910,953,1551,-95
"98","Barking and Dagenham 021D","E01000051","E02000022","Barking and Dagenham 021","E09000002","Barking and Dagenham","E12000007","London",1927,1927,0,288.9,725,2.7,"00AB","Barking and Dagenham",NA,1632,658,1769,4784,3733,2433,5289,8717,2101,1775,3520,3933
"89","Barking and Dagenham 019D","E01000052","E02000020","Barking and Dagenham 019","E09000002","Barking and Dagenham","E12000007","London",2014,2014,0,100.9,769,2.6,"00AB","Barking and Dagenham",NA,9055,7353,9777,9575,7488,6896,10831,9195,-1567,-457,1054,-380
"91","Barking and Dagenham 020A","E01000053","E02000021","Barking and Dagenham 020","E09000002","Barking and Dagenham","E12000007","London",1485,1484,1,82.1,645,2.3,"00AB","Barking and Dagenham",NA,6612,4017,7710,8894,3891,4018,6632,8961,-2721,1,-1078,67
"81","Barking and Dagenham 018A","E01000054","E02000019","Barking and Dagenham 018","E09000002","Barking and Dagenham","E12000007","London",1718,1718,0,100.4,638,2.7,"00AB","Barking and Dagenham",NA,6574,6748,5846,4066,7014,6398,10328,9906,440,-350,4482,5840
"82","Barking and Dagenham 018B","E01000055","E02000019","Barking and Dagenham 018","E09000002","Barking and Dagenham","E12000007","London",1553,1553,0,106.4,560,2.8,"00AB","Barking and Dagenham",NA,7250,5823,7321,5482,7078,6537,8517,8152,-172,714,1196,2670
"83","Barking and Dagenham 018C","E01000056","E02000019","Barking and Dagenham 018","E09000002","Barking and Dagenham","E12000007","London",1584,1542,42,65,573,2.7,"00AB","Barking and Dagenham",NA,5189,4077,6721,3429,3808,3992,5648,10164,-1381,-85,-1073,6735
"52","Barking and Dagenham 012A","E01000057","E02000013","Barking and Dagenham 012","E09000002","Barking and Dagenham","E12000007","London",1496,1496,0,101.3,537,2.8,"00AB","Barking and Dagenham",NA,5599,4944,7364,5338,4455,4634,5843,7312,-1144,-310,-1521,1974
"84","Barking and Dagenham 018D","E01000058","E02000019","Barking and Dagenham 018","E09000002","Barking and Dagenham","E12000007","London",1849,1849,0,101.5,690,2.7,"00AB","Barking and Dagenham",NA,5978,6055,6715,3288,7479,6160,8315,10286,1501,105,1600,6998
"59","Barking and Dagenham 013C","E01000059","E02000014","Barking and Dagenham 013","E09000002","Barking and Dagenham","E12000007","London",1582,1540,42,75.9,578,2.7,"00AB","Barking and Dagenham",NA,6382,5722,8366,5096,5047,4691,5457,9702,-1335,-1031,-2909,4606
"21","Barking and Dagenham 006B","E01000060","E02000007","Barking and Dagenham 006","E09000002","Barking and Dagenham","E12000007","London",1809,1809,0,32.9,770,2.3,"00AB","Barking and Dagenham",NA,4610,5170,3739,5849,4259,4136,5900,11765,-351,-1034,2161,5916
"22","Barking and Dagenham 006C","E01000061","E02000007","Barking and Dagenham 006","E09000002","Barking and Dagenham","E12000007","London",1776,1719,57,29.1,668,2.6,"00AB","Barking and Dagenham",NA,1082,388,2554,1752,1277,617,2356,4485,195,229,-198,2733
"23","Barking and Dagenham 006D","E01000062","E02000007","Barking and Dagenham 006","E09000002","Barking and Dagenham","E12000007","London",1952,1952,0,88.2,761,2.6,"00AB","Barking and Dagenham",NA,7594,6294,8275,9010,7633,7277,10782,7683,39,983,2507,-1327
"15","Barking and Dagenham 004A","E01000063","E02000005","Barking and Dagenham 004","E09000002","Barking and Dagenham","E12000007","London",1620,1620,0,89.4,635,2.6,"00AB","Barking and Dagenham",NA,7139,7862,6477,4291,6231,5926,7224,6523,-908,-1936,747,2232
"24","Barking and Dagenham 006E","E01000064","E02000007","Barking and Dagenham 006","E09000002","Barking and Dagenham","E12000007","London",1893,1831,62,90.7,709,2.6,"00AB","Barking and Dagenham",NA,6018,5384,7052,4847,6050,5762,7733,8146,32,378,681,3299
"25","Barking and Dagenham 007A","E01000065","E02000008","Barking and Dagenham 007","E09000002","Barking and Dagenham","E12000007","London",1736,1736,0,74.3,774,2.2,"00AB","Barking and Dagenham",NA,5453,5383,5486,4987,4604,4733,5327,9073,-849,-650,-159,4086
"47","Barking and Dagenham 011A","E01000066","E02000012","Barking and Dagenham 011","E09000002","Barking and Dagenham","E12000007","London",1928,1928,0,78.7,683,2.8,"00AB","Barking and Dagenham",NA,10036,10069,11294,14816,11307,12039,11912,13615,1271,1970,618,-1201
"48","Barking and Dagenham 011B","E01000067","E02000012","Barking and Dagenham 011","E09000002","Barking and Dagenham","E12000007","London",1969,1969,0,102.3,679,2.9,"00AB","Barking and Dagenham",NA,13231,11033,14231,14931,13473,11250,16419,15606,242,217,2188,675
"75","Barking and Dagenham 016E","E01000068","E02000017","Barking and Dagenham 016","E09000002","Barking and Dagenham","E12000007","London",1590,1575,15,46.8,462,3.4,"00AB","Barking and Dagenham",NA,11547,12530,15653,15226,10292,11550,15677,17504,-1255,-980,24,2278
"49","Barking and Dagenham 011C","E01000069","E02000012","Barking and Dagenham 011","E09000002","Barking and Dagenham","E12000007","London",1763,1756,7,87.9,513,3.4,"00AB","Barking and Dagenham",NA,18796,20887,17421,16346,17845,17702,18273,16557,-951,-3185,852,211
"50","Barking and Dagenham 011D","E01000070","E02000012","Barking and Dagenham 011","E09000002","Barking and Dagenham","E12000007","London",1975,1975,0,50.4,598,3.3,"00AB","Barking and Dagenham",NA,12665,16591,16991,18484,13517,13998,15265,17358,852,-2593,-1726,-1126
"51","Barking and Dagenham 011E","E01000071","E02000012","Barking and Dagenham 011","E09000002","Barking and Dagenham","E12000007","London",2253,2251,2,83.3,785,2.9,"00AB","Barking and Dagenham",NA,16406,13641,20843,17577,15618,12559,21513,16753,-788,-1082,670,-824
"80","Barking and Dagenham 017E","E01000072","E02000018","Barking and Dagenham 017","E09000002","Barking and Dagenham","E12000007","London",1991,1991,0,38.3,784,2.5,"00AB","Barking and Dagenham",NA,4886,3434,6921,5368,3339,4319,6679,6730,-1547,885,-242,1362
"53","Barking and Dagenham 012B","E01000073","E02000013","Barking and Dagenham 012","E09000002","Barking and Dagenham","E12000007","London",1619,1619,0,56.9,627,2.6,"00AB","Barking and Dagenham",NA,6630,5430,9366,2801,4652,5189,7138,5991,-1978,-241,-2228,3190
"54","Barking and Dagenham 012C","E01000074","E02000013","Barking and Dagenham 012","E09000002","Barking and Dagenham","E12000007","London",1567,1567,0,95.4,629,2.5,"00AB","Barking and Dagenham",NA,7297,5992,6722,6373,6035,5018,8350,8265,-1262,-974,1628,1892
"55","Barking and Dagenham 012D","E01000075","E02000013","Barking and Dagenham 012","E09000002","Barking and Dagenham","E12000007","London",1732,1732,0,33.5,622,2.8,"00AB","Barking and Dagenham",NA,6644,6517,7353,5345,4926,6152,8547,7489,-1718,-365,1194,2144
"56","Barking and Dagenham 012E","E01000076","E02000013","Barking and Dagenham 012","E09000002","Barking and Dagenham","E12000007","London",1988,1982,6,104.2,710,2.8,"00AB","Barking and Dagenham",NA,4598,3616,4807,2520,4787,5360,5072,5920,189,1744,265,3400
"37","Barking and Dagenham 008F","E01000077","E02000009","Barking and Dagenham 008","E09000002","Barking and Dagenham","E12000007","London",1445,1437,8,83.1,560,2.6,"00AB","Barking and Dagenham",NA,6565,5787,6903,4614,5549,5028,6213,7009,-1016,-759,-690,2395
"26","Barking and Dagenham 007B","E01000078","E02000008","Barking and Dagenham 007","E09000002","Barking and Dagenham","E12000007","London",1666,1666,0,94.8,649,2.6,"00AB","Barking and Dagenham",NA,5241,3849,6668,4072,5435,3847,8895,6840,194,-2,2227,2768
"42","Barking and Dagenham 009E","E01000079","E02000010","Barking and Dagenham 009","E09000002","Barking and Dagenham","E12000007","London",1546,1546,0,49.9,609,2.5,"00AB","Barking and Dagenham",NA,6922,6346,7428,5490,5302,5300,6830,8613,-1620,-1046,-598,3123
"27","Barking and Dagenham 007C","E01000080","E02000008","Barking and Dagenham 007","E09000002","Barking and Dagenham","E12000007","London",1556,1556,0,67.3,594,2.6,"00AB","Barking and Dagenham",NA,6329,5968,5764,6048,6505,5965,5991,10366,176,-3,227,4318
"28","Barking and Dagenham 007D","E01000081","E02000008","Barking and Dagenham 007","E09000002","Barking and Dagenham","E12000007","London",1688,1688,0,90.9,648,2.6,"00AB","Barking and Dagenham",NA,6873,8695,7197,3733,7418,8504,8765,7667,545,-191,1568,3934
"29","Barking and Dagenham 007E","E01000082","E02000008","Barking and Dagenham 007","E09000002","Barking and Dagenham","E12000007","London",1683,1678,5,104.7,672,2.5,"00AB","Barking and Dagenham",NA,5656,5577,5274,5875,7276,6810,7558,9573,1620,1233,2284,3698
"30","Barking and Dagenham 007F","E01000083","E02000008","Barking and Dagenham 007","E09000002","Barking and Dagenham","E12000007","London",1700,1700,0,94.5,629,2.7,"00AB","Barking and Dagenham",NA,6428,6060,6361,4234,5076,3503,6784,9411,-1352,-2557,423,5177
"60","Barking and Dagenham 013D","E01000084","E02000014","Barking and Dagenham 013","E09000002","Barking and Dagenham","E12000007","London",1355,1355,0,90.3,517,2.6,"00AB","Barking and Dagenham",NA,6378,7295,7909,3615,3973,3963,6766,4659,-2405,-3332,-1143,1044
"61","Barking and Dagenham 013E","E01000085","E02000014","Barking and Dagenham 013","E09000002","Barking and Dagenham","E12000007","London",1718,1711,7,118.2,640,2.7,"00AB","Barking and Dagenham",NA,4835,3971,5256,4076,4861,5601,6419,6408,26,1630,1163,2332
"62","Barking and Dagenham 013F","E01000086","E02000014","Barking and Dagenham 013","E09000002","Barking and Dagenham","E12000007","London",1431,1431,0,102.1,508,2.8,"00AB","Barking and Dagenham",NA,6664,8291,8611,2695,5157,5541,7176,9369,-1507,-2750,-1435,6674
"92","Barking and Dagenham 020B","E01000087","E02000021","Barking and Dagenham 020","E09000002","Barking and Dagenham","E12000007","London",1341,1341,0,36,503,2.7,"00AB","Barking and Dagenham",NA,5563,3507,4938,4495,6382,5611,7836,8192,819,2104,2898,3697
"93","Barking and Dagenham 020C","E01000088","E02000021","Barking and Dagenham 020","E09000002","Barking and Dagenham","E12000007","London",1828,1723,105,80.7,640,2.7,"00AB","Barking and Dagenham",NA,10998,8908,13899,8969,8154,8654,10305,10928,-2844,-254,-3594,1959
"94","Barking and Dagenham 020D","E01000089","E02000021","Barking and Dagenham 020","E09000002","Barking and Dagenham","E12000007","London",1666,1666,0,114.5,612,2.7,"00AB","Barking and Dagenham",NA,8266,5658,10704,6835,8433,7626,10848,10322,167,1968,144,3487
"95","Barking and Dagenham 020E","E01000090","E02000021","Barking and Dagenham 020","E09000002","Barking and Dagenham","E12000007","London",1584,1584,0,8.1,549,2.9,"00AB","Barking and Dagenham",NA,9660,9452,11621,7902,7920,7219,10934,12277,-1740,-2233,-687,4375
"101","Barking and Dagenham 022A","E01000091","E02000023","Barking and Dagenham 022","E09000002","Barking and Dagenham","E12000007","London",1714,1714,0,69.6,633,2.7,"00AB","Barking and Dagenham",NA,2582,3295,2393,3785,3389,2350,3992,5806,807,-945,1599,2021
"90","Barking and Dagenham 019E","E01000092","E02000020","Barking and Dagenham 019","E09000002","Barking and Dagenham","E12000007","London",2674,2674,0,10.1,975,2.7,"00AB","Barking and Dagenham",NA,7019,4615,10902,8432,7035,6683,9345,13681,16,2068,-1557,5249
"102","Barking and Dagenham 022B","E01000093","E02000023","Barking and Dagenham 022","E09000002","Barking and Dagenham","E12000007","London",1547,1547,0,52.7,642,2.4,"00AB","Barking and Dagenham",NA,2361,2372,2518,3391,3154,3200,3646,8216,793,828,1128,4825
"103","Barking and Dagenham 022C","E01000094","E02000023","Barking and Dagenham 022","E09000002","Barking and Dagenham","E12000007","London",1326,1326,0,22,517,2.6,"00AB","Barking and Dagenham",NA,4955,2787,10586,6416,7457,6676,13126,18085,2502,3889,2540,11669
"85","Barking and Dagenham 018E","E01000095","E02000019","Barking and Dagenham 018","E09000002","Barking and Dagenham","E12000007","London",1572,1572,0,6.9,549,2.9,"00AB","Barking and Dagenham",NA,5636,7026,12360,5607,5849,6882,10611,9163,213,-144,-1749,3556
"104","Barking and Dagenham 022D","E01000096","E02000023","Barking and Dagenham 022","E09000002","Barking and Dagenham","E12000007","London",1895,1895,0,31.5,639,3,"00AB","Barking and Dagenham",NA,1815,954,3985,3315,3362,1915,9695,7195,1547,961,5710,3880
"107","Barking and Dagenham 023C","E01000097","E02006799","Barking and Dagenham 023","E09000002","Barking and Dagenham","E12000007","London",1683,1683,0,93.9,708,2.4,"00AB","Barking and Dagenham",NA,5031,3427,6242,6238,4195,4089,6544,6985,-836,662,302,747
"108","Barking and Dagenham 023D","E01000098","E02006799","Barking and Dagenham 023","E09000002","Barking and Dagenham","E12000007","London",1746,1746,0,99.5,625,2.8,"00AB","Barking and Dagenham",NA,5629,4759,6057,6899,4995,5043,6051,7282,-634,284,-6,383
"109","Barking and Dagenham 023E","E01000099","E02006799","Barking and Dagenham 023","E09000002","Barking and Dagenham","E12000007","London",1732,1732,0,55.9,666,2.6,"00AB","Barking and Dagenham",NA,5581,6383,6244,4033,7206,5933,9106,10066,1625,-450,2862,6033
"16","Barking and Dagenham 004B","E01000100","E02000005","Barking and Dagenham 004","E09000002","Barking and Dagenham","E12000007","London",1653,1653,0,78.2,615,2.7,"00AB","Barking and Dagenham",NA,6436,6835,5967,5208,6169,5158,6444,9266,-267,-1677,477,4058
"17","Barking and Dagenham 004C","E01000101","E02000005","Barking and Dagenham 004","E09000002","Barking and Dagenham","E12000007","London",1513,1513,0,92.3,567,2.7,"00AB","Barking and Dagenham",NA,5507,5066,6768,4235,4595,3880,6722,9243,-912,-1186,-46,5008
"31","Barking and Dagenham 007G","E01000102","E02000008","Barking and Dagenham 007","E09000002","Barking and Dagenham","E12000007","London",1540,1540,0,60.9,625,2.5,"00AB","Barking and Dagenham",NA,6073,3975,8494,6686,5112,3791,6735,10005,-961,-184,-1759,3319
"63","Barking and Dagenham 014A","E01000103","E02000015","Barking and Dagenham 014","E09000002","Barking and Dagenham","E12000007","London",1685,1685,0,24,600,2.8,"00AB","Barking and Dagenham",NA,5055,4151,9035,5625,4288,3259,7519,5718,-767,-892,-1516,93
"64","Barking and Dagenham 014B","E01000104","E02000015","Barking and Dagenham 014","E09000002","Barking and Dagenham","E12000007","London",1781,1781,0,80.9,739,2.4,"00AB","Barking and Dagenham",NA,2264,2433,2382,2440,5227,3255,4434,8194,2963,822,2052,5754
"65","Barking and Dagenham 014C","E01000105","E02000015","Barking and Dagenham 014","E09000002","Barking and Dagenham","E12000007","London",2129,2115,14,96.4,915,2.3,"00AB","Barking and Dagenham",NA,3665,1838,3296,6029,2811,2889,4043,5925,-854,1051,747,-104
"66","Barking and Dagenham 014D","E01000106","E02000015","Barking and Dagenham 014","E09000002","Barking and Dagenham","E12000007","London",1968,1968,0,89.7,916,2.1,"00AB","Barking and Dagenham",NA,2655,2639,3864,4715,2931,2750,3885,8576,276,111,21,3861
"45","Barking and Dagenham 010C","E01000107","E02000011","Barking and Dagenham 010","E09000002","Barking and Dagenham","E12000007","London",1666,1632,34,31.1,601,2.7,"00AB","Barking and Dagenham",NA,10531,9888,12555,9145,9750,10407,9789,10603,-781,519,-2766,1458
"46","Barking and Dagenham 010D","E01000108","E02000011","Barking and Dagenham 010","E09000002","Barking and Dagenham","E12000007","London",1558,1558,0,64.4,652,2.4,"00AB","Barking and Dagenham",NA,10810,13724,13367,9564,9214,9298,12921,12169,-1596,-4426,-446,2605
"18","Barking and Dagenham 004D","E01000109","E02000005","Barking and Dagenham 004","E09000002","Barking and Dagenham","E12000007","London",1686,1686,0,44.9,608,2.8,"00AB","Barking and Dagenham",NA,10316,9692,12889,8742,8906,10039,11792,10842,-1410,347,-1097,2100
"7","Barking and Dagenham 002C","E01000110","E02000003","Barking and Dagenham 002","E09000002","Barking and Dagenham","E12000007","London",1416,1404,12,72.8,501,2.8,"00AB","Barking and Dagenham",NA,17082,16467,17232,16437,17370,16258,17201,18125,288,-209,-31,1688
"8","Barking and Dagenham 002D","E01000111","E02000003","Barking and Dagenham 002","E09000002","Barking and Dagenham","E12000007","London",1833,1833,0,61.8,732,2.5,"00AB","Barking and Dagenham",NA,9667,8957,10181,9041,7738,5953,11428,11590,-1929,-3004,1247,2549
"9","Barking and Dagenham 002E","E01000112","E02000003","Barking and Dagenham 002","E09000002","Barking and Dagenham","E12000007","London",1871,1871,0,67.4,739,2.5,"00AB","Barking and Dagenham",NA,10096,10637,16915,12270,11942,12009,16652,16096,1846,1372,-263,3826
"10","Barking and Dagenham 002F","E01000113","E02000003","Barking and Dagenham 002","E09000002","Barking and Dagenham","E12000007","London",1679,1679,0,109.1,633,2.7,"00AB","Barking and Dagenham",NA,12764,14346,20271,13857,9911,8599,13014,18300,-2853,-5747,-7257,4443
"19","Barking and Dagenham 004E","E01000114","E02000005","Barking and Dagenham 004","E09000002","Barking and Dagenham","E12000007","London",2090,2090,0,81.6,758,2.8,"00AB","Barking and Dagenham",NA,10978,10263,14147,8718,9844,9388,13915,13121,-1134,-875,-232,4403
"152","Barnet 009A","E01000115","E02000032","Barnet 009","E09000003","Barnet","E12000007","London",1484,1460,24,54.2,485,3,"00AC","Barnet",NA,25396,27771,29756,29919,30400,29064,28385,29091,5004,1293,-1371,-828
"153","Barnet 009B","E01000116","E02000032","Barnet 009","E09000003","Barnet","E12000007","London",1718,1718,0,70.1,623,2.8,"00AC","Barnet",NA,19989,17215,24315,27375,24596,19962,23492,29131,4607,2747,-823,1756
"157","Barnet 010A","E01000117","E02000033","Barnet 010","E09000003","Barnet","E12000007","London",1819,1819,0,54.9,762,2.4,"00AC","Barnet",NA,20490,23594,20554,27032,22710,20318,22452,26038,2220,-3276,1898,-994
"158","Barnet 010B","E01000118","E02000033","Barnet 010","E09000003","Barnet","E12000007","London",1936,1936,0,67.8,709,2.7,"00AC","Barnet",NA,17462,16373,20317,25097,22055,18410,20448,23685,4593,2037,131,-1412
"154","Barnet 009C","E01000119","E02000032","Barnet 009","E09000003","Barnet","E12000007","London",1680,1680,0,42.3,607,2.8,"00AC","Barnet",NA,16296,22649,26338,30716,21099,19433,25005,29197,4803,-3216,-1333,-1519
"155","Barnet 009D","E01000120","E02000032","Barnet 009","E09000003","Barnet","E12000007","London",1504,1504,0,61.4,505,3,"00AC","Barnet",NA,21439,21169,23191,28946,25648,21658,24283,28321,4209,489,1092,-625
"159","Barnet 010C","E01000121","E02000033","Barnet 010","E09000003","Barnet","E12000007","London",1497,1398,99,39.8,501,2.8,"00AC","Barnet",NA,4380,1884,4003,14810,4855,2857,4119,10610,475,973,116,-4200
"156","Barnet 009E","E01000122","E02000032","Barnet 009","E09000003","Barnet","E12000007","London",1471,1463,8,62.3,522,2.8,"00AC","Barnet",NA,18419,21666,24079,31209,24198,21192,24079,30124,5779,-474,0,-1085
"160","Barnet 010D","E01000123","E02000033","Barnet 010","E09000003","Barnet","E12000007","London",1664,1664,0,31.6,685,2.4,"00AC","Barnet",NA,15685,15799,19133,27409,21596,18051,23515,23107,5911,2252,4382,-4302
"161","Barnet 010E","E01000124","E02000033","Barnet 010","E09000003","Barnet","E12000007","London",1621,1621,0,63.4,660,2.5,"00AC","Barnet",NA,8157,7825,7851,22512,10554,8569,10425,19689,2397,744,2574,-2823
"229","Barnet 024A","E01000125","E02000047","Barnet 024","E09000003","Barnet","E12000007","London",2779,2690,89,90.3,1015,2.7,"00AC","Barnet",NA,4086,1675,4785,17064,7128,5756,12520,9365,3042,4081,7735,-7699
"240","Barnet 026A","E01000126","E02000049","Barnet 026","E09000003","Barnet","E12000007","London",2162,2162,0,134,726,3,"00AC","Barnet",NA,3515,597,5740,19795,5985,4081,7230,17894,2470,3484,1490,-1901
"230","Barnet 024B","E01000127","E02000047","Barnet 024","E09000003","Barnet","E12000007","London",1505,1505,0,75,514,2.9,"00AC","Barnet",NA,7488,4875,9717,15294,8137,5290,7553,12218,649,415,-2164,-3076
"231","Barnet 024C","E01000128","E02000047","Barnet 024","E09000003","Barnet","E12000007","London",1869,1869,0,75.7,624,3,"00AC","Barnet",NA,8729,4305,11179,16066,9830,7709,14220,10156,1101,3404,3041,-5910
"232","Barnet 024D","E01000129","E02000047","Barnet 024","E09000003","Barnet","E12000007","London",1782,1715,67,103.7,624,2.7,"00AC","Barnet",NA,4578,2865,7143,15129,5326,5171,10703,8969,748,2306,3560,-6160
"214","Barnet 021A","E01000130","E02000044","Barnet 021","E09000003","Barnet","E12000007","London",1603,1603,0,93.6,570,2.8,"00AC","Barnet",NA,7053,5128,9337,16901,6783,5736,8412,14069,-270,608,-925,-2832
"233","Barnet 024E","E01000131","E02000047","Barnet 024","E09000003","Barnet","E12000007","London",1806,1796,10,53.7,634,2.8,"00AC","Barnet",NA,10911,8330,14691,24848,13367,16357,17187,18372,2456,8027,2496,-6476
"215","Barnet 021B","E01000132","E02000044","Barnet 021","E09000003","Barnet","E12000007","London",1478,1478,0,96.3,495,3,"00AC","Barnet",NA,7500,3932,10140,10326,9373,7070,10977,11978,1873,3138,837,1652
"216","Barnet 021C","E01000133","E02000044","Barnet 021","E09000003","Barnet","E12000007","London",1601,1601,0,102.9,565,2.8,"00AC","Barnet",NA,5990,3521,5409,12439,5930,5482,4873,9308,-60,1961,-536,-3131
"234","Barnet 024F","E01000134","E02000047","Barnet 024","E09000003","Barnet","E12000007","London",1632,1632,0,102.4,625,2.6,"00AC","Barnet",NA,7619,5958,13256,16826,10908,6651,11732,15641,3289,693,-1524,-1185
"305","Barnet 038A","E01000135","E02000061","Barnet 038","E09000003","Barnet","E12000007","London",1564,1493,71,47.3,541,2.8,"00AC","Barnet",NA,20747,25505,28359,29763,20498,20163,23538,28897,-249,-5342,-4821,-866
"306","Barnet 038B","E01000136","E02000061","Barnet 038","E09000003","Barnet","E12000007","London",1532,1466,66,29.4,563,2.6,"00AC","Barnet",NA,22091,26694,31311,31230,24951,29508,31952,28513,2860,2814,641,-2717
"318","Barnet 041A","E01000137","E02000064","Barnet 041","E09000003","Barnet","E12000007","London",1729,1644,85,140.8,669,2.5,"00AC","Barnet",NA,6482,3810,8559,14415,7050,4883,7931,22213,568,1073,-628,7798
"314","Barnet 040A","E01000138","E02000063","Barnet 040","E09000003","Barnet","E12000007","London",1449,1449,0,55.4,523,2.8,"00AC","Barnet",NA,14392,14440,22436,24907,8122,7731,8498,23631,-6270,-6709,-13938,-1276
"319","Barnet 041B","E01000139","E02000064","Barnet 041","E09000003","Barnet","E12000007","London",1429,1427,2,40.7,560,2.5,"00AC","Barnet",NA,16907,20949,24636,28366,20124,16954,27088,29202,3217,-3995,2452,836
"320","Barnet 041C","E01000140","E02000064","Barnet 041","E09000003","Barnet","E12000007","London",1631,1606,25,111.6,683,2.4,"00AC","Barnet",NA,13411,14741,18401,22884,16180,14091,21004,22471,2769,-650,2603,-413
"310","Barnet 039A","E01000141","E02000062","Barnet 039","E09000003","Barnet","E12000007","London",2104,2081,23,56.8,864,2.4,"00AC","Barnet",NA,5534,6910,10393,26321,6489,9051,14016,20362,955,2141,3623,-5959
"315","Barnet 040B","E01000142","E02000063","Barnet 040","E09000003","Barnet","E12000007","London",2381,2296,85,119.4,950,2.4,"00AC","Barnet",NA,11492,8117,11603,24590,13777,10630,15822,24022,2285,2513,4219,-568
"321","Barnet 041D","E01000143","E02000064","Barnet 041","E09000003","Barnet","E12000007","London",1459,1339,120,83.6,538,2.5,"00AC","Barnet",NA,5742,5623,6871,22513,6313,4650,6455,14668,571,-973,-416,-7845
"307","Barnet 038C","E01000144","E02000061","Barnet 038","E09000003","Barnet","E12000007","London",1538,1538,0,77.6,607,2.5,"00AC","Barnet",NA,17876,26137,31238,24488,13510,17365,17845,28053,-4366,-8772,-13393,3565
"299","Barnet 037A","E01000145","E02000060","Barnet 037","E09000003","Barnet","E12000007","London",1517,1473,44,73.2,444,3.3,"00AC","Barnet",NA,21986,20089,30266,31111,19850,17787,25029,29415,-2136,-2302,-5237,-1696
"308","Barnet 038D","E01000146","E02000061","Barnet 038","E09000003","Barnet","E12000007","London",1716,1715,1,83.1,744,2.3,"00AC","Barnet",NA,15820,24544,24659,29148,15838,20146,20212,29981,18,-4398,-4447,833
"262","Barnet 030A","E01000147","E02000053","Barnet 030","E09000003","Barnet","E12000007","London",1734,1732,2,85.7,544,3.2,"00AC","Barnet",NA,16776,13012,19616,28967,21580,21599,28903,22518,4804,8587,9287,-6449
"263","Barnet 030B","E01000148","E02000053","Barnet 030","E09000003","Barnet","E12000007","London",1873,1858,15,80,725,2.6,"00AC","Barnet",NA,7294,6518,7489,21915,7872,6462,9051,14574,578,-56,1562,-7341
"293","Barnet 036A","E01000150","E02000059","Barnet 036","E09000003","Barnet","E12000007","London",2060,2056,4,44.3,744,2.8,"00AC","Barnet",NA,10676,8277,13707,25753,15001,12915,19386,21808,4325,4638,5679,-3945
"241","Barnet 026B","E01000151","E02000049","Barnet 026","E09000003","Barnet","E12000007","London",1711,1711,0,120.3,617,2.8,"00AC","Barnet",NA,2788,1692,3550,13556,3941,1651,5879,16218,1153,-41,2329,2662
"242","Barnet 026C","E01000152","E02000049","Barnet 026","E09000003","Barnet","E12000007","London",1729,1729,0,93.5,564,3.1,"00AC","Barnet",NA,4044,1103,6349,17769,4920,2766,7797,10326,876,1663,1448,-7443
"243","Barnet 026D","E01000153","E02000049","Barnet 026","E09000003","Barnet","E12000007","London",1541,1541,0,93.4,620,2.5,"00AC","Barnet",NA,2480,1359,2461,13691,2623,2000,3906,7323,143,641,1445,-6368
"244","Barnet 026E","E01000154","E02000049","Barnet 026","E09000003","Barnet","E12000007","London",1360,1360,0,100.8,501,2.7,"00AC","Barnet",NA,2517,1070,4612,16405,5921,5196,7899,9748,3404,4126,3287,-6657
"264","Barnet 030D","E01000155","E02000053","Barnet 030","E09000003","Barnet","E12000007","London",1880,1880,0,64.7,797,2.4,"00AC","Barnet",NA,9906,8653,11562,28354,12242,11720,17547,15872,2336,3067,5985,-12482
"219","Barnet 022A","E01000156","E02000045","Barnet 022","E09000003","Barnet","E12000007","London",1875,1875,0,104.2,751,2.5,"00AC","Barnet",NA,13038,14823,13342,29111,22939,18636,26099,30758,9901,3813,12757,1647
"220","Barnet 022B","E01000157","E02000045","Barnet 022","E09000003","Barnet","E12000007","London",1541,1541,0,122.4,689,2.2,"00AC","Barnet",NA,13951,10497,20020,26356,16514,13897,20137,21375,2563,3400,117,-4981
"184","Barnet 015A","E01000158","E02000038","Barnet 015","E09000003","Barnet","E12000007","London",1470,1455,15,54.4,564,2.6,"00AC","Barnet",NA,10952,11598,9595,26438,14236,12900,13358,22422,3284,1302,3763,-4016
"185","Barnet 015B","E01000159","E02000038","Barnet 015","E09000003","Barnet","E12000007","London",1777,1777,0,36,645,2.8,"00AC","Barnet",NA,11711,10152,15301,27987,15037,13828,14956,27157,3326,3676,-345,-830
"186","Barnet 015C","E01000160","E02000038","Barnet 015","E09000003","Barnet","E12000007","London",2061,2037,24,68.1,923,2.2,"00AC","Barnet",NA,16373,15558,17425,27484,19439,17502,25156,20371,3066,1944,7731,-7113
"187","Barnet 015D","E01000161","E02000038","Barnet 015","E09000003","Barnet","E12000007","London",1821,1752,69,75.1,710,2.5,"00AC","Barnet",NA,14421,13419,18149,28728,16911,16147,24109,27412,2490,2728,5960,-1316
"188","Barnet 015E","E01000162","E02000038","Barnet 015","E09000003","Barnet","E12000007","London",1599,1502,97,87.7,552,2.7,"00AC","Barnet",NA,12335,9624,15381,27128,12265,11274,14481,21740,-70,1650,-900,-5388
"221","Barnet 022C","E01000163","E02000045","Barnet 022","E09000003","Barnet","E12000007","London",1558,1547,11,81.4,759,2,"00AC","Barnet",NA,5517,3523,4260,20431,6907,5081,5546,20416,1390,1558,1286,-15
"222","Barnet 022D","E01000164","E02000045","Barnet 022","E09000003","Barnet","E12000007","London",1686,1686,0,30.8,648,2.6,"00AC","Barnet",NA,6495,4990,8716,21177,8339,7386,10285,19943,1844,2396,1569,-1234
"223","Barnet 022E","E01000165","E02000045","Barnet 022","E09000003","Barnet","E12000007","London",1862,1862,0,100.5,707,2.6,"00AC","Barnet",NA,17307,17225,24212,28329,17898,16188,24601,27606,591,-1037,389,-723
"122","Barnet 003A","E01000166","E02000026","Barnet 003","E09000003","Barnet","E12000007","London",1582,1582,0,42.8,648,2.4,"00AC","Barnet",NA,16253,12065,18151,23641,17440,12264,14816,24189,1187,199,-3335,548
"117","Barnet 002A","E01000167","E02000025","Barnet 002","E09000003","Barnet","E12000007","London",1307,1307,0,21.7,522,2.5,"00AC","Barnet",NA,9706,8416,12299,11671,9176,7762,7498,11661,-530,-654,-4801,-10
"123","Barnet 003B","E01000168","E02000026","Barnet 003","E09000003","Barnet","E12000007","London",1564,1559,5,49.8,576,2.7,"00AC","Barnet",NA,25399,24448,22216,30829,28143,23830,25782,29003,2744,-618,3566,-1826
"124","Barnet 003C","E01000169","E02000026","Barnet 003","E09000003","Barnet","E12000007","London",1490,1485,5,62.5,670,2.2,"00AC","Barnet",NA,17974,19458,17135,29227,20396,18230,17613,27288,2422,-1228,478,-1939
"136","Barnet 006A","E01000170","E02000029","Barnet 006","E09000003","Barnet","E12000007","London",1636,1626,10,55.2,656,2.5,"00AC","Barnet",NA,12505,13317,12823,19566,12869,8072,9319,19990,364,-5245,-3504,424
"137","Barnet 006B","E01000171","E02000029","Barnet 006","E09000003","Barnet","E12000007","London",1849,1849,0,55.5,856,2.2,"00AC","Barnet",NA,12133,9638,15787,26253,10104,7538,11986,21534,-2029,-2100,-3801,-4719
"125","Barnet 003D","E01000172","E02000026","Barnet 003","E09000003","Barnet","E12000007","London",1677,1650,27,30.8,602,2.7,"00AC","Barnet",NA,19391,14237,26221,29241,24913,19179,27154,30703,5522,4942,933,1462
"138","Barnet 006C","E01000173","E02000029","Barnet 006","E09000003","Barnet","E12000007","London",1719,1719,0,47,617,2.8,"00AC","Barnet",NA,18649,21053,26341,26750,24782,17800,21936,26368,6133,-3253,-4405,-382
"139","Barnet 006D","E01000174","E02000029","Barnet 006","E09000003","Barnet","E12000007","London",1728,1728,0,91.7,766,2.3,"00AC","Barnet",NA,13924,11521,18793,24318,15295,11814,14307,22557,1371,293,-4486,-1761
"140","Barnet 006E","E01000175","E02000029","Barnet 006","E09000003","Barnet","E12000007","London",1585,1585,0,31.6,618,2.6,"00AC","Barnet",NA,20986,20567,27634,28653,24745,21932,22117,30365,3759,1365,-5517,1712
"245","Barnet 027A","E01000176","E02000050","Barnet 027","E09000003","Barnet","E12000007","London",1613,1605,8,73.4,698,2.3,"00AC","Barnet",NA,7517,5419,7200,19595,7785,4317,7871,14031,268,-1102,671,-5564
"256","Barnet 029A","E01000177","E02000052","Barnet 029","E09000003","Barnet","E12000007","London",1628,1628,0,96.5,690,2.4,"00AC","Barnet",NA,17815,19113,25025,31777,25912,23761,30123,29618,8097,4648,5098,-2159
"246","Barnet 027B","E01000178","E02000050","Barnet 027","E09000003","Barnet","E12000007","London",1791,1791,0,42.9,695,2.6,"00AC","Barnet",NA,15084,18136,16066,32256,22875,19114,23767,31914,7791,978,7701,-342
"257","Barnet 029B","E01000179","E02000052","Barnet 029","E09000003","Barnet","E12000007","London",1614,1614,0,112.2,763,2.1,"00AC","Barnet",NA,15953,19891,24749,31657,25603,23106,27864,31175,9650,3215,3115,-482
"258","Barnet 029C","E01000180","E02000052","Barnet 029","E09000003","Barnet","E12000007","London",1607,1607,0,94.1,689,2.3,"00AC","Barnet",NA,13536,8938,15875,26990,17416,12554,16947,22665,3880,3616,1072,-4325
"259","Barnet 029D","E01000181","E02000052","Barnet 029","E09000003","Barnet","E12000007","London",1711,1711,0,119.6,669,2.6,"00AC","Barnet",NA,16531,19586,19664,30756,26085,25993,29021,32658,9554,6407,9357,1902
"260","Barnet 029E","E01000182","E02000052","Barnet 029","E09000003","Barnet","E12000007","London",1691,1691,0,77.1,746,2.3,"00AC","Barnet",NA,20305,24206,24128,32244,25290,26474,28153,32734,4985,2268,4025,490
"277","Barnet 033A","E01000183","E02000056","Barnet 033","E09000003","Barnet","E12000007","London",1473,1392,81,63.7,584,2.4,"00AC","Barnet",NA,17522,17553,21812,30650,22849,19322,27159,31460,5327,1769,5347,810
"247","Barnet 027C","E01000184","E02000050","Barnet 027","E09000003","Barnet","E12000007","London",1414,1414,0,20.6,503,2.8,"00AC","Barnet",NA,5469,3099,6226,15677,6367,4143,5567,9752,898,1044,-659,-5925
"261","Barnet 029F","E01000185","E02000052","Barnet 029","E09000003","Barnet","E12000007","London",1447,1447,0,117.1,606,2.4,"00AC","Barnet",NA,2820,1774,3496,13515,6780,4340,6533,13553,3960,2566,3037,38
"178","Barnet 014A","E01000186","E02000037","Barnet 014","E09000003","Barnet","E12000007","London",1612,1612,0,63.2,501,3.2,"00AC","Barnet",NA,25274,26003,28948,31028,30395,27203,31367,29857,5121,1200,2419,-1171
"179","Barnet 014B","E01000187","E02000037","Barnet 014","E09000003","Barnet","E12000007","London",1657,1657,0,76.8,593,2.8,"00AC","Barnet",NA,15392,9464,19731,25089,18602,10696,20955,22274,3210,1232,1224,-2815
"180","Barnet 014C","E01000188","E02000037","Barnet 014","E09000003","Barnet","E12000007","London",1554,1554,0,4.9,516,3,"00AC","Barnet",NA,20517,23047,28924,30963,25991,29042,28512,30316,5474,5995,-412,-647
"181","Barnet 014D","E01000189","E02000037","Barnet 014","E09000003","Barnet","E12000007","London",1814,1814,0,111.9,711,2.6,"00AC","Barnet",NA,2988,833,5022,11434,5156,2424,6607,10428,2168,1591,1585,-1006
"182","Barnet 014E","E01000190","E02000037","Barnet 014","E09000003","Barnet","E12000007","London",1579,1579,0,63.6,546,2.9,"00AC","Barnet",NA,15082,14732,19814,29266,22057,20431,23336,26798,6975,5699,3522,-2468
"183","Barnet 014F","E01000191","E02000037","Barnet 014","E09000003","Barnet","E12000007","London",1525,1525,0,60,530,2.9,"00AC","Barnet",NA,18607,18510,26179,31250,26745,24541,25875,31124,8138,6031,-304,-126
"198","Barnet 018A","E01000192","E02000041","Barnet 018","E09000003","Barnet","E12000007","London",1850,1850,0,65.1,683,2.7,"00AC","Barnet",NA,13492,14529,18196,31713,18005,15325,20400,26945,4513,796,2204,-4768
"199","Barnet 018B","E01000193","E02000041","Barnet 018","E09000003","Barnet","E12000007","London",1709,1709,0,56.2,594,2.9,"00AC","Barnet",NA,16289,14834,17315,31860,17630,17637,16787,26342,1341,2803,-528,-5518
"200","Barnet 018C","E01000194","E02000041","Barnet 018","E09000003","Barnet","E12000007","London",1640,1640,0,49.3,610,2.7,"00AC","Barnet",NA,7865,10276,14831,26422,14986,16453,20146,23504,7121,6177,5315,-2918
"172","Barnet 013A","E01000195","E02000036","Barnet 013","E09000003","Barnet","E12000007","London",1788,1788,0,56.7,697,2.6,"00AC","Barnet",NA,6754,5181,8817,13040,7377,5551,8045,11816,623,370,-772,-1224
"251","Barnet 028A","E01000196","E02000051","Barnet 028","E09000003","Barnet","E12000007","London",1802,1802,0,73.3,896,2,"00AC","Barnet",NA,17578,17828,21173,31315,18830,17473,18633,17208,1252,-355,-2540,-14107
"225","Barnet 023A","E01000197","E02000046","Barnet 023","E09000003","Barnet","E12000007","London",1830,1827,3,66.1,707,2.6,"00AC","Barnet",NA,14671,17660,17584,31828,20751,20028,24222,31643,6080,2368,6638,-185
"235","Barnet 025A","E01000198","E02000048","Barnet 025","E09000003","Barnet","E12000007","London",1893,1893,0,57.5,685,2.8,"00AC","Barnet",NA,17683,17921,28078,31952,21009,18108,26994,27983,3326,187,-1084,-3969
"236","Barnet 025B","E01000199","E02000048","Barnet 025","E09000003","Barnet","E12000007","London",1617,1617,0,47.8,671,2.4,"00AC","Barnet",NA,23828,25683,31080,32288,28054,25530,28359,31661,4226,-153,-2721,-627
"252","Barnet 028B","E01000200","E02000051","Barnet 028","E09000003","Barnet","E12000007","London",1845,1839,6,66.4,863,2.1,"00AC","Barnet",NA,17298,18387,20690,32245,23450,20004,22580,31879,6152,1617,1890,-366
"253","Barnet 028C","E01000201","E02000051","Barnet 028","E09000003","Barnet","E12000007","London",1531,1531,0,38.9,517,3,"00AC","Barnet",NA,23943,28447,29398,31980,27119,28889,29792,30716,3176,442,394,-1264
"254","Barnet 028D","E01000202","E02000051","Barnet 028","E09000003","Barnet","E12000007","London",1751,1751,0,77.5,648,2.7,"00AC","Barnet",NA,16974,20463,21315,32260,27207,26695,29069,30286,10233,6232,7754,-1974
"255","Barnet 028E","E01000203","E02000051","Barnet 028","E09000003","Barnet","E12000007","London",1718,1646,72,56.3,613,2.7,"00AC","Barnet",NA,9988,9387,14777,30079,16984,14721,17484,26749,6996,5334,2707,-3330
"237","Barnet 025C","E01000204","E02000048","Barnet 025","E09000003","Barnet","E12000007","London",1728,1728,0,54.6,687,2.5,"00AC","Barnet",NA,19773,21875,22445,32234,23123,22963,25466,30639,3350,1088,3021,-1595
"287","Barnet 035A","E01000205","E02000058","Barnet 035","E09000003","Barnet","E12000007","London",1522,1522,0,40,619,2.5,"00AC","Barnet",NA,23667,26310,28476,31955,27084,25954,30013,32440,3417,-356,1537,485
"278","Barnet 033B","E01000206","E02000056","Barnet 033","E09000003","Barnet","E12000007","London",1576,1490,86,11.9,514,2.9,"00AC","Barnet",NA,20340,27308,32241,30641,24895,31845,32622,30157,4555,4537,381,-484
"279","Barnet 033C","E01000207","E02000056","Barnet 033","E09000003","Barnet","E12000007","London",1583,1583,0,45.6,608,2.6,"00AC","Barnet",NA,21832,25893,29037,31782,28661,27235,31010,30655,6829,1342,1973,-1127
"280","Barnet 033D","E01000208","E02000056","Barnet 033","E09000003","Barnet","E12000007","London",1594,1591,3,39.2,619,2.6,"00AC","Barnet",NA,22947,29791,31651,32179,26573,29054,32502,31538,3626,-737,851,-641
"288","Barnet 035B","E01000209","E02000058","Barnet 035","E09000003","Barnet","E12000007","London",1563,1550,13,38.9,747,2.1,"00AC","Barnet",NA,22757,26921,29222,32393,26829,26240,31201,31754,4072,-681,1979,-639
"281","Barnet 033E","E01000210","E02000056","Barnet 033","E09000003","Barnet","E12000007","London",1548,1548,0,31.2,600,2.6,"00AC","Barnet",NA,22131,26607,28597,32469,26202,25190,30715,32524,4071,-1417,2118,55
"289","Barnet 035C","E01000211","E02000058","Barnet 035","E09000003","Barnet","E12000007","London",2014,2014,0,73.5,861,2.3,"00AC","Barnet",NA,13157,14963,17358,26479,16409,14322,17505,28426,3252,-641,147,1947
"290","Barnet 035D","E01000212","E02000058","Barnet 035","E09000003","Barnet","E12000007","London",1428,1428,0,41.1,529,2.7,"00AC","Barnet",NA,19921,30754,30007,32289,25717,28769,27589,32486,5796,-1985,-2418,197
"282","Barnet 033F","E01000213","E02000056","Barnet 033","E09000003","Barnet","E12000007","London",1438,1438,0,33.9,465,3.1,"00AC","Barnet",NA,19120,30327,32244,30494,29383,32117,32703,29926,10263,1790,459,-568
"309","Barnet 038E","E01000214","E02000061","Barnet 038","E09000003","Barnet","E12000007","London",1663,1663,0,50.2,717,2.3,"00AC","Barnet",NA,21599,31364,31532,32417,22030,29398,29734,32112,431,-1966,-1798,-305
"300","Barnet 037B","E01000215","E02000060","Barnet 037","E09000003","Barnet","E12000007","London",2033,2033,0,92.9,680,3,"00AC","Barnet",NA,16866,12706,27648,30564,20770,18127,21397,24208,3904,5421,-6251,-6356
"291","Barnet 035E","E01000216","E02000058","Barnet 035","E09000003","Barnet","E12000007","London",1968,1947,21,100.9,684,2.8,"00AC","Barnet",NA,19747,16999,26502,31326,23147,21624,27026,30499,3400,4625,524,-827
"292","Barnet 035F","E01000217","E02000058","Barnet 035","E09000003","Barnet","E12000007","London",1725,1716,9,80.4,521,3.3,"00AC","Barnet",NA,21541,20528,26848,31669,21997,25275,23486,24087,456,4747,-3362,-7582
"301","Barnet 037C","E01000218","E02000060","Barnet 037","E09000003","Barnet","E12000007","London",1818,1798,20,119.8,573,3.1,"00AC","Barnet",NA,19629,13979,28099,30568,20254,20828,20057,24710,625,6849,-8042,-5858
"302","Barnet 037D","E01000219","E02000060","Barnet 037","E09000003","Barnet","E12000007","London",1905,1897,8,99.6,581,3.3,"00AC","Barnet",NA,16448,12741,24468,31293,16802,16183,17324,22716,354,3442,-7144,-8577
"303","Barnet 037E","E01000220","E02000060","Barnet 037","E09000003","Barnet","E12000007","London",1871,1731,140,122,593,2.9,"00AC","Barnet",NA,12724,10125,15215,31488,17487,15652,17861,27224,4763,5527,2646,-4264
"311","Barnet 039B","E01000221","E02000062","Barnet 039","E09000003","Barnet","E12000007","London",1294,1279,15,30.7,485,2.6,"00AC","Barnet",NA,3587,3826,6434,15903,3428,2784,4895,13542,-159,-1042,-1539,-2361
"316","Barnet 040C","E01000222","E02000063","Barnet 040","E09000003","Barnet","E12000007","London",1582,1582,0,38,506,3.1,"00AC","Barnet",NA,9935,6775,13834,24380,8327,8685,11195,17200,-1608,1910,-2639,-7180
"312","Barnet 039C","E01000223","E02000062","Barnet 039","E09000003","Barnet","E12000007","London",1287,1287,0,23.6,478,2.7,"00AC","Barnet",NA,6199,7046,7923,15165,6385,4842,6907,11801,186,-2204,-1016,-3364
"317","Barnet 040D","E01000224","E02000063","Barnet 040","E09000003","Barnet","E12000007","London",1559,1559,0,97.1,524,3,"00AC","Barnet",NA,14165,10312,16762,26595,14073,10285,12695,16631,-92,-27,-4067,-9964
"304","Barnet 037F","E01000225","E02000060","Barnet 037","E09000003","Barnet","E12000007","London",1776,1761,15,57.2,529,3.3,"00AC","Barnet",NA,20664,19939,29263,30743,22611,24415,26984,24545,1947,4476,-2279,-6198
"201","Barnet 018D","E01000226","E02000041","Barnet 018","E09000003","Barnet","E12000007","London",1758,1758,0,101.6,630,2.8,"00AC","Barnet",NA,4950,3710,7542,13687,8000,5387,9331,8361,3050,1677,1789,-5326
"202","Barnet 018E","E01000227","E02000041","Barnet 018","E09000003","Barnet","E12000007","London",1854,1805,49,72.5,603,3,"00AC","Barnet",NA,18044,16453,23607,26179,22115,17644,22064,26279,4071,1191,-1543,100
"141","Barnet 007A","E01000228","E02000030","Barnet 007","E09000003","Barnet","E12000007","London",1481,1481,0,5.1,475,3.1,"00AC","Barnet",NA,14459,14122,21206,27675,20291,18869,22419,27758,5832,4747,1213,83
"173","Barnet 013B","E01000229","E02000036","Barnet 013","E09000003","Barnet","E12000007","London",1667,1667,0,59.5,600,2.8,"00AC","Barnet",NA,8418,6171,10599,19280,10942,9833,11786,16038,2524,3662,1187,-3242
"174","Barnet 013C","E01000230","E02000036","Barnet 013","E09000003","Barnet","E12000007","London",1785,1757,28,65.8,650,2.7,"00AC","Barnet",NA,18859,17248,23703,29722,24251,20010,24278,22441,5392,2762,575,-7281
"175","Barnet 013D","E01000231","E02000036","Barnet 013","E09000003","Barnet","E12000007","London",1849,1849,0,50.7,654,2.8,"00AC","Barnet",NA,13586,11208,20924,27508,17541,13678,23012,28003,3955,2470,2088,495
"176","Barnet 013E","E01000232","E02000036","Barnet 013","E09000003","Barnet","E12000007","London",1837,1811,26,61.6,706,2.6,"00AC","Barnet",NA,14761,15687,14817,30250,17894,14707,15704,26858,3133,-980,887,-3392
"177","Barnet 013F","E01000233","E02000036","Barnet 013","E09000003","Barnet","E12000007","London",1817,1817,0,68.6,635,2.9,"00AC","Barnet",NA,18266,16655,20384,30741,23060,17920,24761,28441,4794,1265,4377,-2300
"217","Barnet 021D","E01000234","E02000044","Barnet 021","E09000003","Barnet","E12000007","London",1701,1701,0,61.6,650,2.6,"00AC","Barnet",NA,19493,17570,25443,31182,22347,17403,23641,27262,2854,-167,-1802,-3920
"218","Barnet 021E","E01000235","E02000044","Barnet 021","E09000003","Barnet","E12000007","London",1688,1688,0,48.1,582,2.9,"00AC","Barnet",NA,7960,4093,7525,18972,9894,7368,10095,14222,1934,3275,2570,-4750
"283","Barnet 034A","E01000236","E02000057","Barnet 034","E09000003","Barnet","E12000007","London",1860,1860,0,81.1,674,2.8,"00AC","Barnet",NA,15622,13713,20702,31304,21363,17076,26079,30399,5741,3363,5377,-905
"271","Barnet 032A","E01000237","E02000055","Barnet 032","E09000003","Barnet","E12000007","London",2038,2038,0,62.8,740,2.8,"00AC","Barnet",NA,15016,19650,19897,30720,21656,23519,29134,29699,6640,3869,9237,-1021
"284","Barnet 034B","E01000238","E02000057","Barnet 034","E09000003","Barnet","E12000007","London",1963,1961,2,92.9,615,3.2,"00AC","Barnet",NA,16949,14130,19752,29387,19499,20587,20239,25692,2550,6457,487,-3695
"267","Barnet 031A","E01000239","E02000054","Barnet 031","E09000003","Barnet","E12000007","London",1970,1970,0,45.9,877,2.2,"00AC","Barnet",NA,12730,10819,18694,26448,13622,14375,18817,24621,892,3556,123,-1827
"268","Barnet 031B","E01000240","E02000054","Barnet 031","E09000003","Barnet","E12000007","London",1670,1670,0,37.9,582,2.9,"00AC","Barnet",NA,13700,10411,17679,28782,14087,15058,19762,26975,387,4647,2083,-1807
"269","Barnet 031C","E01000241","E02000054","Barnet 031","E09000003","Barnet","E12000007","London",1744,1744,0,51.3,696,2.5,"00AC","Barnet",NA,18623,20064,27502,31840,21796,21128,28207,31383,3173,1064,705,-457
"272","Barnet 032B","E01000242","E02000055","Barnet 032","E09000003","Barnet","E12000007","London",1656,1592,64,59.9,597,2.7,"00AC","Barnet",NA,14345,14791,16214,30464,13122,13698,16321,28334,-1223,-1093,107,-2130
"273","Barnet 032C","E01000243","E02000055","Barnet 032","E09000003","Barnet","E12000007","London",1884,1884,0,102.6,791,2.4,"00AC","Barnet",NA,11316,13406,18385,28986,15721,19000,23730,28154,4405,5594,5345,-832
"274","Barnet 032D","E01000244","E02000055","Barnet 032","E09000003","Barnet","E12000007","London",1705,1532,173,76.2,582,2.6,"00AC","Barnet",NA,13134,13229,18314,29495,17640,18565,27586,24449,4506,5336,9272,-5046
"275","Barnet 032E","E01000245","E02000055","Barnet 032","E09000003","Barnet","E12000007","London",1982,1982,0,109.4,811,2.4,"00AC","Barnet",NA,6619,4790,5973,24964,7805,8540,10573,18158,1186,3750,4600,-6806
"118","Barnet 002B","E01000246","E02000025","Barnet 002","E09000003","Barnet","E12000007","London",1503,1498,5,14,654,2.3,"00AC","Barnet",NA,19975,24278,25656,30755,23570,24298,26002,31494,3595,20,346,739
"119","Barnet 002C","E01000247","E02000025","Barnet 002","E09000003","Barnet","E12000007","London",1691,1691,0,63.7,746,2.3,"00AC","Barnet",NA,17016,18781,22158,29450,24409,21632,20463,30199,7393,2851,-1695,749
"111","Barnet 001A","E01000248","E02000024","Barnet 001","E09000003","Barnet","E12000007","London",1661,1613,48,61.3,666,2.4,"00AC","Barnet",NA,19081,22889,28298,31766,24732,27292,28289,31891,5651,4403,-9,125
"112","Barnet 001B","E01000249","E02000024","Barnet 001","E09000003","Barnet","E12000007","London",1525,1510,15,18.8,572,2.6,"00AC","Barnet",NA,25105,28260,26288,31695,29008,29898,26690,31946,3903,1638,402,251
"113","Barnet 001C","E01000250","E02000024","Barnet 001","E09000003","Barnet","E12000007","London",2232,2219,13,38.4,979,2.3,"00AC","Barnet",NA,12862,18242,17524,30846,18051,14491,18528,29482,5189,-3751,1004,-1364
"120","Barnet 002D","E01000251","E02000025","Barnet 002","E09000003","Barnet","E12000007","London",1846,1824,22,82.7,947,1.9,"00AC","Barnet",NA,10080,11982,9291,29565,13832,11527,10715,25137,3752,-455,1424,-4428
"121","Barnet 002E","E01000252","E02000025","Barnet 002","E09000003","Barnet","E12000007","London",1609,1609,0,68.5,753,2.1,"00AC","Barnet",NA,14909,13895,17059,28570,17557,15297,14942,29898,2648,1402,-2117,1328
"142","Barnet 007B","E01000253","E02000030","Barnet 007","E09000003","Barnet","E12000007","London",1691,1610,81,5.1,597,2.7,"00AC","Barnet",NA,18135,28329,28275,31148,23559,29013,30460,28461,5424,684,2185,-2687
"114","Barnet 001D","E01000254","E02000024","Barnet 001","E09000003","Barnet","E12000007","London",1549,1497,52,10.1,622,2.4,"00AC","Barnet",NA,21622,26108,31175,29949,25237,29480,31146,31308,3615,3372,-29,1359
"194","Barnet 017A","E01000255","E02000040","Barnet 017","E09000003","Barnet","E12000007","London",1481,1481,0,13.9,527,2.8,"00AC","Barnet",NA,12046,7559,15292,19914,13464,10976,12873,21988,1418,3417,-2419,2074
"190","Barnet 016A","E01000256","E02000039","Barnet 016","E09000003","Barnet","E12000007","London",1788,1788,0,31.8,656,2.7,"00AC","Barnet",NA,19676,19814,27854,29906,19746,19814,26901,29306,70,0,-953,-600
"195","Barnet 017B","E01000257","E02000040","Barnet 017","E09000003","Barnet","E12000007","London",1855,1855,0,27.3,724,2.6,"00AC","Barnet",NA,6365,4374,8688,19475,8397,6675,9639,13517,2032,2301,951,-5958
"191","Barnet 016B","E01000258","E02000039","Barnet 016","E09000003","Barnet","E12000007","London",1658,1658,0,20.8,696,2.4,"00AC","Barnet",NA,17769,20394,23955,30925,21196,24044,26930,28928,3427,3650,2975,-1997
"238","Barnet 025D","E01000259","E02000048","Barnet 025","E09000003","Barnet","E12000007","London",2597,2597,0,20.2,980,2.7,"00AC","Barnet",NA,17469,11801,21638,31041,19011,15919,22888,28512,1542,4118,1250,-2529
"239","Barnet 025E","E01000260","E02000048","Barnet 025","E09000003","Barnet","E12000007","London",1982,1982,0,24.3,761,2.6,"00AC","Barnet",NA,11990,12554,18988,29591,11104,12978,16884,22313,-886,424,-2104,-7278
"196","Barnet 017C","E01000261","E02000040","Barnet 017","E09000003","Barnet","E12000007","London",1601,1513,88,13.4,646,2.3,"00AC","Barnet",NA,19317,27430,30247,31694,24535,24567,29676,31784,5218,-2863,-571,90
"197","Barnet 017D","E01000262","E02000040","Barnet 017","E09000003","Barnet","E12000007","London",2260,2245,15,10.2,752,3,"00AC","Barnet",NA,17632,8043,24414,29433,18782,11924,25665,21662,1150,3881,1251,-7771
"192","Barnet 016C","E01000263","E02000039","Barnet 016","E09000003","Barnet","E12000007","London",1581,1581,0,40.1,499,3.2,"00AC","Barnet",NA,22642,31424,32346,31074,29585,31818,32524,31889,6943,394,178,815
"193","Barnet 016D","E01000264","E02000039","Barnet 016","E09000003","Barnet","E12000007","London",1648,1648,0,43.6,634,2.6,"00AC","Barnet",NA,13910,14566,18547,31324,15425,13177,14904,27815,1515,-1389,-3643,-3509
"162","Barnet 011A","E01000265","E02000034","Barnet 011","E09000003","Barnet","E12000007","London",1927,1927,0,91.4,791,2.4,"00AC","Barnet",NA,11067,9954,15171,25957,14814,9228,15049,24330,3747,-726,-122,-1627
"163","Barnet 011B","E01000266","E02000034","Barnet 011","E09000003","Barnet","E12000007","London",1527,1511,16,23.8,511,3,"00AC","Barnet",NA,19328,27004,29526,30438,26728,27590,29743,30874,7400,586,217,436
"132","Barnet 005A","E01000267","E02000028","Barnet 005","E09000003","Barnet","E12000007","London",1520,1520,0,54.4,567,2.7,"00AC","Barnet",NA,18005,17676,23457,30027,19381,18478,18595,30465,1376,802,-4862,438
"133","Barnet 005B","E01000268","E02000028","Barnet 005","E09000003","Barnet","E12000007","London",1739,1680,59,68.9,745,2.3,"00AC","Barnet",NA,11925,11887,17546,24732,14071,8930,16182,23187,2146,-2957,-1364,-1545
"134","Barnet 005C","E01000269","E02000028","Barnet 005","E09000003","Barnet","E12000007","London",1425,1425,0,52.5,535,2.7,"00AC","Barnet",NA,20594,20983,23356,26222,23496,22562,23616,25360,2902,1579,260,-862
"135","Barnet 005D","E01000270","E02000028","Barnet 005","E09000003","Barnet","E12000007","London",1482,1482,0,58.8,626,2.4,"00AC","Barnet",NA,17083,20710,22847,29504,23035,21006,23170,27816,5952,296,323,-1688
"147","Barnet 008A","E01000271","E02000031","Barnet 008","E09000003","Barnet","E12000007","London",1469,1461,8,42.9,582,2.5,"00AC","Barnet",NA,19060,26529,27301,30957,25601,23639,27744,30626,6541,-2890,443,-331
"148","Barnet 008B","E01000272","E02000031","Barnet 008","E09000003","Barnet","E12000007","London",1340,1266,74,28.5,468,2.7,"00AC","Barnet",NA,27083,30533,31923,32295,28995,29255,32261,31859,1912,-1278,338,-436
"149","Barnet 008C","E01000273","E02000031","Barnet 008","E09000003","Barnet","E12000007","London",1520,1497,23,46.2,648,2.3,"00AC","Barnet",NA,14007,13130,13201,29370,17811,14590,17795,30321,3804,1460,4594,951
"164","Barnet 011C","E01000274","E02000034","Barnet 011","E09000003","Barnet","E12000007","London",1862,1862,0,69.7,699,2.7,"00AC","Barnet",NA,10889,7368,13173,25558,14947,10690,13900,18817,4058,3322,727,-6741
"167","Barnet 012A","E01000275","E02000035","Barnet 012","E09000003","Barnet","E12000007","London",1637,1544,93,49.4,644,2.4,"00AC","Barnet",NA,17611,19797,21714,31273,20267,15618,22429,29617,2656,-4179,715,-1656
"209","Barnet 020A","E01000276","E02000043","Barnet 020","E09000003","Barnet","E12000007","London",1520,1520,0,29.6,506,3,"00AC","Barnet",NA,25985,31432,31198,31848,31435,32223,32534,32473,5450,791,1336,625
"168","Barnet 012B","E01000277","E02000035","Barnet 012","E09000003","Barnet","E12000007","London",1591,1561,30,86,777,2,"00AC","Barnet",NA,12350,11445,17088,26409,13695,11018,14295,26804,1345,-427,-2793,395
"210","Barnet 020B","E01000278","E02000043","Barnet 020","E09000003","Barnet","E12000007","London",1514,1514,0,55,498,3,"00AC","Barnet",NA,25281,29891,31520,31869,30579,31705,31918,32368,5298,1814,398,499
"143","Barnet 007C","E01000279","E02000030","Barnet 007","E09000003","Barnet","E12000007","London",1449,1446,3,2.9,513,2.8,"00AC","Barnet",NA,23271,31493,32208,32132,28473,32554,32547,30638,5202,1061,339,-1494
"144","Barnet 007D","E01000280","E02000030","Barnet 007","E09000003","Barnet","E12000007","London",1381,1381,0,13.6,497,2.8,"00AC","Barnet",NA,25931,31512,32301,32174,31888,31792,32066,31682,5957,280,-235,-492
"150","Barnet 008D","E01000281","E02000031","Barnet 008","E09000003","Barnet","E12000007","London",1260,1221,39,46.8,480,2.5,"00AC","Barnet",NA,18811,19237,21433,16334,16103,12266,15398,24332,-2708,-6971,-6035,7998
"151","Barnet 008E","E01000282","E02000031","Barnet 008","E09000003","Barnet","E12000007","London",1705,1705,0,32.2,639,2.7,"00AC","Barnet",NA,16926,19566,22392,31684,25762,22071,26938,30765,8836,2505,4546,-919
"169","Barnet 012C","E01000283","E02000035","Barnet 012","E09000003","Barnet","E12000007","London",1430,1430,0,43.3,480,3,"00AC","Barnet",NA,24703,29736,30590,32187,29715,30271,32091,32493,5012,535,1501,306
"170","Barnet 012D","E01000284","E02000035","Barnet 012","E09000003","Barnet","E12000007","London",1672,1671,1,60.6,780,2.1,"00AC","Barnet",NA,10980,11456,11649,25340,16059,10930,16462,24533,5079,-526,4813,-807
"126","Barnet 004A","E01000285","E02000027","Barnet 004","E09000003","Barnet","E12000007","London",1449,1443,6,71.7,610,2.4,"00AC","Barnet",NA,17212,14815,17818,23581,15466,11253,13227,21138,-1746,-3562,-4591,-2443
"145","Barnet 007E","E01000286","E02000030","Barnet 007","E09000003","Barnet","E12000007","London",1571,1538,33,58.4,654,2.4,"00AC","Barnet",NA,10357,8303,10262,16293,10186,7900,10174,19283,-171,-403,-88,2990
"127","Barnet 004B","E01000287","E02000027","Barnet 004","E09000003","Barnet","E12000007","London",1589,1580,9,58.1,622,2.5,"00AC","Barnet",NA,10147,8219,11168,10752,9272,7747,10041,8294,-875,-472,-1127,-2458
"128","Barnet 004C","E01000288","E02000027","Barnet 004","E09000003","Barnet","E12000007","London",1569,1565,4,46.6,568,2.8,"00AC","Barnet",NA,14793,14989,19694,27369,20116,16593,23739,23269,5323,1604,4045,-4100
"129","Barnet 004D","E01000289","E02000027","Barnet 004","E09000003","Barnet","E12000007","London",1817,1817,0,64.6,631,2.9,"00AC","Barnet",NA,3521,2128,4289,7230,4275,2717,4549,10479,754,589,260,3249
"146","Barnet 007F","E01000290","E02000030","Barnet 007","E09000003","Barnet","E12000007","London",1557,1557,0,7.6,674,2.3,"00AC","Barnet",NA,10659,12342,14390,21936,11173,12931,11909,16876,514,589,-2481,-5060
"130","Barnet 004E","E01000291","E02000027","Barnet 004","E09000003","Barnet","E12000007","London",1575,1574,1,63.1,602,2.6,"00AC","Barnet",NA,6379,4924,6652,11035,5917,4771,4804,10471,-462,-153,-1848,-564
"115","Barnet 001E","E01000292","E02000024","Barnet 001","E09000003","Barnet","E12000007","London",1467,1460,7,51,629,2.3,"00AC","Barnet",NA,17375,17716,18173,28689,20288,18660,17722,29233,2913,944,-451,544
"116","Barnet 001F","E01000293","E02000024","Barnet 001","E09000003","Barnet","E12000007","London",1722,1670,52,62.9,642,2.6,"00AC","Barnet",NA,21335,23596,22474,31651,26389,26052,25448,31531,5054,2456,2974,-120
"131","Barnet 004F","E01000294","E02000027","Barnet 004","E09000003","Barnet","E12000007","London",1599,1520,79,48.3,672,2.3,"00AC","Barnet",NA,18937,16332,18952,31537,19073,15472,14053,30725,136,-860,-4899,-812
"226","Barnet 023B","E01000295","E02000046","Barnet 023","E09000003","Barnet","E12000007","London",1714,1703,11,83.9,686,2.5,"00AC","Barnet",NA,18693,22425,23085,32171,22048,24385,25419,31554,3355,1960,2334,-617
"227","Barnet 023C","E01000296","E02000046","Barnet 023","E09000003","Barnet","E12000007","London",1707,1707,0,76.9,734,2.3,"00AC","Barnet",NA,12824,15943,17282,30055,19937,17993,24893,28826,7113,2050,7611,-1229
"248","Barnet 027D","E01000297","E02000050","Barnet 027","E09000003","Barnet","E12000007","London",1434,1430,4,61.8,554,2.6,"00AC","Barnet",NA,12719,12825,19270,27787,22951,19486,24275,20506,10232,6661,5005,-7281
"228","Barnet 023D","E01000298","E02000046","Barnet 023","E09000003","Barnet","E12000007","London",1812,1763,49,68.1,733,2.4,"00AC","Barnet",NA,13853,12879,21676,29974,20167,17097,26187,31398,6314,4218,4511,1424
"203","Barnet 019A","E01000299","E02000042","Barnet 019","E09000003","Barnet","E12000007","London",1809,1782,27,109.6,782,2.3,"00AC","Barnet",NA,10278,10860,15581,30044,15768,14357,21810,28620,5490,3497,6229,-1424
"204","Barnet 019B","E01000300","E02000042","Barnet 019","E09000003","Barnet","E12000007","London",1632,1632,0,94.1,667,2.4,"00AC","Barnet",NA,15588,14519,16700,31018,21784,18264,19542,31065,6196,3745,2842,47
"211","Barnet 020C","E01000301","E02000043","Barnet 020","E09000003","Barnet","E12000007","London",1539,1508,31,53.6,528,2.9,"00AC","Barnet",NA,20602,22906,22985,31538,28262,26315,27739,32018,7660,3409,4754,480
"205","Barnet 019C","E01000302","E02000042","Barnet 019","E09000003","Barnet","E12000007","London",1763,1728,35,81.3,840,2.1,"00AC","Barnet",NA,10208,9959,9506,31388,16320,12507,16075,25161,6112,2548,6569,-6227
"212","Barnet 020D","E01000303","E02000043","Barnet 020","E09000003","Barnet","E12000007","London",1567,1542,25,72.4,540,2.9,"00AC","Barnet",NA,22292,23586,26195,32093,27625,28129,28840,31550,5333,4543,2645,-543
"213","Barnet 020E","E01000304","E02000043","Barnet 020","E09000003","Barnet","E12000007","London",1556,1532,24,87.6,621,2.5,"00AC","Barnet",NA,13781,13161,13709,31426,18931,18249,23919,25682,5150,5088,10210,-5744
"294","Barnet 036B","E01000305","E02000059","Barnet 036","E09000003","Barnet","E12000007","London",1657,1651,6,24.1,637,2.6,"00AC","Barnet",NA,7363,6396,8465,22861,8416,8903,10451,15855,1053,2507,1986,-7006
"295","Barnet 036C","E01000306","E02000059","Barnet 036","E09000003","Barnet","E12000007","London",1696,1696,0,115.7,558,3,"00AC","Barnet",NA,12217,11152,16171,22589,16672,19059,22310,20772,4455,7907,6139,-1817
"313","Barnet 039D","E01000307","E02000062","Barnet 039","E09000003","Barnet","E12000007","London",1655,1655,0,33,530,3.1,"00AC","Barnet",NA,9374,10483,14476,21235,11581,12997,20505,14214,2207,2514,6029,-7021
"296","Barnet 036D","E01000308","E02000059","Barnet 036","E09000003","Barnet","E12000007","London",1516,1516,0,28.7,669,2.3,"00AC","Barnet",NA,3217,1994,4981,14111,2575,3065,4659,10958,-642,1071,-322,-3153
"270","Barnet 031D","E01000309","E02000054","Barnet 031","E09000003","Barnet","E12000007","London",1822,1791,31,62.8,619,2.9,"00AC","Barnet",NA,17192,18830,22682,30539,19740,20808,22125,29635,2548,1978,-557,-904
"285","Barnet 034C","E01000310","E02000057","Barnet 034","E09000003","Barnet","E12000007","London",2029,1984,45,66.6,701,2.8,"00AC","Barnet",NA,10865,10839,14108,26546,14615,17756,22281,19182,3750,6917,8173,-7364
"286","Barnet 034D","E01000311","E02000057","Barnet 034","E09000003","Barnet","E12000007","London",1632,1632,0,46.8,470,3.5,"00AC","Barnet",NA,19691,22716,27113,31362,24014,27262,30285,29723,4323,4546,3172,-1639
"297","Barnet 036E","E01000312","E02000059","Barnet 036","E09000003","Barnet","E12000007","London",1672,1672,0,114.1,710,2.4,"00AC","Barnet",NA,7245,7630,8622,20747,9827,8373,10309,19725,2582,743,1687,-1022
"298","Barnet 036F","E01000313","E02000059","Barnet 036","E09000003","Barnet","E12000007","London",1858,1851,7,85.2,672,2.8,"00AC","Barnet",NA,7487,7636,9759,22732,11102,13928,17819,20230,3615,6292,8060,-2502
"276","Barnet 032F","E01000314","E02000055","Barnet 032","E09000003","Barnet","E12000007","London",1865,1865,0,74.3,658,2.8,"00AC","Barnet",NA,21229,23031,20550,31660,21553,24883,27708,30494,324,1852,7158,-1166
"224","Barnet 022F","E01000315","E02000045","Barnet 022","E09000003","Barnet","E12000007","London",1715,1715,0,33.9,614,2.8,"00AC","Barnet",NA,5567,3886,6492,12589,6393,4137,5544,9597,826,251,-948,-2992
"249","Barnet 027E","E01000316","E02000050","Barnet 027","E09000003","Barnet","E12000007","London",2312,2312,0,56.9,874,2.6,"00AC","Barnet",NA,9959,7998,13541,27265,12957,11191,14587,27926,2998,3193,1046,661
"206","Barnet 019D","E01000317","E02000042","Barnet 019","E09000003","Barnet","E12000007","London",1613,1580,33,94.5,657,2.4,"00AC","Barnet",NA,12429,11355,14812,30739,20330,16826,21371,29531,7901,5471,6559,-1208
"207","Barnet 019E","E01000318","E02000042","Barnet 019","E09000003","Barnet","E12000007","London",1840,1820,20,67.6,610,3,"00AC","Barnet",NA,17172,15694,19817,29182,19617,16424,24522,28788,2445,730,4705,-394
"250","Barnet 027F","E01000319","E02000050","Barnet 027","E09000003","Barnet","E12000007","London",1500,1500,0,94.3,529,2.8,"00AC","Barnet",NA,18341,17414,23971,29492,24273,20204,23969,31429,5932,2790,-2,1937
"165","Barnet 011D","E01000320","E02000034","Barnet 011","E09000003","Barnet","E12000007","London",1475,1475,0,63.2,628,2.3,"00AC","Barnet",NA,20451,19576,24874,32003,23556,21244,23146,31397,3105,1668,-1728,-606
"171","Barnet 012E","E01000321","E02000035","Barnet 012","E09000003","Barnet","E12000007","London",1635,1577,58,93.4,700,2.3,"00AC","Barnet",NA,10864,13828,11605,31024,15028,14509,13812,27561,4164,681,2207,-3463
"166","Barnet 011E","E01000322","E02000034","Barnet 011","E09000003","Barnet","E12000007","London",1717,1675,42,83.9,774,2.2,"00AC","Barnet",NA,13074,13337,16927,30419,16148,14975,18349,26479,3074,1638,1422,-3940
"208","Barnet 019F","E01000323","E02000042","Barnet 019","E09000003","Barnet","E12000007","London",1982,1916,66,92.6,865,2.2,"00AC","Barnet",NA,9626,10820,11221,29566,12647,13360,15466,29073,3021,2540,4245,-493
"189","Barnet 015F","E01000324","E02000038","Barnet 015","E09000003","Barnet","E12000007","London",1786,1762,24,65.8,655,2.7,"00AC","Barnet",NA,15217,13483,14383,29084,19152,17075,15807,28129,3935,3592,1424,-955
"384","Bexley 014A","E01000325","E02000078","Bexley 014","E09000004","Bexley","E12000007","London",1610,1610,0,41.1,583,2.8,"00AD","Bexley",NA,28161,26347,28322,18763,30315,28938,29038,21425,2154,2591,716,2662
"385","Bexley 014B","E01000326","E02000078","Bexley 014","E09000004","Bexley","E12000007","London",1295,1295,0,47.4,544,2.4,"00AD","Bexley",NA,22978,25081,27235,13608,22437,19756,28766,15431,-541,-5325,1531,1823
"400","Bexley 017A","E01000327","E02000081","Bexley 017","E09000004","Bexley","E12000007","London",1543,1543,0,39.4,604,2.6,"00AD","Bexley",NA,27622,28221,26355,17808,26556,26532,25580,21050,-1066,-1689,-775,3242
"401","Bexley 017B","E01000328","E02000081","Bexley 017","E09000004","Bexley","E12000007","London",1480,1470,10,27.2,596,2.5,"00AD","Bexley",NA,25765,23338,24433,17903,24964,23656,25187,15934,-801,318,754,-1969
"402","Bexley 017C","E01000329","E02000081","Bexley 017","E09000004","Bexley","E12000007","London",1316,1299,17,27.4,517,2.5,"00AD","Bexley",NA,14578,17117,16307,11426,16736,12959,14175,14535,2158,-4158,-2132,3109
"403","Bexley 017D","E01000330","E02000081","Bexley 017","E09000004","Bexley","E12000007","London",1544,1544,0,60.5,772,2,"00AD","Bexley",NA,16332,16218,16850,16847,17393,15086,15675,17160,1061,-1132,-1175,313
"404","Bexley 017E","E01000331","E02000081","Bexley 017","E09000004","Bexley","E12000007","London",1630,1630,0,30.5,617,2.6,"00AD","Bexley",NA,10103,8356,11785,6631,10606,11321,8308,7516,503,2965,-3477,885
"341","Bexley 005A","E01000332","E02000069","Bexley 005","E09000004","Bexley","E12000007","London",1529,1529,0,55,611,2.5,"00AD","Bexley",NA,17921,19019,17652,10815,17572,16348,15858,14455,-349,-2671,-1794,3640
"332","Bexley 003A","E01000333","E02000067","Bexley 003","E09000004","Bexley","E12000007","London",1666,1653,13,57.3,793,2.1,"00AD","Bexley",NA,9749,8734,11081,8493,9136,7117,8048,7745,-613,-1617,-3033,-748
"345","Bexley 006A","E01000334","E02000070","Bexley 006","E09000004","Bexley","E12000007","London",1611,1611,0,60.8,640,2.5,"00AD","Bexley",NA,17737,16455,16982,10336,20134,17694,18882,13683,2397,1239,1900,3347
"333","Bexley 003B","E01000335","E02000067","Bexley 003","E09000004","Bexley","E12000007","London",1794,1794,0,12.9,638,2.8,"00AD","Bexley",NA,8050,6571,9713,6836,7484,6847,9049,4686,-566,276,-664,-2150
"334","Bexley 003C","E01000336","E02000067","Bexley 003","E09000004","Bexley","E12000007","London",1886,1886,0,104.3,793,2.4,"00AD","Bexley",NA,7235,4285,8481,5621,6978,5122,7754,11367,-257,837,-727,5746
"335","Bexley 003D","E01000337","E02000067","Bexley 003","E09000004","Bexley","E12000007","London",1653,1653,0,60.2,663,2.5,"00AD","Bexley",NA,14302,13059,17339,10145,14325,9684,12932,16384,23,-3375,-4407,6239
"336","Bexley 003E","E01000338","E02000067","Bexley 003","E09000004","Bexley","E12000007","London",1751,1751,0,101.1,693,2.5,"00AD","Bexley",NA,12884,14008,12982,11260,15440,13401,15947,14509,2556,-607,2965,3249
"444","Bexley 025A","E01000339","E02000089","Bexley 025","E09000004","Bexley","E12000007","London",1530,1530,0,60,602,2.5,"00AD","Bexley",NA,20396,15677,19216,14197,20245,16284,16200,12600,-151,607,-3016,-1597
"405","Bexley 018A","E01000340","E02000082","Bexley 018","E09000004","Bexley","E12000007","London",1502,1502,0,64.6,619,2.4,"00AD","Bexley",NA,22601,23970,26660,11145,21152,21203,22274,13074,-1449,-2767,-4386,1929
"429","Bexley 022A","E01000341","E02000086","Bexley 022","E09000004","Bexley","E12000007","London",1490,1485,5,61.3,610,2.4,"00AD","Bexley",NA,26153,26604,23070,13112,26889,22873,23161,17668,736,-3731,91,4556
"430","Bexley 022B","E01000342","E02000086","Bexley 022","E09000004","Bexley","E12000007","London",1595,1595,0,72.9,644,2.5,"00AD","Bexley",NA,24896,23934,25100,15915,26236,26368,27332,16619,1340,2434,2232,704
"431","Bexley 022C","E01000343","E02000086","Bexley 022","E09000004","Bexley","E12000007","London",1535,1535,0,50.7,550,2.8,"00AD","Bexley",NA,26809,28692,26991,17008,25638,23642,24678,15537,-1171,-5050,-2313,-1471
"445","Bexley 025B","E01000344","E02000089","Bexley 025","E09000004","Bexley","E12000007","London",1609,1609,0,71.1,646,2.5,"00AD","Bexley",NA,27655,27032,26590,19870,29395,27999,27611,18800,1740,967,1021,-1070
"432","Bexley 022D","E01000345","E02000086","Bexley 022","E09000004","Bexley","E12000007","London",1355,1355,0,65.2,487,2.8,"00AD","Bexley",NA,29056,26037,26796,19881,30014,26467,27656,19029,958,430,860,-852
"424","Bexley 021A","E01000346","E02000085","Bexley 021","E09000004","Bexley","E12000007","London",1622,1622,0,46.6,625,2.6,"00AD","Bexley",NA,25430,26113,25204,14348,27053,26841,27393,17302,1623,728,2189,2954
"425","Bexley 021B","E01000347","E02000085","Bexley 021","E09000004","Bexley","E12000007","London",1486,1486,0,75.6,618,2.4,"00AD","Bexley",NA,23389,20570,27980,15261,21205,20424,24252,12078,-2184,-146,-3728,-3183
"417","Bexley 020A","E01000348","E02000084","Bexley 020","E09000004","Bexley","E12000007","London",1481,1481,0,50.5,523,2.8,"00AD","Bexley",NA,30534,29757,28162,22291,30845,31020,29379,19200,311,1263,1217,-3091
"418","Bexley 020B","E01000349","E02000084","Bexley 020","E09000004","Bexley","E12000007","London",1659,1659,0,49.8,650,2.6,"00AD","Bexley",NA,29633,28648,28957,23034,28749,27618,28557,20995,-884,-1030,-400,-2039
"426","Bexley 021C","E01000350","E02000085","Bexley 021","E09000004","Bexley","E12000007","London",1501,1501,0,55.7,521,2.9,"00AD","Bexley",NA,27774,29995,26482,18841,27494,28982,26601,16711,-280,-1013,119,-2130
"439","Bexley 024A","E01000351","E02000088","Bexley 024","E09000004","Bexley","E12000007","London",1586,1586,0,50.7,616,2.6,"00AD","Bexley",NA,25734,28324,24658,16292,28910,28616,29472,15274,3176,292,4814,-1018
"427","Bexley 021D","E01000352","E02000085","Bexley 021","E09000004","Bexley","E12000007","London",1575,1575,0,45.7,676,2.3,"00AD","Bexley",NA,19180,16345,19422,16833,18461,15609,18152,12923,-719,-736,-1270,-3910
"374","Bexley 011A","E01000353","E02000075","Bexley 011","E09000004","Bexley","E12000007","London",1686,1686,0,49.9,662,2.5,"00AD","Bexley",NA,30247,29090,28666,19561,31288,28808,28033,22468,1041,-282,-633,2907
"375","Bexley 011B","E01000354","E02000075","Bexley 011","E09000004","Bexley","E12000007","London",1505,1505,0,73.3,623,2.4,"00AD","Bexley",NA,15049,11161,12838,10867,14357,11375,10288,13997,-692,214,-2550,3130
"376","Bexley 011C","E01000355","E02000075","Bexley 011","E09000004","Bexley","E12000007","London",1464,1436,28,34.8,613,2.3,"00AD","Bexley",NA,24418,23147,18726,16021,26104,23838,21304,17378,1686,691,2578,1357
"362","Bexley 009A","E01000356","E02000073","Bexley 009","E09000004","Bexley","E12000007","London",1546,1546,0,50,628,2.5,"00AD","Bexley",NA,26951,27449,25951,18592,28292,28046,21970,19985,1341,597,-3981,1393
"363","Bexley 009B","E01000357","E02000073","Bexley 009","E09000004","Bexley","E12000007","London",1457,1457,0,72.3,488,3,"00AD","Bexley",NA,30652,26146,31355,19714,31322,27221,31516,21258,670,1075,161,1544
"377","Bexley 011D","E01000358","E02000075","Bexley 011","E09000004","Bexley","E12000007","London",1608,1608,0,54.6,659,2.4,"00AD","Bexley",NA,25820,23876,25335,18145,27999,25694,25082,21416,2179,1818,-253,3271
"364","Bexley 009C","E01000359","E02000073","Bexley 009","E09000004","Bexley","E12000007","London",1280,1280,0,62.8,488,2.6,"00AD","Bexley",NA,30085,31032,28364,20570,29659,28774,25514,22159,-426,-2258,-2850,1589
"389","Bexley 015A","E01000360","E02000079","Bexley 015","E09000004","Bexley","E12000007","London",1662,1580,82,37.8,662,2.4,"00AD","Bexley",NA,16225,20088,17580,21666,15461,15247,13538,24215,-764,-4841,-4042,2549
"419","Bexley 020C","E01000361","E02000084","Bexley 020","E09000004","Bexley","E12000007","London",1540,1540,0,54,602,2.6,"00AD","Bexley",NA,23134,21061,25068,18260,22228,18324,20415,18391,-906,-2737,-4653,131
"390","Bexley 015B","E01000362","E02000079","Bexley 015","E09000004","Bexley","E12000007","London",1482,1482,0,37.6,626,2.4,"00AD","Bexley",NA,18260,22464,20066,14774,22591,21785,21270,20142,4331,-679,1204,5368
"420","Bexley 020D","E01000363","E02000084","Bexley 020","E09000004","Bexley","E12000007","London",1441,1441,0,34.4,565,2.6,"00AD","Bexley",NA,25382,27691,22803,21168,27447,27446,24583,22882,2065,-245,1780,1714
"434","Bexley 023A","E01000364","E02000087","Bexley 023","E09000004","Bexley","E12000007","London",1577,1577,0,36.4,651,2.4,"00AD","Bexley",NA,21662,22185,22624,18989,22592,19884,24238,18350,930,-2301,1614,-639
"391","Bexley 015C","E01000365","E02000079","Bexley 015","E09000004","Bexley","E12000007","London",1678,1612,66,49.2,700,2.3,"00AD","Bexley",NA,24443,22353,22679,22324,17724,14875,17409,21477,-6719,-7478,-5270,-847
"392","Bexley 015D","E01000366","E02000079","Bexley 015","E09000004","Bexley","E12000007","London",1585,1581,4,67.2,655,2.4,"00AD","Bexley",NA,16027,20749,16963,19344,24361,18578,21828,24025,8334,-2171,4865,4681
"369","Bexley 010A","E01000367","E02000074","Bexley 010","E09000004","Bexley","E12000007","London",1575,1528,47,60.1,605,2.5,"00AD","Bexley",NA,6297,7049,7602,3700,7337,8887,7535,4945,1040,1838,-67,1245
"370","Bexley 010B","E01000368","E02000074","Bexley 010","E09000004","Bexley","E12000007","London",1539,1539,0,64.7,632,2.4,"00AD","Bexley",NA,8582,5693,9167,4425,7649,5493,7531,5826,-933,-200,-1636,1401
"386","Bexley 014C","E01000369","E02000078","Bexley 014","E09000004","Bexley","E12000007","London",1618,1618,0,60.8,626,2.6,"00AD","Bexley",NA,20133,16042,22343,13915,19968,17308,15787,16210,-165,1266,-6556,2295
"387","Bexley 014D","E01000370","E02000078","Bexley 014","E09000004","Bexley","E12000007","London",1597,1597,0,49,649,2.5,"00AD","Bexley",NA,23390,22290,21845,18886,25235,21606,21815,17949,1845,-684,-30,-937
"388","Bexley 014E","E01000371","E02000078","Bexley 014","E09000004","Bexley","E12000007","London",1545,1545,0,66.8,634,2.4,"00AD","Bexley",NA,23189,25743,26799,10972,25707,23132,26197,15848,2518,-2611,-602,4876
"371","Bexley 010C","E01000372","E02000074","Bexley 010","E09000004","Bexley","E12000007","London",1680,1645,35,73.3,593,2.8,"00AD","Bexley",NA,8489,8779,6942,5731,8629,6745,5551,8400,140,-2034,-1391,2669
"355","Bexley 008A","E01000373","E02000072","Bexley 008","E09000004","Bexley","E12000007","London",1574,1574,0,176.9,688,2.3,"00AD","Bexley",NA,4320,1811,4235,5855,6921,3900,7186,9309,2601,2089,2951,3454
"411","Bexley 019A","E01000374","E02000083","Bexley 019","E09000004","Bexley","E12000007","London",1533,1533,0,20.6,534,2.9,"00AD","Bexley",NA,5861,2913,8419,3206,5012,3994,4792,3375,-849,1081,-3627,169
"412","Bexley 019B","E01000375","E02000083","Bexley 019","E09000004","Bexley","E12000007","London",1476,1476,0,34.4,565,2.6,"00AD","Bexley",NA,14275,12003,15427,7304,13759,10512,13857,9755,-516,-1491,-1570,2451
"413","Bexley 019C","E01000376","E02000083","Bexley 019","E09000004","Bexley","E12000007","London",1541,1541,0,28,606,2.5,"00AD","Bexley",NA,21061,19338,24049,16013,20629,18013,22286,15902,-432,-1325,-1763,-111
"414","Bexley 019D","E01000377","E02000083","Bexley 019","E09000004","Bexley","E12000007","London",1420,1420,0,33,649,2.2,"00AD","Bexley",NA,25840,25317,23957,18532,22036,18260,19801,19309,-3804,-7057,-4156,777
"415","Bexley 019E","E01000378","E02000083","Bexley 019","E09000004","Bexley","E12000007","London",2121,2100,21,16.8,968,2.2,"00AD","Bexley",NA,12417,10965,16125,14917,13034,14634,11949,13098,617,3669,-4176,-1819
"416","Bexley 019F","E01000379","E02000083","Bexley 019","E09000004","Bexley","E12000007","London",1680,1680,0,51.8,663,2.5,"00AD","Bexley",NA,15678,11435,20112,10689,14573,12710,15062,11876,-1105,1275,-5050,1187
"372","Bexley 010D","E01000380","E02000074","Bexley 010","E09000004","Bexley","E12000007","London",1455,1455,0,64.7,758,1.9,"00AD","Bexley",NA,10551,10192,16802,6842,11063,9159,12852,8063,512,-1033,-3950,1221
"460","Bexley 028A","E01000381","E02000092","Bexley 028","E09000004","Bexley","E12000007","London",1598,1579,19,7.8,660,2.4,"00AD","Bexley",NA,10943,9970,11598,11570,9838,10186,9530,8316,-1105,216,-2068,-3254
"454","Bexley 027A","E01000382","E02000091","Bexley 027","E09000004","Bexley","E12000007","London",1524,1524,0,26.1,587,2.6,"00AD","Bexley",NA,26540,27433,26115,25839,29390,30431,28679,24812,2850,2998,2564,-1027
"461","Bexley 028B","E01000383","E02000092","Bexley 028","E09000004","Bexley","E12000007","London",1505,1505,0,5.4,633,2.4,"00AD","Bexley",NA,16358,17063,19280,12441,14388,16746,16002,11844,-1970,-317,-3278,-597
"455","Bexley 027B","E01000384","E02000091","Bexley 027","E09000004","Bexley","E12000007","London",1722,1722,0,57.4,780,2.2,"00AD","Bexley",NA,23408,17823,23165,23951,22480,17044,22926,22627,-928,-779,-239,-1324
"462","Bexley 028C","E01000385","E02000092","Bexley 028","E09000004","Bexley","E12000007","London",1866,1866,0,31.2,770,2.4,"00AD","Bexley",NA,6528,5154,6843,5790,8145,5398,7798,7836,1617,244,955,2046
"463","Bexley 028D","E01000386","E02000092","Bexley 028","E09000004","Bexley","E12000007","London",1457,1457,0,26.4,659,2.2,"00AD","Bexley",NA,6470,4015,6150,7190,5780,4494,5389,5375,-690,479,-761,-1815
"456","Bexley 027C","E01000387","E02000091","Bexley 027","E09000004","Bexley","E12000007","London",1535,1535,0,49.9,618,2.5,"00AD","Bexley",NA,22523,22224,19069,19588,22661,21895,22202,20444,138,-329,3133,856
"394","Bexley 016A","E01000388","E02000080","Bexley 016","E09000004","Bexley","E12000007","London",1531,1531,0,28.9,621,2.5,"00AD","Bexley",NA,24336,27710,22293,18973,22407,21537,24134,18864,-1929,-6173,1841,-109
"421","Bexley 020E","E01000389","E02000084","Bexley 020","E09000004","Bexley","E12000007","London",1649,1649,0,37.3,714,2.3,"00AD","Bexley",NA,21363,20488,21968,20435,21752,18472,23233,21328,389,-2016,1265,893
"422","Bexley 020F","E01000390","E02000084","Bexley 020","E09000004","Bexley","E12000007","London",1290,1284,6,23.7,515,2.5,"00AD","Bexley",NA,20132,24116,21565,16029,24289,24427,27730,18281,4157,311,6165,2252
"428","Bexley 021E","E01000391","E02000085","Bexley 021","E09000004","Bexley","E12000007","London",1709,1709,0,36.7,644,2.7,"00AD","Bexley",NA,19946,18013,26027,10029,20349,17672,18826,12807,403,-341,-7201,2778
"395","Bexley 016B","E01000392","E02000080","Bexley 016","E09000004","Bexley","E12000007","London",1646,1646,0,74.5,695,2.4,"00AD","Bexley",NA,8389,7576,13676,9591,9530,7016,9731,11480,1141,-560,-3945,1889
"423","Bexley 020G","E01000393","E02000084","Bexley 020","E09000004","Bexley","E12000007","London",1581,1581,0,57.2,640,2.5,"00AD","Bexley",NA,23272,23177,25941,14018,25324,22914,24413,19919,2052,-263,-1528,5901
"393","Bexley 015E","E01000394","E02000079","Bexley 015","E09000004","Bexley","E12000007","London",1458,1458,0,61.5,624,2.3,"00AD","Bexley",NA,24470,21804,22931,21460,24750,20017,22255,24906,280,-1787,-676,3446
"406","Bexley 018B","E01000395","E02000082","Bexley 018","E09000004","Bexley","E12000007","London",1428,1428,0,44.5,499,2.9,"00AD","Bexley",NA,28576,29444,26446,17434,29078,26401,25506,22537,502,-3043,-940,5103
"407","Bexley 018C","E01000396","E02000082","Bexley 018","E09000004","Bexley","E12000007","London",1399,1399,0,63.9,507,2.8,"00AD","Bexley",NA,24285,23518,26044,12054,27547,26826,26020,18728,3262,3308,-24,6674
"464","Bexley 029A","E01000398","E02006785","Bexley 029","E09000004","Bexley","E12000007","London",1599,1599,0,68.4,611,2.6,"00AD","Bexley",NA,14629,12312,14048,7653,13660,11367,12651,8424,-969,-945,-1397,771
"465","Bexley 029B","E01000399","E02006785","Bexley 029","E09000004","Bexley","E12000007","London",1554,1554,0,53.3,619,2.5,"00AD","Bexley",NA,23055,24907,24782,16195,24007,22028,23760,14540,952,-2879,-1022,-1655
"466","Bexley 029C","E01000400","E02006785","Bexley 029","E09000004","Bexley","E12000007","London",1547,1547,0,54.9,590,2.6,"00AD","Bexley",NA,19434,17330,22818,12554,20683,17572,18259,15409,1249,242,-4559,2855
"379","Bexley 013A","E01000401","E02000077","Bexley 013","E09000004","Bexley","E12000007","London",1647,1584,63,61,637,2.5,"00AD","Bexley",NA,11121,10299,9463,7966,9932,7539,9753,9521,-1189,-2760,290,1555
"342","Bexley 005B","E01000402","E02000069","Bexley 005","E09000004","Bexley","E12000007","London",1536,1525,11,49.2,660,2.3,"00AD","Bexley",NA,11949,9453,12178,10679,13743,9915,12320,13255,1794,462,142,2576
"337","Bexley 004A","E01000403","E02000068","Bexley 004","E09000004","Bexley","E12000007","London",2108,2108,0,33.7,990,2.1,"00AD","Bexley",NA,7682,6191,6494,12282,8758,7459,9818,11488,1076,1268,3324,-794
"338","Bexley 004B","E01000404","E02000068","Bexley 004","E09000004","Bexley","E12000007","London",2234,2234,0,131.3,959,2.3,"00AD","Bexley",NA,5609,5618,10677,5569,9013,6522,9379,12200,3404,904,-1298,6631
"339","Bexley 004C","E01000405","E02000068","Bexley 004","E09000004","Bexley","E12000007","London",1410,1410,0,36.4,522,2.7,"00AD","Bexley",NA,10318,10660,13466,9275,10945,7683,9392,11760,627,-2977,-4074,2485
"343","Bexley 005C","E01000406","E02000069","Bexley 005","E09000004","Bexley","E12000007","London",1649,1649,0,38.5,594,2.8,"00AD","Bexley",NA,10456,10211,17199,10905,10838,9884,12899,14594,382,-327,-4300,3689
"344","Bexley 005D","E01000407","E02000069","Bexley 005","E09000004","Bexley","E12000007","London",1480,1441,39,34.2,630,2.3,"00AD","Bexley",NA,16337,18374,12957,13558,16884,16945,14618,14393,547,-1429,1661,835
"340","Bexley 004D","E01000408","E02000068","Bexley 004","E09000004","Bexley","E12000007","London",1636,1636,0,15,570,2.9,"00AD","Bexley",NA,12171,9287,13267,8610,13059,9487,11457,12359,888,200,-1810,3749
"396","Bexley 016C","E01000409","E02000080","Bexley 016","E09000004","Bexley","E12000007","London",1649,1649,0,72.8,649,2.5,"00AD","Bexley",NA,26680,27660,25808,12818,28554,27652,25644,14730,1874,-8,-164,1912
"408","Bexley 018D","E01000410","E02000082","Bexley 018","E09000004","Bexley","E12000007","London",1568,1568,0,57.5,594,2.6,"00AD","Bexley",NA,26722,27148,26276,12989,28364,27493,29579,17563,1642,345,3303,4574
"397","Bexley 016D","E01000411","E02000080","Bexley 016","E09000004","Bexley","E12000007","London",1398,1398,0,73.2,551,2.5,"00AD","Bexley",NA,25547,25036,27055,12708,24808,22717,22933,15798,-739,-2319,-4122,3090
"409","Bexley 018E","E01000412","E02000082","Bexley 018","E09000004","Bexley","E12000007","London",1678,1678,0,68.4,632,2.7,"00AD","Bexley",NA,19459,23416,25754,11979,23442,21603,24881,19761,3983,-1813,-873,7782
"410","Bexley 018F","E01000413","E02000082","Bexley 018","E09000004","Bexley","E12000007","London",1301,1301,0,62.9,505,2.6,"00AD","Bexley",NA,21965,19520,25299,13744,21480,20353,23912,13369,-485,833,-1387,-375
"398","Bexley 016E","E01000414","E02000080","Bexley 016","E09000004","Bexley","E12000007","London",1708,1708,0,58,674,2.5,"00AD","Bexley",NA,14848,17327,16736,14002,19500,18096,19878,19315,4652,769,3142,5313
"399","Bexley 016F","E01000415","E02000080","Bexley 016","E09000004","Bexley","E12000007","London",1498,1498,0,65.6,512,2.9,"00AD","Bexley",NA,28480,29706,27407,18390,29203,27134,27777,17452,723,-2572,370,-938
"326","Bexley 002A","E01000416","E02000066","Bexley 002","E09000004","Bexley","E12000007","London",1547,1505,42,86.7,517,2.9,"00AD","Bexley",NA,8699,6643,10287,7629,10069,8188,11921,16918,1370,1545,1634,9289
"346","Bexley 006B","E01000417","E02000070","Bexley 006","E09000004","Bexley","E12000007","London",1639,1639,0,22,713,2.3,"00AD","Bexley",NA,15507,17382,14739,15989,15462,16053,15686,16113,-45,-1329,947,124
"327","Bexley 002B","E01000418","E02000066","Bexley 002","E09000004","Bexley","E12000007","London",1937,1937,0,37.6,754,2.6,"00AD","Bexley",NA,12028,9600,13336,11340,13088,10258,16620,11988,1060,658,3284,648
"347","Bexley 006C","E01000419","E02000070","Bexley 006","E09000004","Bexley","E12000007","London",1461,1461,0,55.4,594,2.5,"00AD","Bexley",NA,27796,29952,27552,14681,27246,27386,23755,18712,-550,-2566,-3797,4031
"348","Bexley 006D","E01000420","E02000070","Bexley 006","E09000004","Bexley","E12000007","London",1551,1551,0,56.5,604,2.6,"00AD","Bexley",NA,22573,22175,21781,11386,23589,23638,20662,14688,1016,1463,-1119,3302
"365","Bexley 009D","E01000421","E02000073","Bexley 009","E09000004","Bexley","E12000007","London",1482,1482,0,51.4,603,2.5,"00AD","Bexley",NA,27916,28935,25305,19005,27687,27797,23974,22573,-229,-1138,-1331,3568
"328","Bexley 002C","E01000422","E02000066","Bexley 002","E09000004","Bexley","E12000007","London",1729,1729,0,165.9,681,2.5,"00AD","Bexley",NA,5209,1866,5995,9152,4580,1815,3931,10383,-629,-51,-2064,1231
"446","Bexley 025C","E01000423","E02000089","Bexley 025","E09000004","Bexley","E12000007","London",1638,1625,13,57.8,609,2.7,"00AD","Bexley",NA,30507,27112,29698,22617,31569,31041,30551,23115,1062,3929,853,498
"449","Bexley 026A","E01000424","E02000090","Bexley 026","E09000004","Bexley","E12000007","London",1693,1628,65,43.9,765,2.1,"00AD","Bexley",NA,26454,24914,27983,29447,26346,25338,27529,28800,-108,424,-454,-647
"447","Bexley 025D","E01000425","E02000089","Bexley 025","E09000004","Bexley","E12000007","London",1752,1617,135,47.8,590,2.7,"00AD","Bexley",NA,30931,30918,29769,24449,29603,26725,29150,23865,-1328,-4193,-619,-584
"450","Bexley 026B","E01000426","E02000090","Bexley 026","E09000004","Bexley","E12000007","London",1675,1675,0,65.4,712,2.4,"00AD","Bexley",NA,20882,20295,23551,23300,25842,23893,26310,22791,4960,3598,2759,-509
"451","Bexley 026C","E01000427","E02000090","Bexley 026","E09000004","Bexley","E12000007","London",1932,1932,0,47.4,922,2.1,"00AD","Bexley",NA,20641,17785,18778,22120,21346,19274,18109,18478,705,1489,-669,-3642
"457","Bexley 027D","E01000428","E02000091","Bexley 027","E09000004","Bexley","E12000007","London",1752,1627,125,19.6,882,1.8,"00AD","Bexley",NA,12709,13158,16028,20034,11145,11016,12416,14175,-1564,-2142,-3612,-5859
"356","Bexley 008B","E01000429","E02000072","Bexley 008","E09000004","Bexley","E12000007","London",1639,1639,0,52.9,719,2.3,"00AD","Bexley",NA,5803,4647,8470,1641,3946,3709,4720,7157,-1857,-938,-3750,5516
"357","Bexley 008C","E01000430","E02000072","Bexley 008","E09000004","Bexley","E12000007","London",1782,1782,0,11.8,678,2.6,"00AD","Bexley",NA,14549,12599,16592,8588,15469,11407,15584,16488,920,-1192,-1008,7900
"358","Bexley 008D","E01000431","E02000072","Bexley 008","E09000004","Bexley","E12000007","London",1672,1664,8,114.1,681,2.4,"00AD","Bexley",NA,6075,4471,4616,5556,4866,3346,5372,7150,-1209,-1125,756,1594
"359","Bexley 008E","E01000432","E02000072","Bexley 008","E09000004","Bexley","E12000007","London",1673,1673,0,36.3,640,2.6,"00AD","Bexley",NA,10387,8768,10780,5599,8530,8029,8691,6701,-1857,-739,-2089,1102
"360","Bexley 008F","E01000433","E02000072","Bexley 008","E09000004","Bexley","E12000007","London",1810,1810,0,58.2,720,2.5,"00AD","Bexley",NA,4816,3647,7430,2651,5180,3717,4520,8092,364,70,-2910,5441
"361","Bexley 008G","E01000434","E02000072","Bexley 008","E09000004","Bexley","E12000007","London",1584,1584,0,10.2,596,2.7,"00AD","Bexley",NA,5549,2338,7162,2896,5286,4893,4805,2737,-263,2555,-2357,-159
"373","Bexley 010E","E01000435","E02000074","Bexley 010","E09000004","Bexley","E12000007","London",1406,1406,0,80.2,597,2.4,"00AD","Bexley",NA,10455,8015,14772,7486,8933,8472,9198,9011,-1522,457,-5574,1525
"378","Bexley 011E","E01000436","E02000075","Bexley 011","E09000004","Bexley","E12000007","London",1685,1685,0,60.8,615,2.7,"00AD","Bexley",NA,28833,29578,21919,20192,28894,24302,24598,19986,61,-5276,2679,-206
"350","Bexley 007A","E01000437","E02000071","Bexley 007","E09000004","Bexley","E12000007","London",1322,1322,0,49.7,498,2.7,"00AD","Bexley",NA,19898,18796,22806,10450,20908,17190,20591,14344,1010,-1606,-2215,3894
"351","Bexley 007B","E01000438","E02000071","Bexley 007","E09000004","Bexley","E12000007","London",1599,1599,0,87.3,599,2.7,"00AD","Bexley",NA,18639,20414,20757,11775,20479,17460,20159,14591,1840,-2954,-598,2816
"352","Bexley 007C","E01000439","E02000071","Bexley 007","E09000004","Bexley","E12000007","London",1368,1368,0,54.2,496,2.8,"00AD","Bexley",NA,10866,11135,13177,5325,10962,10312,10296,8100,96,-823,-2881,2775
"353","Bexley 007D","E01000440","E02000071","Bexley 007","E09000004","Bexley","E12000007","London",1413,1413,0,58.5,517,2.7,"00AD","Bexley",NA,27625,28761,23836,14012,28456,28033,26561,14622,831,-728,2725,610
"354","Bexley 007E","E01000441","E02000071","Bexley 007","E09000004","Bexley","E12000007","London",1598,1598,0,67.9,672,2.4,"00AD","Bexley",NA,11300,8109,9900,8740,9105,6088,7524,7958,-2195,-2021,-2376,-782
"349","Bexley 006E","E01000442","E02000070","Bexley 006","E09000004","Bexley","E12000007","London",1613,1613,0,52.5,626,2.6,"00AD","Bexley",NA,20404,22789,19596,10313,20050,19063,16380,13786,-354,-3726,-3216,3473
"440","Bexley 024B","E01000443","E02000088","Bexley 024","E09000004","Bexley","E12000007","London",1276,1276,0,46.6,510,2.5,"00AD","Bexley",NA,17005,12469,16090,15567,15127,16197,13413,16819,-1878,3728,-2677,1252
"435","Bexley 023B","E01000444","E02000087","Bexley 023","E09000004","Bexley","E12000007","London",1637,1631,6,11.9,626,2.6,"00AD","Bexley",NA,29097,31078,28798,27642,29413,30662,27313,25359,316,-416,-1485,-2283
"441","Bexley 024C","E01000445","E02000088","Bexley 024","E09000004","Bexley","E12000007","London",1641,1641,0,27.8,687,2.4,"00AD","Bexley",NA,29259,29547,26186,25193,30239,30235,29336,21166,980,688,3150,-4027
"442","Bexley 024D","E01000446","E02000088","Bexley 024","E09000004","Bexley","E12000007","London",1572,1572,0,56.1,602,2.6,"00AD","Bexley",NA,26553,27883,23568,17979,29192,28900,28741,18484,2639,1017,5173,505
"436","Bexley 023C","E01000447","E02000087","Bexley 023","E09000004","Bexley","E12000007","London",1535,1534,1,15.5,713,2.2,"00AD","Bexley",NA,21048,22024,24524,20076,23573,20310,22653,25953,2525,-1714,-1871,5877
"437","Bexley 023D","E01000448","E02000087","Bexley 023","E09000004","Bexley","E12000007","London",1335,1335,0,29.3,504,2.6,"00AD","Bexley",NA,31309,31663,30494,27597,32286,31857,29789,28566,977,194,-705,969
"438","Bexley 023E","E01000449","E02000087","Bexley 023","E09000004","Bexley","E12000007","London",1495,1482,13,32.7,648,2.3,"00AD","Bexley",NA,30361,30183,29247,28746,29679,31245,29112,28070,-682,1062,-135,-676
"366","Bexley 009E","E01000450","E02000073","Bexley 009","E09000004","Bexley","E12000007","London",1832,1832,0,79.9,645,2.8,"00AD","Bexley",NA,15813,13539,13956,10637,15488,11972,11172,13661,-325,-1567,-2784,3024
"367","Bexley 009F","E01000451","E02000073","Bexley 009","E09000004","Bexley","E12000007","London",1699,1699,0,81.6,621,2.7,"00AD","Bexley",NA,25283,27592,23599,12836,25437,21337,25216,14947,154,-6255,1617,2111
"368","Bexley 009G","E01000452","E02000073","Bexley 009","E09000004","Bexley","E12000007","London",1428,1428,0,89.6,495,2.9,"00AD","Bexley",NA,28017,27547,25613,15506,28186,23567,26542,18688,169,-3980,929,3182
"380","Bexley 013B","E01000453","E02000077","Bexley 013","E09000004","Bexley","E12000007","London",1472,1472,0,70,513,2.9,"00AD","Bexley",NA,24816,24576,23707,13003,24923,22192,22201,14794,107,-2384,-1506,1791
"381","Bexley 013C","E01000454","E02000077","Bexley 013","E09000004","Bexley","E12000007","London",1572,1572,0,76.6,628,2.5,"00AD","Bexley",NA,15653,16633,14249,11720,14917,13615,13016,12360,-736,-3018,-1233,640
"382","Bexley 013D","E01000455","E02000077","Bexley 013","E09000004","Bexley","E12000007","London",1705,1705,0,64.8,605,2.8,"00AD","Bexley",NA,23402,24405,21346,13777,28880,27442,26303,17380,5478,3037,4957,3603
"383","Bexley 013E","E01000456","E02000077","Bexley 013","E09000004","Bexley","E12000007","London",1427,1427,0,84.5,487,2.9,"00AD","Bexley",NA,27597,26458,24943,16903,28689,25247,26121,19274,1092,-1211,1178,2371
"452","Bexley 026D","E01000457","E02000090","Bexley 026","E09000004","Bexley","E12000007","London",1783,1703,80,59.9,825,2.1,"00AD","Bexley",NA,19087,19670,21550,21271,22343,18823,26885,22509,3256,-847,5335,1238
"458","Bexley 027E","E01000458","E02000091","Bexley 027","E09000004","Bexley","E12000007","London",1462,1459,3,43.2,631,2.3,"00AD","Bexley",NA,29469,28095,28164,29428,30217,25060,29924,28549,748,-3035,1760,-879
"459","Bexley 027F","E01000459","E02000091","Bexley 027","E09000004","Bexley","E12000007","London",1687,1675,12,54.4,781,2.1,"00AD","Bexley",NA,17392,17212,19726,26064,19978,13929,17951,22379,2586,-3283,-1775,-3685
"433","Bexley 022E","E01000460","E02000086","Bexley 022","E09000004","Bexley","E12000007","London",1353,1353,0,26.2,498,2.7,"00AD","Bexley",NA,31265,31347,31514,27141,31910,31221,31323,24102,645,-126,-191,-3039
"443","Bexley 024E","E01000461","E02000088","Bexley 024","E09000004","Bexley","E12000007","London",1662,1662,0,30.7,569,2.9,"00AD","Bexley",NA,27433,27794,28799,24192,28480,27504,27147,23278,1047,-290,-1652,-914
"453","Bexley 026E","E01000462","E02000090","Bexley 026","E09000004","Bexley","E12000007","London",1643,1531,112,35.5,738,2.1,"00AD","Bexley",NA,22348,22173,22709,25885,20871,17121,21652,19773,-1477,-5052,-1057,-6112
"448","Bexley 025E","E01000463","E02000089","Bexley 025","E09000004","Bexley","E12000007","London",1254,1254,0,53.2,452,2.8,"00AD","Bexley",NA,28449,28108,26888,22480,30668,27191,29129,20938,2219,-917,2241,-1542
"329","Bexley 002D","E01000464","E02000066","Bexley 002","E09000004","Bexley","E12000007","London",1443,1443,0,99.2,546,2.6,"00AD","Bexley",NA,7650,4523,6314,5735,9293,5128,8295,12071,1643,605,1981,6336
"330","Bexley 002E","E01000465","E02000066","Bexley 002","E09000004","Bexley","E12000007","London",1542,1542,0,57.5,707,2.2,"00AD","Bexley",NA,6295,6661,6860,10406,8150,5072,5054,9941,1855,-1589,-1806,-465
"322","Bexley 001A","E01000466","E02000065","Bexley 001","E09000004","Bexley","E12000007","London",1655,1641,14,7,602,2.7,"00AD","Bexley",NA,6389,5579,7850,8409,10384,6530,8316,14737,3995,951,466,6328
"323","Bexley 001B","E01000467","E02000065","Bexley 001","E09000004","Bexley","E12000007","London",1634,1634,0,95.1,591,2.8,"00AD","Bexley",NA,12568,9187,15597,12240,13195,8873,13310,18781,627,-314,-2287,6541
"324","Bexley 001C","E01000468","E02000065","Bexley 001","E09000004","Bexley","E12000007","London",2723,2723,0,92.8,890,3.1,"00AD","Bexley",NA,15711,12893,23291,14370,13352,10114,17271,26445,-2359,-2779,-6020,12075
"325","Bexley 001D","E01000469","E02000065","Bexley 001","E09000004","Bexley","E12000007","London",1654,1654,0,43.6,645,2.6,"00AD","Bexley",NA,13177,13479,12054,14623,14416,13036,15598,23032,1239,-443,3544,8409
"331","Bexley 002F","E01000470","E02000066","Bexley 002","E09000004","Bexley","E12000007","London",1443,1443,0,40,590,2.4,"00AD","Bexley",NA,5271,2979,5190,6159,3992,2324,3950,10586,-1279,-655,-1240,4427
"595","Brent 026A","E01000471","E02000118","Brent 026","E09000005","Brent","E12000007","London",1638,1638,0,117.8,469,3.5,"00AE","Brent",NA,11469,11185,18577,15640,12708,14810,18984,11146,1239,3625,407,-4494
"609","Brent 029A","E01000472","E02000121","Brent 029","E09000005","Brent","E12000007","London",1346,1346,0,31.1,512,2.6,"00AE","Brent",NA,10388,8345,18827,17944,9940,11655,21674,17411,-448,3310,2847,-533
"610","Brent 029B","E01000473","E02000121","Brent 029","E09000005","Brent","E12000007","London",1883,1883,0,108.5,520,3.6,"00AE","Brent",NA,9720,8946,17334,12770,9178,9612,14776,9745,-542,666,-2558,-3025
"596","Brent 026B","E01000474","E02000118","Brent 026","E09000005","Brent","E12000007","London",1999,1999,0,101.7,501,4,"00AE","Brent",NA,10170,6530,13230,15154,14425,16038,18130,8943,4255,9508,4900,-6211
"611","Brent 029C","E01000475","E02000121","Brent 029","E09000005","Brent","E12000007","London",1976,1976,0,63.3,596,3.3,"00AE","Brent",NA,12823,11312,17019,17295,13120,13609,19048,18958,297,2297,2029,1663
"597","Brent 026C","E01000476","E02000118","Brent 026","E09000005","Brent","E12000007","London",1618,1618,0,71.2,455,3.6,"00AE","Brent",NA,11909,11436,13178,16150,13128,17304,20567,10214,1219,5868,7389,-5936
"598","Brent 026D","E01000477","E02000118","Brent 026","E09000005","Brent","E12000007","London",1916,1910,6,49.8,656,2.9,"00AE","Brent",NA,9094,7767,12839,17847,10092,12372,18016,9396,998,4605,5177,-8451
"612","Brent 029D","E01000478","E02000121","Brent 029","E09000005","Brent","E12000007","London",1641,1640,1,85.4,447,3.7,"00AE","Brent",NA,8975,9670,15358,14080,12052,13994,19993,13088,3077,4324,4635,-992
"509","Brent 009A","E01000479","E02000101","Brent 009","E09000005","Brent","E12000007","London",1659,1620,39,52.8,510,3.2,"00AE","Brent",NA,18256,16259,24629,30617,17361,15653,19820,24798,-895,-606,-4809,-5819
"494","Brent 006A","E01000480","E02000098","Brent 006","E09000005","Brent","E12000007","London",1749,1741,8,58.7,535,3.3,"00AE","Brent",NA,17310,17911,23529,30738,21877,22044,27108,25706,4567,4133,3579,-5032
"510","Brent 009B","E01000481","E02000101","Brent 009","E09000005","Brent","E12000007","London",1538,1538,0,60.5,610,2.5,"00AE","Brent",NA,8468,6666,11112,22053,8179,7462,10151,20805,-289,796,-961,-1248
"511","Brent 009C","E01000482","E02000101","Brent 009","E09000005","Brent","E12000007","London",2886,2790,96,84.4,992,2.8,"00AE","Brent",NA,780,245,573,16393,6055,4598,7727,16346,5275,4353,7154,-47
"512","Brent 009D","E01000483","E02000101","Brent 009","E09000005","Brent","E12000007","London",1745,1745,0,77.3,643,2.7,"00AE","Brent",NA,3362,2001,5559,13807,6145,3734,7446,13122,2783,1733,1887,-685
"495","Brent 006B","E01000484","E02000098","Brent 006","E09000005","Brent","E12000007","London",1228,1228,0,39.4,423,2.9,"00AE","Brent",NA,7004,5120,6980,17123,4067,2300,3285,12369,-2937,-2820,-3695,-4754
"496","Brent 006C","E01000485","E02000098","Brent 006","E09000005","Brent","E12000007","London",1375,1371,4,77.4,488,2.8,"00AE","Brent",NA,8025,5851,9091,21806,10021,7354,12191,18090,1996,1503,3100,-3716
"497","Brent 006D","E01000486","E02000098","Brent 006","E09000005","Brent","E12000007","London",1702,1702,0,22.9,532,3.2,"00AE","Brent",NA,18133,14523,22587,30735,18470,16128,21202,21916,337,1605,-1385,-8819
"498","Brent 006E","E01000487","E02000098","Brent 006","E09000005","Brent","E12000007","London",1890,1875,15,61.6,674,2.8,"00AE","Brent",NA,13236,9547,19018,28900,17045,13371,20246,24676,3809,3824,1228,-4224
"575","Brent 022A","E01000488","E02000114","Brent 022","E09000005","Brent","E12000007","London",1576,1573,3,96.9,533,3,"00AE","Brent",NA,8471,7039,11970,26192,13368,11029,17415,20868,4897,3990,5445,-5324
"614","Brent 030A","E01000489","E02000122","Brent 030","E09000005","Brent","E12000007","London",1581,1581,0,49.5,593,2.7,"00AE","Brent",NA,13494,12072,18591,24524,14104,11736,16740,26844,610,-336,-1851,2320
"580","Brent 023A","E01000490","E02000115","Brent 023","E09000005","Brent","E12000007","London",1606,1606,0,121.6,787,2,"00AE","Brent",NA,9924,11735,12600,24238,9459,10928,12768,19342,-465,-807,168,-4896
"615","Brent 030B","E01000491","E02000122","Brent 030","E09000005","Brent","E12000007","London",1996,1989,7,53.7,806,2.5,"00AE","Brent",NA,10373,9824,11434,24174,12655,10918,13093,23370,2282,1094,1659,-804
"616","Brent 030C","E01000492","E02000122","Brent 030","E09000005","Brent","E12000007","London",1315,1306,9,83.1,467,2.8,"00AE","Brent",NA,15446,14920,20887,28014,19435,18471,21213,27198,3989,3551,326,-816
"617","Brent 030D","E01000493","E02000122","Brent 030","E09000005","Brent","E12000007","London",1637,1637,0,87.4,578,2.8,"00AE","Brent",NA,16185,16170,24343,27203,19871,16765,22334,28860,3686,595,-2009,1657
"581","Brent 023B","E01000494","E02000115","Brent 023","E09000005","Brent","E12000007","London",1738,1699,39,79.3,724,2.3,"00AE","Brent",NA,11331,9149,10827,30850,14510,9560,17534,27049,3179,411,6707,-3801
"582","Brent 023C","E01000495","E02000115","Brent 023","E09000005","Brent","E12000007","London",1574,1574,0,91.6,850,1.9,"00AE","Brent",NA,6193,7411,5604,21981,7022,7153,9019,19277,829,-258,3415,-2704
"518","Brent 011A","E01000497","E02000103","Brent 011","E09000005","Brent","E12000007","London",1756,1756,0,58.2,586,3,"00AE","Brent",NA,8597,5343,11334,21272,13047,9156,12914,18005,4450,3813,1580,-3267
"514","Brent 010B","E01000498","E02000102","Brent 010","E09000005","Brent","E12000007","London",1680,1680,0,59,457,3.7,"00AE","Brent",NA,10740,6952,15090,14797,10271,6885,13742,7193,-469,-67,-1348,-7604
"519","Brent 011B","E01000499","E02000103","Brent 011","E09000005","Brent","E12000007","London",1732,1732,0,32.8,500,3.5,"00AE","Brent",NA,9589,4950,11671,14497,8932,5126,13373,11322,-657,176,1702,-3175
"520","Brent 011C","E01000501","E02000103","Brent 011","E09000005","Brent","E12000007","London",1874,1874,0,116.7,734,2.6,"00AE","Brent",NA,6546,1975,7244,18739,5937,2865,6188,12119,-609,890,-1056,-6620
"521","Brent 011D","E01000502","E02000103","Brent 011","E09000005","Brent","E12000007","London",1393,1375,18,37,453,3,"00AE","Brent",NA,13171,8174,14782,26470,9243,8263,9965,13285,-3928,89,-4817,-13185
"522","Brent 011E","E01000503","E02000103","Brent 011","E09000005","Brent","E12000007","London",1968,1968,0,48.6,721,2.7,"00AE","Brent",NA,7351,5363,8634,25500,10760,8798,11584,15464,3409,3435,2950,-10036
"554","Brent 018A","E01000504","E02000110","Brent 018","E09000005","Brent","E12000007","London",1676,1676,0,115.5,676,2.5,"00AE","Brent",NA,9128,10039,8660,25919,12066,10991,12235,23362,2938,952,3575,-2557
"555","Brent 018B","E01000505","E02000110","Brent 018","E09000005","Brent","E12000007","London",1660,1660,0,106.1,525,3.2,"00AE","Brent",NA,12716,10995,12267,26389,13144,11908,14665,20182,428,913,2398,-6207
"532","Brent 014A","E01000506","E02000106","Brent 014","E09000005","Brent","E12000007","London",1671,1671,0,56.9,657,2.5,"00AE","Brent",NA,5531,4399,7645,20466,6733,5701,8450,13545,1202,1302,805,-6921
"556","Brent 018C","E01000507","E02000110","Brent 018","E09000005","Brent","E12000007","London",1634,1634,0,70.7,508,3.2,"00AE","Brent",NA,12615,10403,15350,26402,12155,8806,14637,18851,-460,-1597,-713,-7551
"589","Brent 025A","E01000508","E02000117","Brent 025","E09000005","Brent","E12000007","London",1961,1961,0,85.7,716,2.7,"00AE","Brent",NA,3672,3363,4038,16337,2804,2312,2767,7754,-868,-1051,-1271,-8583
"533","Brent 014B","E01000509","E02000106","Brent 014","E09000005","Brent","E12000007","London",1453,1453,0,112,430,3.4,"00AE","Brent",NA,10149,8469,13594,16431,6023,5763,11472,9065,-4126,-2706,-2122,-7366
"534","Brent 014C","E01000510","E02000106","Brent 014","E09000005","Brent","E12000007","London",1673,1673,0,95.1,533,3.1,"00AE","Brent",NA,9522,7082,12065,22482,7471,6785,13101,14583,-2051,-297,1036,-7899
"535","Brent 014D","E01000511","E02000106","Brent 014","E09000005","Brent","E12000007","London",1629,1629,0,96.7,543,3,"00AE","Brent",NA,8704,7372,11630,22992,7333,6177,12071,15128,-1371,-1195,441,-7864
"557","Brent 018D","E01000512","E02000110","Brent 018","E09000005","Brent","E12000007","London",1702,1702,0,111.9,610,2.8,"00AE","Brent",NA,10894,12855,19884,26124,14059,13658,19407,21580,3165,803,-477,-4544
"474","Brent 002A","E01000513","E02000094","Brent 002","E09000005","Brent","E12000007","London",1693,1638,55,100.8,471,3.5,"00AE","Brent",NA,14755,13784,21784,23763,17776,17509,23298,14859,3021,3725,1514,-8904
"475","Brent 002B","E01000514","E02000094","Brent 002","E09000005","Brent","E12000007","London",1512,1512,0,96.4,495,3.1,"00AE","Brent",NA,13400,10917,16053,24593,19661,15849,21952,22794,6261,4932,5899,-1799
"479","Brent 003A","E01000515","E02000095","Brent 003","E09000005","Brent","E12000007","London",1702,1698,4,44.5,628,2.7,"00AE","Brent",NA,8335,5086,12572,18820,9760,8804,12317,13910,1425,3718,-255,-4910
"476","Brent 002C","E01000516","E02000094","Brent 002","E09000005","Brent","E12000007","London",1707,1691,16,69.4,517,3.3,"00AE","Brent",NA,11200,7973,14746,24655,15891,14404,19471,16763,4691,6431,4725,-7892
"480","Brent 003B","E01000517","E02000095","Brent 003","E09000005","Brent","E12000007","London",1609,1609,0,70.1,491,3.3,"00AE","Brent",NA,16380,13727,16062,29581,20165,19882,29299,25317,3785,6155,13237,-4264
"489","Brent 005A","E01000518","E02000097","Brent 005","E09000005","Brent","E12000007","London",1662,1662,0,33.2,557,3,"00AE","Brent",NA,12421,9143,14481,20967,11638,11642,16006,17783,-783,2499,1525,-3184
"490","Brent 005B","E01000519","E02000097","Brent 005","E09000005","Brent","E12000007","London",1923,1923,0,26.2,629,3.1,"00AE","Brent",NA,11430,7782,11609,23642,13983,12756,18669,19013,2553,4974,7060,-4629
"477","Brent 002D","E01000520","E02000094","Brent 002","E09000005","Brent","E12000007","London",1637,1602,35,67.4,586,2.7,"00AE","Brent",NA,10264,7317,12825,26059,13868,13397,18709,18814,3604,6080,5884,-7245
"590","Brent 025B","E01000521","E02000117","Brent 025","E09000005","Brent","E12000007","London",2179,2167,12,154.5,905,2.4,"00AE","Brent",NA,1520,1634,2037,14539,1546,1558,1649,5543,26,-76,-388,-8996
"591","Brent 025C","E01000522","E02000117","Brent 025","E09000005","Brent","E12000007","London",1923,1923,0,133.6,710,2.7,"00AE","Brent",NA,7063,4078,7293,17034,7408,3873,7591,10210,345,-205,298,-6824
"619","Brent 031A","E01000523","E02000123","Brent 031","E09000005","Brent","E12000007","London",2610,2610,0,186.4,993,2.6,"00AE","Brent",NA,5417,2891,5128,14687,5769,5725,8352,5708,352,2834,3224,-8979
"620","Brent 031B","E01000524","E02000123","Brent 031","E09000005","Brent","E12000007","London",2514,2499,15,159.6,1035,2.4,"00AE","Brent",NA,2982,1919,3069,13503,2026,1396,3434,8533,-956,-523,365,-4970
"621","Brent 031C","E01000525","E02000123","Brent 031","E09000005","Brent","E12000007","London",1986,1986,0,127.2,785,2.5,"00AE","Brent",NA,5513,4668,6008,11950,4308,4535,5299,10036,-1205,-133,-709,-1914
"592","Brent 025D","E01000526","E02000117","Brent 025","E09000005","Brent","E12000007","London",2279,2226,53,164.4,813,2.7,"00AE","Brent",NA,3298,1638,4379,13254,3405,2219,3029,9329,107,581,-1350,-3925
"593","Brent 025E","E01000527","E02000117","Brent 025","E09000005","Brent","E12000007","London",2178,2174,4,172.3,813,2.7,"00AE","Brent",NA,5823,3857,4543,19792,5487,4687,6465,8715,-336,830,1922,-11077
"594","Brent 025F","E01000528","E02000117","Brent 025","E09000005","Brent","E12000007","London",1493,1493,0,134.3,600,2.5,"00AE","Brent",NA,1431,1036,3128,10462,2016,1301,1543,11653,585,265,-1585,1191
"631","Brent 033A","E01000530","E02000125","Brent 033","E09000005","Brent","E12000007","London",1824,1823,1,103.8,700,2.6,"00AE","Brent",NA,15378,13047,15999,26362,15876,14524,15813,27312,498,1477,-186,950
"632","Brent 033B","E01000531","E02000125","Brent 033","E09000005","Brent","E12000007","London",2077,2070,7,193,908,2.3,"00AE","Brent",NA,7350,5466,7613,21754,9550,7505,11151,19097,2200,2039,3538,-2657
"633","Brent 033C","E01000532","E02000125","Brent 033","E09000005","Brent","E12000007","London",1630,1630,0,158.7,733,2.2,"00AE","Brent",NA,8444,9524,6539,19863,13072,12613,14333,19005,4628,3089,7794,-858
"622","Brent 031E","E01000533","E02000123","Brent 031","E09000005","Brent","E12000007","London",2259,2259,0,121,952,2.4,"00AE","Brent",NA,3604,3215,3181,16180,3536,3600,4706,9780,-68,385,1525,-6400
"634","Brent 033D","E01000534","E02000125","Brent 033","E09000005","Brent","E12000007","London",1775,1771,4,115.6,651,2.7,"00AE","Brent",NA,10687,8391,13593,27995,12737,10037,13825,21197,2050,1646,232,-6798
"623","Brent 031F","E01000535","E02000123","Brent 031","E09000005","Brent","E12000007","London",2170,2170,0,115.4,829,2.6,"00AE","Brent",NA,8104,9479,13286,24191,8157,9890,13291,14271,53,411,5,-9920
"484","Brent 004A","E01000536","E02000096","Brent 004","E09000005","Brent","E12000007","London",1573,1561,12,47.2,522,3,"00AE","Brent",NA,18315,20196,23608,30750,22663,21019,24904,29298,4348,823,1296,-1452
"485","Brent 004B","E01000538","E02000096","Brent 004","E09000005","Brent","E12000007","London",1582,1554,28,39.7,478,3.3,"00AE","Brent",NA,23379,26116,27005,30310,26424,24215,28798,30464,3045,-1901,1793,154
"486","Brent 004C","E01000539","E02000096","Brent 004","E09000005","Brent","E12000007","London",1541,1541,0,54.2,548,2.8,"00AE","Brent",NA,21418,16535,26891,31345,24208,21316,27174,29056,2790,4781,283,-2289
"487","Brent 004D","E01000540","E02000096","Brent 004","E09000005","Brent","E12000007","London",1496,1477,19,39.8,471,3.1,"00AE","Brent",NA,17621,18395,22753,31184,23205,20977,24950,29656,5584,2582,2197,-1528
"488","Brent 004E","E01000541","E02000096","Brent 004","E09000005","Brent","E12000007","London",1406,1402,4,57.7,499,2.8,"00AE","Brent",NA,13163,11840,15414,29971,17467,16959,23068,27340,4304,5119,7654,-2631
"481","Brent 003E","E01000543","E02000095","Brent 003","E09000005","Brent","E12000007","London",1596,1596,0,81.4,500,3.2,"00AE","Brent",NA,11391,9099,16460,23310,12186,12170,16776,23569,795,3071,316,259
"637","Brent 034A","E01000544","E02000126","Brent 034","E09000005","Brent","E12000007","London",1777,1777,0,246.5,742,2.4,"00AE","Brent",NA,2951,2115,4472,15106,4326,2561,4773,16953,1375,446,301,1847
"604","Brent 028A","E01000545","E02000120","Brent 028","E09000005","Brent","E12000007","London",1809,1809,0,156.1,856,2.1,"00AE","Brent",NA,5989,10523,9692,23508,8170,10965,12065,23856,2181,442,2373,348
"605","Brent 028B","E01000546","E02000120","Brent 028","E09000005","Brent","E12000007","London",1645,1645,0,173.2,756,2.2,"00AE","Brent",NA,10367,11922,12537,27053,11842,11489,13656,27651,1475,-433,1119,598
"606","Brent 028C","E01000547","E02000120","Brent 028","E09000005","Brent","E12000007","London",1780,1780,0,234.8,768,2.3,"00AE","Brent",NA,10699,10213,8493,25039,12127,11526,12411,26912,1428,1313,3918,1873
"607","Brent 028D","E01000548","E02000120","Brent 028","E09000005","Brent","E12000007","London",2044,2034,10,188.9,1014,2,"00AE","Brent",NA,3686,5244,4971,19395,6002,6445,9030,18518,2316,1201,4059,-877
"608","Brent 028E","E01000549","E02000120","Brent 028","E09000005","Brent","E12000007","London",1936,1936,0,174.1,883,2.2,"00AE","Brent",NA,10383,9787,9928,22762,17220,14166,16925,28632,6837,4379,6997,5870
"638","Brent 034B","E01000550","E02000126","Brent 034","E09000005","Brent","E12000007","London",1966,1941,25,138.1,906,2.1,"00AE","Brent",NA,1957,2739,2845,15072,5037,4681,6521,18331,3080,1942,3676,3259
"639","Brent 034C","E01000551","E02000126","Brent 034","E09000005","Brent","E12000007","London",2215,2203,12,162,940,2.3,"00AE","Brent",NA,1317,477,1636,13629,2719,1426,2476,11873,1402,949,840,-1756
"640","Brent 034D","E01000552","E02000126","Brent 034","E09000005","Brent","E12000007","London",1817,1817,0,209.6,793,2.3,"00AE","Brent",NA,2814,2345,2736,14067,2223,1578,1795,10387,-591,-767,-941,-3680
"538","Brent 015A","E01000553","E02000107","Brent 015","E09000005","Brent","E12000007","London",2100,2096,4,147.6,696,3,"00AE","Brent",NA,7765,6942,6180,20096,8430,7406,10757,11485,665,464,4577,-8611
"539","Brent 015B","E01000554","E02000107","Brent 015","E09000005","Brent","E12000007","London",1857,1857,0,85.7,683,2.7,"00AE","Brent",NA,9333,7195,12798,15765,11041,8045,11082,19952,1708,850,-1716,4187
"540","Brent 015C","E01000555","E02000107","Brent 015","E09000005","Brent","E12000007","London",1497,1497,0,72.4,512,2.9,"00AE","Brent",NA,16049,15870,13986,29682,17367,14299,18190,24633,1318,-1571,4204,-5049
"541","Brent 015D","E01000556","E02000107","Brent 015","E09000005","Brent","E12000007","London",1869,1869,0,190.9,800,2.3,"00AE","Brent",NA,5314,7101,10347,23444,5417,7924,11194,13087,103,823,847,-10357
"542","Brent 015E","E01000557","E02000107","Brent 015","E09000005","Brent","E12000007","London",1861,1841,20,158.8,751,2.5,"00AE","Brent",NA,11850,13052,14968,24392,12417,11494,14832,26055,567,-1558,-136,1663
"543","Brent 015F","E01000558","E02000107","Brent 015","E09000005","Brent","E12000007","London",1508,1465,43,86.8,665,2.2,"00AE","Brent",NA,9627,11809,10099,28707,10501,10230,10452,24142,874,-1579,353,-4565
"558","Brent 018E","E01000559","E02000110","Brent 018","E09000005","Brent","E12000007","London",1415,1411,4,124,650,2.2,"00AE","Brent",NA,8879,9977,11528,26119,13049,11752,14499,20030,4170,1775,2971,-6089
"583","Brent 023D","E01000560","E02000115","Brent 023","E09000005","Brent","E12000007","London",1617,1614,3,77.9,727,2.2,"00AE","Brent",NA,13219,13783,13677,30121,15320,17548,18590,20197,2101,3765,4913,-9924
"584","Brent 023E","E01000561","E02000115","Brent 023","E09000005","Brent","E12000007","London",1805,1805,0,153,823,2.2,"00AE","Brent",NA,10218,8608,12878,24073,11438,8121,12968,26725,1220,-487,90,2652
"504","Brent 008A","E01000562","E02000100","Brent 008","E09000005","Brent","E12000007","London",1548,1543,5,49.6,480,3.2,"00AE","Brent",NA,20434,18349,22111,29778,22052,19034,27237,29134,1618,685,5126,-644
"505","Brent 008B","E01000563","E02000100","Brent 008","E09000005","Brent","E12000007","London",1480,1480,0,39.5,474,3.1,"00AE","Brent",NA,20603,17200,23246,30757,23008,23715,25967,29254,2405,6515,2721,-1503
"527","Brent 013A","E01000564","E02000105","Brent 013","E09000005","Brent","E12000007","London",1570,1557,13,77.5,460,3.4,"00AE","Brent",NA,9759,7223,12439,26205,15579,15373,20207,18577,5820,8150,7768,-7628
"528","Brent 013B","E01000565","E02000105","Brent 013","E09000005","Brent","E12000007","London",1473,1467,6,79.4,497,3,"00AE","Brent",NA,8384,6151,6214,25027,10807,7844,11804,16729,2423,1693,5590,-8298
"506","Brent 008C","E01000566","E02000100","Brent 008","E09000005","Brent","E12000007","London",1535,1531,4,73.5,475,3.2,"00AE","Brent",NA,16824,14663,21520,28937,18443,17400,22772,24327,1619,2737,1252,-4610
"544","Brent 016A","E01000567","E02000108","Brent 016","E09000005","Brent","E12000007","London",1380,1372,8,66.9,486,2.8,"00AE","Brent",NA,12666,11162,15514,24480,15214,14174,16347,22881,2548,3012,833,-1599
"507","Brent 008D","E01000568","E02000100","Brent 008","E09000005","Brent","E12000007","London",2260,1599,661,28.1,787,2,"00AE","Brent",NA,21318,27865,29394,28710,19206,28542,31746,31921,-2112,677,2352,3211
"508","Brent 008E","E01000569","E02000100","Brent 008","E09000005","Brent","E12000007","London",1565,1565,0,41.5,480,3.3,"00AE","Brent",NA,19857,13833,24369,28338,24540,19961,28823,28794,4683,6128,4454,456
"523","Brent 012A","E01000570","E02000104","Brent 012","E09000005","Brent","E12000007","London",1579,1578,1,118.4,513,3.1,"00AE","Brent",NA,10371,6467,10133,19880,9860,8445,10510,16804,-511,1978,377,-3076
"524","Brent 012B","E01000571","E02000104","Brent 012","E09000005","Brent","E12000007","London",1707,1666,41,48.5,477,3.5,"00AE","Brent",NA,13123,8666,15951,26938,13409,12255,13763,21531,286,3589,-2188,-5407
"499","Brent 007A","E01000572","E02000099","Brent 007","E09000005","Brent","E12000007","London",1481,1481,0,68.8,462,3.2,"00AE","Brent",NA,17449,12595,23940,29639,21906,19015,27942,25312,4457,6420,4002,-4327
"500","Brent 007B","E01000573","E02000099","Brent 007","E09000005","Brent","E12000007","London",1596,1591,5,67.7,474,3.4,"00AE","Brent",NA,14347,8943,15097,27001,19745,15941,26326,24465,5398,6998,11229,-2536
"501","Brent 007C","E01000574","E02000099","Brent 007","E09000005","Brent","E12000007","London",1355,1355,0,61.5,428,3.2,"00AE","Brent",NA,16005,13248,21026,30023,21395,17979,27347,23957,5390,4731,6321,-6066
"502","Brent 007D","E01000575","E02000099","Brent 007","E09000005","Brent","E12000007","London",1855,1855,0,68.8,625,3,"00AE","Brent",NA,12561,9834,17852,23783,17078,18804,26057,24484,4517,8970,8205,701
"525","Brent 012C","E01000576","E02000104","Brent 012","E09000005","Brent","E12000007","London",1660,1660,0,56.8,534,3.1,"00AE","Brent",NA,14546,13214,20693,29826,18536,17444,23106,23795,3990,4230,2413,-6031
"503","Brent 007E","E01000577","E02000099","Brent 007","E09000005","Brent","E12000007","London",2420,2369,51,69.9,793,3,"00AE","Brent",NA,5775,2114,8325,16855,7362,4628,9141,13767,1587,2514,816,-3088
"526","Brent 012D","E01000578","E02000104","Brent 012","E09000005","Brent","E12000007","London",1821,1761,60,55.1,689,2.6,"00AE","Brent",NA,10959,8953,13146,24742,9740,9590,11920,20244,-1219,637,-1226,-4498
"626","Brent 032A","E01000579","E02000124","Brent 032","E09000005","Brent","E12000007","London",1665,1659,6,147.6,683,2.4,"00AE","Brent",NA,10180,11345,13308,15223,9716,9993,10489,22330,-464,-1352,-2819,7107
"627","Brent 032B","E01000580","E02000124","Brent 032","E09000005","Brent","E12000007","London",1980,1944,36,44.4,821,2.4,"00AE","Brent",NA,9432,11213,8342,23954,13028,11269,13102,26700,3596,56,4760,2746
"618","Brent 030E","E01000581","E02000122","Brent 030","E09000005","Brent","E12000007","London",1550,1550,0,93.5,603,2.6,"00AE","Brent",NA,12756,13580,15785,26635,18047,15589,18784,28949,5291,2009,2999,2314
"628","Brent 032C","E01000582","E02000124","Brent 032","E09000005","Brent","E12000007","London",1847,1847,0,95.5,720,2.6,"00AE","Brent",NA,16639,16278,18996,30922,18983,18476,23187,31420,2344,2198,4191,498
"629","Brent 032D","E01000583","E02000124","Brent 032","E09000005","Brent","E12000007","London",2273,2262,11,116.4,1017,2.2,"00AE","Brent",NA,9006,10232,9105,25464,13504,15913,14232,25931,4498,5681,5127,467
"635","Brent 033E","E01000584","E02000125","Brent 033","E09000005","Brent","E12000007","London",1695,1695,0,134.7,619,2.7,"00AE","Brent",NA,15397,13590,18727,26926,19076,17653,20470,22197,3679,4063,1743,-4729
"636","Brent 033F","E01000585","E02000125","Brent 033","E09000005","Brent","E12000007","London",1814,1814,0,180.9,718,2.5,"00AE","Brent",NA,12117,13080,13891,19038,18741,17512,21983,21121,6624,4432,8092,2083
"630","Brent 032E","E01000586","E02000124","Brent 032","E09000005","Brent","E12000007","London",2457,2456,1,164.5,1093,2.2,"00AE","Brent",NA,6345,9115,9044,19286,9718,11262,15341,15575,3373,2147,6297,-3711
"468","Brent 001A","E01000587","E02000093","Brent 001","E09000005","Brent","E12000007","London",1708,1653,55,86.3,458,3.6,"00AE","Brent",NA,15682,12185,18252,23919,18779,14735,25400,16949,3097,2550,7148,-6970
"478","Brent 002E","E01000588","E02000094","Brent 002","E09000005","Brent","E12000007","London",2197,2197,0,62.8,669,3.3,"00AE","Brent",NA,11016,6834,11539,23659,11154,7891,11677,13689,138,1057,138,-9970
"469","Brent 001B","E01000589","E02000093","Brent 001","E09000005","Brent","E12000007","London",1932,1884,48,66.4,592,3.2,"00AE","Brent",NA,12598,8890,13381,23483,14793,14296,19254,18289,2195,5406,5873,-5194
"470","Brent 001C","E01000590","E02000093","Brent 001","E09000005","Brent","E12000007","London",1789,1789,0,67,626,2.9,"00AE","Brent",NA,18380,14125,21171,26151,17374,13408,20154,23705,-1006,-717,-1017,-2446
"482","Brent 003F","E01000591","E02000095","Brent 003","E09000005","Brent","E12000007","London",2075,2075,0,64.3,650,3.2,"00AE","Brent",NA,13885,8458,18733,22628,12795,15356,18408,19288,-1090,6898,-325,-3340
"471","Brent 001D","E01000592","E02000093","Brent 001","E09000005","Brent","E12000007","London",1622,1618,4,81.9,525,3.1,"00AE","Brent",NA,13121,11911,13487,24259,14170,13314,17888,19465,1049,1403,4401,-4794
"472","Brent 001E","E01000593","E02000093","Brent 001","E09000005","Brent","E12000007","London",2134,2134,0,118.1,680,3.1,"00AE","Brent",NA,12450,8232,13251,22162,13896,10504,15258,19657,1446,2272,2007,-2505
"473","Brent 001F","E01000594","E02000093","Brent 001","E09000005","Brent","E12000007","London",1698,1698,0,69.9,527,3.2,"00AE","Brent",NA,11215,10247,16692,25247,15517,15632,22796,20261,4302,5385,6104,-4986
"600","Brent 027A","E01000595","E02000119","Brent 027","E09000005","Brent","E12000007","London",1685,1685,0,87.8,582,2.9,"00AE","Brent",NA,1782,448,3503,10162,2369,1735,3374,5627,587,1287,-129,-4535
"569","Brent 021A","E01000596","E02000113","Brent 021","E09000005","Brent","E12000007","London",1694,1694,0,89.3,640,2.6,"00AE","Brent",NA,3555,1237,4757,10504,1966,1442,4155,4735,-1589,205,-602,-5769
"601","Brent 027D","E01000599","E02000119","Brent 027","E09000005","Brent","E12000007","London",1308,1308,0,149.5,489,2.7,"00AE","Brent",NA,2072,1728,1962,14613,3616,1608,3822,12759,1544,-120,1860,-1854
"602","Brent 027E","E01000600","E02000119","Brent 027","E09000005","Brent","E12000007","London",2047,2029,18,10.1,783,2.6,"00AE","Brent",NA,857,835,108,14753,4834,3532,5511,9319,3977,2697,5403,-5434
"570","Brent 021B","E01000601","E02000113","Brent 021","E09000005","Brent","E12000007","London",1505,1505,0,21.6,477,3.2,"00AE","Brent",NA,2313,829,5238,11651,1159,409,3597,4365,-1154,-420,-1641,-7286
"571","Brent 021C","E01000602","E02000113","Brent 021","E09000005","Brent","E12000007","London",1541,1541,0,114.9,512,3,"00AE","Brent",NA,3286,2521,5642,10857,3147,4014,4934,8718,-139,1493,-708,-2139
"572","Brent 021D","E01000603","E02000113","Brent 021","E09000005","Brent","E12000007","London",1487,1487,0,121.1,576,2.6,"00AE","Brent",NA,6854,4762,11266,16542,4194,2758,7228,10349,-2660,-2004,-4038,-6193
"573","Brent 021E","E01000604","E02000113","Brent 021","E09000005","Brent","E12000007","London",1766,1766,0,104.5,548,3.2,"00AE","Brent",NA,2586,932,3009,9411,3828,4043,4881,10329,1242,3111,1872,918
"574","Brent 021F","E01000605","E02000113","Brent 021","E09000005","Brent","E12000007","London",1662,1662,0,96.9,553,3,"00AE","Brent",NA,3453,2068,3656,11538,3113,1541,4178,7614,-340,-527,522,-3924
"545","Brent 016B","E01000606","E02000108","Brent 016","E09000005","Brent","E12000007","London",1710,1703,7,72.6,567,3,"00AE","Brent",NA,10462,7053,12691,24489,14024,14212,15941,18611,3562,7159,3250,-5878
"529","Brent 013C","E01000607","E02000105","Brent 013","E09000005","Brent","E12000007","London",2223,2214,9,113.2,667,3.3,"00AE","Brent",NA,10500,8308,11678,23002,15496,13850,21708,22499,4996,5542,10030,-503
"530","Brent 013D","E01000608","E02000105","Brent 013","E09000005","Brent","E12000007","London",2263,2263,0,39.9,734,3.1,"00AE","Brent",NA,8256,6710,12754,23131,10875,13195,17776,18265,2619,6485,5022,-4866
"546","Brent 016C","E01000609","E02000108","Brent 016","E09000005","Brent","E12000007","London",2079,2075,4,83.8,640,3.2,"00AE","Brent",NA,9464,7161,11423,19809,12781,13514,18950,17603,3317,6353,7527,-2206
"559","Brent 019A","E01000610","E02000111","Brent 019","E09000005","Brent","E12000007","London",1935,1870,65,67.7,621,3,"00AE","Brent",NA,9202,8312,13037,26890,9688,10700,13311,18394,486,2388,274,-8496
"547","Brent 016D","E01000611","E02000108","Brent 016","E09000005","Brent","E12000007","London",1415,1415,0,115,454,3.1,"00AE","Brent",NA,7124,4969,6922,15319,12736,14693,12337,19440,5612,9724,5415,4121
"560","Brent 019B","E01000612","E02000111","Brent 019","E09000005","Brent","E12000007","London",1652,1652,0,64.6,521,3.2,"00AE","Brent",NA,10249,8794,15059,20524,11932,10665,16191,19355,1683,1871,1132,-1169
"531","Brent 013E","E01000613","E02000105","Brent 013","E09000005","Brent","E12000007","London",1673,1659,14,76.8,639,2.6,"00AE","Brent",NA,8695,7770,12013,26919,9458,10338,13767,15750,763,2568,1754,-11169
"548","Brent 017B","E01000615","E02000109","Brent 017","E09000005","Brent","E12000007","London",1603,1603,0,24.1,563,2.8,"00AE","Brent",NA,12629,9534,18536,19380,14460,15612,19665,18550,1831,6078,1129,-830
"564","Brent 020A","E01000616","E02000112","Brent 020","E09000005","Brent","E12000007","London",1747,1747,0,102.3,586,3,"00AE","Brent",NA,8967,7768,14356,24976,13026,15023,18342,20637,4059,7255,3986,-4339
"549","Brent 017C","E01000617","E02000109","Brent 017","E09000005","Brent","E12000007","London",1750,1741,9,64.5,528,3.3,"00AE","Brent",NA,8611,6386,11650,21174,11795,12511,15609,17508,3184,6125,3959,-3666
"550","Brent 017D","E01000618","E02000109","Brent 017","E09000005","Brent","E12000007","London",1639,1639,0,89.8,500,3.3,"00AE","Brent",NA,14896,10023,18490,20006,11657,10301,15203,12845,-3239,278,-3287,-7161
"551","Brent 017E","E01000619","E02000109","Brent 017","E09000005","Brent","E12000007","London",1652,1652,0,77.4,473,3.5,"00AE","Brent",NA,13445,10115,15384,15698,13761,15792,15076,12629,316,5677,-308,-3069
"565","Brent 020B","E01000620","E02000112","Brent 020","E09000005","Brent","E12000007","London",1715,1637,78,39.1,500,3.3,"00AE","Brent",NA,10294,10107,14412,17456,13582,13239,17468,12841,3288,3132,3056,-4615
"566","Brent 020C","E01000621","E02000112","Brent 020","E09000005","Brent","E12000007","London",1779,1774,5,83.3,514,3.5,"00AE","Brent",NA,8927,6404,13419,18139,10821,14369,18165,11750,1894,7965,4746,-6389
"515","Brent 010D","E01000622","E02000102","Brent 010","E09000005","Brent","E12000007","London",1585,1585,0,25.3,636,2.5,"00AE","Brent",NA,7990,7178,9429,21919,8388,10525,13879,14328,398,3347,4450,-7591
"491","Brent 005C","E01000623","E02000097","Brent 005","E09000005","Brent","E12000007","London",1772,1772,0,92.6,541,3.3,"00AE","Brent",NA,14265,10953,15366,23069,17785,17717,21934,17229,3520,6764,6568,-5840
"492","Brent 005D","E01000624","E02000097","Brent 005","E09000005","Brent","E12000007","London",1690,1690,0,64.1,594,2.8,"00AE","Brent",NA,14185,11174,15162,24479,16597,13810,20497,17552,2412,2636,5335,-6927
"513","Brent 009E","E01000625","E02000101","Brent 009","E09000005","Brent","E12000007","London",1504,1469,35,56.2,557,2.6,"00AE","Brent",NA,13124,11889,18420,28144,12976,12389,17259,15206,-148,500,-1161,-12938
"516","Brent 010E","E01000626","E02000102","Brent 010","E09000005","Brent","E12000007","London",1500,1500,0,72.3,590,2.5,"00AE","Brent",NA,4723,2362,5237,12276,4223,3060,4738,10884,-500,698,-499,-1392
"536","Brent 014E","E01000627","E02000106","Brent 014","E09000005","Brent","E12000007","London",1900,1900,0,86.1,653,2.9,"00AE","Brent",NA,6591,4216,9018,13634,4358,4206,6762,7310,-2233,-10,-2256,-6324
"537","Brent 014F","E01000628","E02000106","Brent 014","E09000005","Brent","E12000007","London",1891,1882,9,53.6,633,3,"00AE","Brent",NA,8412,8222,11308,21210,6566,6074,8094,15316,-1846,-2148,-3214,-5894
"493","Brent 005E","E01000629","E02000097","Brent 005","E09000005","Brent","E12000007","London",1911,1911,0,104.4,605,3.2,"00AE","Brent",NA,14085,10652,13733,18190,15004,14409,18386,14673,919,3757,4653,-3517
"599","Brent 026E","E01000630","E02000118","Brent 026","E09000005","Brent","E12000007","London",2254,2254,0,78.8,768,2.9,"00AE","Brent",NA,4010,4690,5171,17395,7804,7212,9873,16639,3794,2522,4702,-756
"561","Brent 019C","E01000631","E02000111","Brent 019","E09000005","Brent","E12000007","London",1882,1882,0,74.4,522,3.6,"00AE","Brent",NA,11996,11884,14564,19722,15814,14842,22192,20178,3818,2958,7628,456
"613","Brent 029E","E01000632","E02000121","Brent 029","E09000005","Brent","E12000007","London",2087,2087,0,73.3,548,3.8,"00AE","Brent",NA,11359,11362,16753,14472,14797,17023,24438,14527,3438,5661,7685,55
"562","Brent 019D","E01000633","E02000111","Brent 019","E09000005","Brent","E12000007","London",1970,1949,21,119.7,554,3.5,"00AE","Brent",NA,5952,6885,11551,12719,11113,14068,20205,15099,5161,7183,8654,2380
"563","Brent 019E","E01000634","E02000111","Brent 019","E09000005","Brent","E12000007","London",2343,2343,0,139,696,3.4,"00AE","Brent",NA,7848,5757,11043,16881,12295,11953,17672,16718,4447,6196,6629,-163
"567","Brent 020D","E01000635","E02000112","Brent 020","E09000005","Brent","E12000007","London",2415,2392,23,103.9,774,3.1,"00AE","Brent",NA,7140,5986,9923,19613,8643,8846,13835,17952,1503,2860,3912,-1661
"568","Brent 020E","E01000636","E02000112","Brent 020","E09000005","Brent","E12000007","London",1776,1776,0,83.3,518,3.4,"00AE","Brent",NA,8897,10437,12500,18952,14769,14832,17647,16450,5872,4395,5147,-2502
"576","Brent 022B","E01000637","E02000114","Brent 022","E09000005","Brent","E12000007","London",1675,1675,0,233,636,2.6,"00AE","Brent",NA,8557,6575,9096,23217,9469,7474,9940,17366,912,899,844,-5851
"585","Brent 024A","E01000638","E02000116","Brent 024","E09000005","Brent","E12000007","London",1939,1939,0,66,715,2.7,"00AE","Brent",NA,5760,7144,6952,13018,6732,8667,12876,13311,972,1523,5924,293
"577","Brent 022C","E01000639","E02000114","Brent 022","E09000005","Brent","E12000007","London",1757,1757,0,181.9,716,2.5,"00AE","Brent",NA,10872,12711,18872,20654,13391,16857,20059,22059,2519,4146,1187,1405
"586","Brent 024B","E01000640","E02000116","Brent 024","E09000005","Brent","E12000007","London",2123,2123,0,172.2,802,2.6,"00AE","Brent",NA,3477,4770,7300,16592,6601,9126,12581,11316,3124,4356,5281,-5276
"587","Brent 024C","E01000641","E02000116","Brent 024","E09000005","Brent","E12000007","London",1945,1945,0,180.3,715,2.7,"00AE","Brent",NA,6192,3061,7470,17001,6793,5827,9445,11574,601,2766,1975,-5427
"578","Brent 022D","E01000642","E02000114","Brent 022","E09000005","Brent","E12000007","London",2054,2044,10,129.1,915,2.2,"00AE","Brent",NA,5818,6701,6708,18521,8373,8847,12878,18056,2555,2146,6170,-465
"588","Brent 024D","E01000643","E02000116","Brent 024","E09000005","Brent","E12000007","London",2146,2139,7,37.6,840,2.5,"00AE","Brent",NA,1228,900,671,16186,1547,1472,1904,11251,319,572,1233,-4935
"579","Brent 022E","E01000644","E02000114","Brent 022","E09000005","Brent","E12000007","London",1948,1948,0,158.1,728,2.7,"00AE","Brent",NA,7506,6236,9415,21545,9761,7627,12567,19378,2255,1391,3152,-2167
"667","Bromley 007A","E01000645","E02000133","Bromley 007","E09000006","Bromley","E12000007","London",1375,1375,0,17.6,536,2.6,"00AF","Bromley",NA,29573,32220,31392,31975,31974,32792,32674,32505,2401,572,1282,530
"715","Bromley 016A","E01000646","E02000142","Bromley 016","E09000006","Bromley","E12000007","London",1641,1564,77,46.6,728,2.1,"00AF","Bromley",NA,27682,24343,27904,25289,25139,21219,23021,30878,-2543,-3124,-4883,5589
"716","Bromley 016B","E01000647","E02000142","Bromley 016","E09000006","Bromley","E12000007","London",1609,1609,0,63.9,635,2.5,"00AF","Bromley",NA,25178,20147,23954,25548,28173,24404,28055,27442,2995,4257,4101,1894
"717","Bromley 016C","E01000648","E02000142","Bromley 016","E09000006","Bromley","E12000007","London",1744,1708,36,46,646,2.6,"00AF","Bromley",NA,26889,21852,24279,29854,28427,26092,26535,28618,1538,4240,2256,-1236
"668","Bromley 007B","E01000649","E02000133","Bromley 007","E09000006","Bromley","E12000007","London",1981,1899,82,23.2,774,2.5,"00AF","Bromley",NA,25979,24693,24278,31847,24181,21041,25339,30948,-1798,-3652,1061,-899
"740","Bromley 022A","E01000650","E02000148","Bromley 022","E09000006","Bromley","E12000007","London",1911,1880,31,21.6,750,2.5,"00AF","Bromley",NA,25024,22736,25947,31973,22910,21370,24791,31782,-2114,-1366,-1156,-191
"730","Bromley 020A","E01000651","E02000146","Bromley 020","E09000006","Bromley","E12000007","London",1628,1474,154,56,631,2.3,"00AF","Bromley",NA,25729,23151,25725,30159,23790,20442,27486,30800,-1939,-2709,1761,641
"741","Bromley 022B","E01000652","E02000148","Bromley 022","E09000006","Bromley","E12000007","London",1625,1625,0,28.1,659,2.5,"00AF","Bromley",NA,28609,29659,28143,27080,30316,28841,28562,28422,1707,-818,419,1342
"718","Bromley 016D","E01000653","E02000142","Bromley 016","E09000006","Bromley","E12000007","London",1584,1487,97,31.9,608,2.4,"00AF","Bromley",NA,26421,23051,21748,31038,26162,24905,24562,26928,-259,1854,2814,-4110
"819","Bromley 039A","E01000654","E02000165","Bromley 039","E09000006","Bromley","E12000007","London",1273,1273,0,12,486,2.6,"00AF","Bromley",NA,24638,23120,27414,15964,25924,28215,26943,13505,1286,5095,-471,-2459
"820","Bromley 039B","E01000655","E02000165","Bromley 039","E09000006","Bromley","E12000007","London",1323,1323,0,34.8,494,2.7,"00AF","Bromley",NA,24805,26539,29002,16135,23230,21722,25880,15079,-1575,-4817,-3122,-1056
"821","Bromley 039C","E01000656","E02000165","Bromley 039","E09000006","Bromley","E12000007","London",1400,1400,0,4.1,517,2.7,"00AF","Bromley",NA,29681,27896,28985,24180,28095,28788,28262,17555,-1586,892,-723,-6625
"822","Bromley 039D","E01000657","E02000165","Bromley 039","E09000006","Bromley","E12000007","London",1587,1587,0,51.6,674,2.4,"00AF","Bromley",NA,22520,18678,21604,16091,21563,18348,19519,14681,-957,-330,-2085,-1410
"834","Bromley 042A","E01000658","E02006789","Bromley 042","E09000006","Bromley","E12000007","London",1358,1358,0,6.3,550,2.5,"00AF","Bromley",NA,27843,27822,26695,20185,27660,22590,25893,21317,-183,-5232,-802,1132
"823","Bromley 039E","E01000659","E02000165","Bromley 039","E09000006","Bromley","E12000007","London",1462,1462,0,28.7,520,2.8,"00AF","Bromley",NA,27496,29172,29095,17676,24907,20417,21954,16991,-2589,-8755,-7141,-685
"759","Bromley 026A","E01000661","E02000152","Bromley 026","E09000006","Bromley","E12000007","London",1594,1583,11,17,671,2.4,"00AF","Bromley",NA,4494,2775,4275,8815,2184,1058,3123,7498,-2310,-1717,-1152,-1317
"760","Bromley 026B","E01000662","E02000152","Bromley 026","E09000006","Bromley","E12000007","London",1741,1741,0,33.2,680,2.6,"00AF","Bromley",NA,14570,10989,12681,12357,15760,13483,12395,14145,1190,2494,-286,1788
"761","Bromley 026C","E01000663","E02000152","Bromley 026","E09000006","Bromley","E12000007","London",1627,1627,0,51,660,2.5,"00AF","Bromley",NA,15391,11712,15988,13055,15170,11328,11236,18338,-221,-384,-4752,5283
"762","Bromley 026D","E01000664","E02000152","Bromley 026","E09000006","Bromley","E12000007","London",1610,1610,0,20.3,612,2.6,"00AF","Bromley",NA,15206,12644,17614,17690,15545,14250,15679,16319,339,1606,-1935,-1371
"796","Bromley 033A","E01000665","E02000159","Bromley 033","E09000006","Bromley","E12000007","London",1815,1815,0,21.8,757,2.4,"00AF","Bromley",NA,20083,15772,23190,23525,21513,17343,18389,22152,1430,1571,-4801,-1373
"797","Bromley 033B","E01000666","E02000159","Bromley 033","E09000006","Bromley","E12000007","London",1814,1814,0,6.1,776,2.3,"00AF","Bromley",NA,28287,29593,28389,28374,30605,30290,30458,26316,2318,697,2069,-2058
"798","Bromley 033C","E01000667","E02000159","Bromley 033","E09000006","Bromley","E12000007","London",1620,1620,0,15.3,622,2.6,"00AF","Bromley",NA,29007,31239,28788,28666,29178,31351,30427,27352,171,112,1639,-1314
"731","Bromley 020B","E01000668","E02000146","Bromley 020","E09000006","Bromley","E12000007","London",1620,1620,0,23.1,691,2.3,"00AF","Bromley",NA,21074,18356,25054,23526,21632,18063,20781,23767,558,-293,-4273,241
"732","Bromley 020C","E01000669","E02000146","Bromley 020","E09000006","Bromley","E12000007","London",1672,1672,0,96.5,740,2.3,"00AF","Bromley",NA,21590,20767,20698,24322,25534,20826,22311,24614,3944,59,1613,292
"720","Bromley 018A","E01000670","E02000144","Bromley 018","E09000006","Bromley","E12000007","London",1932,1926,6,39.9,864,2.2,"00AF","Bromley",NA,29555,27465,24859,32099,27655,29166,30230,32164,-1900,1701,5371,65
"733","Bromley 020D","E01000671","E02000146","Bromley 020","E09000006","Bromley","E12000007","London",1744,1744,0,50.9,784,2.2,"00AF","Bromley",NA,21982,18642,23422,29570,23067,18934,23275,30103,1085,292,-147,533
"690","Bromley 011A","E01000672","E02000137","Bromley 011","E09000006","Bromley","E12000007","London",1520,1461,59,46.5,650,2.2,"00AF","Bromley",NA,26184,25674,25708,28656,26102,25128,26465,29083,-82,-546,757,427
"691","Bromley 011B","E01000673","E02000137","Bromley 011","E09000006","Bromley","E12000007","London",1571,1562,9,32.9,630,2.5,"00AF","Bromley",NA,22579,21835,23109,25862,25303,22652,24290,28958,2724,817,1181,3096
"673","Bromley 008A","E01000674","E02000134","Bromley 008","E09000006","Bromley","E12000007","London",1564,1545,19,77.7,802,1.9,"00AF","Bromley",NA,16366,15552,16987,24918,20072,16602,21027,26177,3706,1050,4040,1259
"721","Bromley 018B","E01000675","E02000144","Bromley 018","E09000006","Bromley","E12000007","London",1624,1612,12,28.2,690,2.3,"00AF","Bromley",NA,16321,23576,18496,28733,20532,20032,18139,30760,4211,-3544,-357,2027
"674","Bromley 008B","E01000676","E02000134","Bromley 008","E09000006","Bromley","E12000007","London",1735,1729,6,52.3,866,2,"00AF","Bromley",NA,9306,9157,10078,16613,10169,8014,12610,19370,863,-1143,2532,2757
"722","Bromley 018C","E01000677","E02000144","Bromley 018","E09000006","Bromley","E12000007","London",1769,1769,0,46.4,800,2.2,"00AF","Bromley",NA,17817,17774,24694,26207,19350,21654,27480,28501,1533,3880,2786,2294
"719","Bromley 016E","E01000678","E02000142","Bromley 016","E09000006","Bromley","E12000007","London",1707,1707,0,57.1,666,2.6,"00AF","Bromley",NA,23074,17767,23532,26296,24371,22571,21870,28772,1297,4804,-1662,2476
"734","Bromley 020E","E01000679","E02000146","Bromley 020","E09000006","Bromley","E12000007","London",1660,1660,0,56.2,662,2.5,"00AF","Bromley",NA,22188,17910,21926,19135,25363,22144,22106,26083,3175,4234,180,6948
"814","Bromley 037A","E01000680","E02000163","Bromley 037","E09000006","Bromley","E12000007","London",1609,1609,0,2,646,2.5,"00AF","Bromley",NA,26186,27787,28280,26446,25936,28155,28925,26266,-250,368,645,-180
"805","Bromley 035A","E01000681","E02000161","Bromley 035","E09000006","Bromley","E12000007","London",1705,1705,0,54.3,654,2.6,"00AF","Bromley",NA,31555,28798,31447,25411,32204,31116,31128,27664,649,2318,-319,2253
"806","Bromley 035B","E01000682","E02000161","Bromley 035","E09000006","Bromley","E12000007","London",1524,1524,0,54.8,642,2.4,"00AF","Bromley",NA,30455,29595,26530,24947,32080,31473,29883,26836,1625,1878,3353,1889
"807","Bromley 035C","E01000683","E02000161","Bromley 035","E09000006","Bromley","E12000007","London",1592,1567,25,61.1,705,2.2,"00AF","Bromley",NA,27773,21827,25284,24202,20857,16501,18500,25498,-6916,-5326,-6784,1296
"808","Bromley 035D","E01000684","E02000161","Bromley 035","E09000006","Bromley","E12000007","London",2036,2036,0,50.6,757,2.7,"00AF","Bromley",NA,30141,26830,26959,28709,32202,30860,30516,30298,2061,4030,3557,1589
"815","Bromley 037B","E01000685","E02000163","Bromley 037","E09000006","Bromley","E12000007","London",1565,1565,0,14.1,618,2.5,"00AF","Bromley",NA,20823,14885,19732,15019,19965,15615,17233,15880,-858,730,-2499,861
"816","Bromley 037C","E01000686","E02000163","Bromley 037","E09000006","Bromley","E12000007","London",1508,1508,0,34.2,648,2.3,"00AF","Bromley",NA,29184,25181,26844,27436,28089,20656,26105,28307,-1095,-4525,-739,871
"817","Bromley 037D","E01000687","E02000163","Bromley 037","E09000006","Bromley","E12000007","London",1603,1603,0,27.4,656,2.4,"00AF","Bromley",NA,29857,28985,26074,26749,29432,25352,25788,28086,-425,-3633,-286,1337
"818","Bromley 037E","E01000688","E02000163","Bromley 037","E09000006","Bromley","E12000007","London",1365,1365,0,14.8,504,2.7,"00AF","Bromley",NA,30818,27959,30243,29066,32451,30556,31854,30738,1633,2597,1611,1672
"647","Bromley 002A","E01000689","E02000128","Bromley 002","E09000006","Bromley","E12000007","London",1375,1339,36,9.9,612,2.2,"00AF","Bromley",NA,12962,11468,15544,15166,9455,9795,14071,8616,-3507,-1673,-1473,-6550
"648","Bromley 002B","E01000690","E02000128","Bromley 002","E09000006","Bromley","E12000007","London",1402,1402,0,42.2,534,2.6,"00AF","Bromley",NA,26709,26997,26150,26142,25078,25127,26204,29585,-1631,-1870,54,3443
"649","Bromley 002C","E01000691","E02000128","Bromley 002","E09000006","Bromley","E12000007","London",1438,1420,18,59.5,619,2.3,"00AF","Bromley",NA,16390,12828,17557,19414,19681,13552,16697,19770,3291,724,-860,356
"650","Bromley 002D","E01000692","E02000128","Bromley 002","E09000006","Bromley","E12000007","London",1575,1565,10,44.7,659,2.4,"00AF","Bromley",NA,26522,22031,28337,24696,26640,21968,29686,27970,118,-63,1349,3274
"686","Bromley 010A","E01000693","E02000136","Bromley 010","E09000006","Bromley","E12000007","London",1609,1257,352,6,570,2.2,"00AF","Bromley",NA,15421,22413,17570,29416,20571,25810,29661,28627,5150,3397,12091,-789
"669","Bromley 007C","E01000694","E02000133","Bromley 007","E09000006","Bromley","E12000007","London",1627,1589,38,16.1,635,2.5,"00AF","Bromley",NA,30805,30132,29656,31696,30120,30818,30240,30871,-685,686,584,-825
"670","Bromley 007D","E01000695","E02000133","Bromley 007","E09000006","Bromley","E12000007","London",1494,1469,25,19.7,614,2.4,"00AF","Bromley",NA,28632,26367,29616,30198,25469,27529,28994,29818,-3163,1162,-622,-380
"671","Bromley 007E","E01000696","E02000133","Bromley 007","E09000006","Bromley","E12000007","London",1514,1460,54,7.4,637,2.3,"00AF","Bromley",NA,20435,28328,30321,31155,27789,30716,31039,32255,7354,2388,718,1100
"672","Bromley 007F","E01000697","E02000133","Bromley 007","E09000006","Bromley","E12000007","London",1615,1611,4,31.1,765,2.1,"00AF","Bromley",NA,27536,31225,31732,31978,31573,29617,31662,32476,4037,-1608,-70,498
"687","Bromley 010B","E01000698","E02000136","Bromley 010","E09000006","Bromley","E12000007","London",1182,1177,5,10.5,439,2.7,"00AF","Bromley",NA,26787,28832,29048,28397,27358,29735,29712,26653,571,903,664,-1744
"710","Bromley 015A","E01000699","E02000141","Bromley 015","E09000006","Bromley","E12000007","London",1442,1432,10,105.6,648,2.2,"00AF","Bromley",NA,11022,10872,12608,14328,12765,10675,14030,16685,1743,-197,1422,2357
"700","Bromley 013A","E01000700","E02000139","Bromley 013","E09000006","Bromley","E12000007","London",1509,1509,0,75.4,666,2.3,"00AF","Bromley",NA,18965,13936,17779,16924,19697,14381,16723,23747,732,445,-1056,6823
"711","Bromley 015B","E01000701","E02000141","Bromley 015","E09000006","Bromley","E12000007","London",1327,1327,0,99.2,599,2.2,"00AF","Bromley",NA,21790,21996,21068,23819,20045,16570,17119,24927,-1745,-5426,-3949,1108
"701","Bromley 013B","E01000702","E02000139","Bromley 013","E09000006","Bromley","E12000007","London",1321,1321,0,95.4,572,2.3,"00AF","Bromley",NA,24101,20051,24522,22890,21509,18364,24039,25348,-2592,-1687,-483,2458
"702","Bromley 013C","E01000703","E02000139","Bromley 013","E09000006","Bromley","E12000007","London",1599,1581,18,66.3,694,2.3,"00AF","Bromley",NA,18163,22040,20135,31524,21321,25238,23616,31954,3158,3198,3481,430
"712","Bromley 015C","E01000704","E02000141","Bromley 015","E09000006","Bromley","E12000007","London",1444,1444,0,44.4,593,2.4,"00AF","Bromley",NA,18420,18144,20071,22009,20493,21233,23248,22656,2073,3089,3177,647
"713","Bromley 015D","E01000705","E02000141","Bromley 015","E09000006","Bromley","E12000007","London",1310,1305,5,86.1,565,2.3,"00AF","Bromley",NA,13003,12555,12601,23312,14866,12807,13274,26736,1863,252,673,3424
"703","Bromley 013D","E01000706","E02000139","Bromley 013","E09000006","Bromley","E12000007","London",1293,1293,0,42.9,591,2.2,"00AF","Bromley",NA,17245,18330,15270,18622,16996,15019,17320,20410,-249,-3311,2050,1788
"829","Bromley 041A","E01000707","E02006787","Bromley 041","E09000006","Bromley","E12000007","London",1455,1455,0,94.5,536,2.7,"00AF","Bromley",NA,30733,29598,29654,29999,32003,30529,30016,31670,1270,931,362,1671
"830","Bromley 041B","E01000708","E02006787","Bromley 041","E09000006","Bromley","E12000007","London",1543,1543,0,64.2,650,2.4,"00AF","Bromley",NA,25432,19361,24446,27881,25608,22584,25194,27190,176,3223,748,-691
"662","Bromley 006A","E01000709","E02000132","Bromley 006","E09000006","Bromley","E12000007","London",1317,1296,21,54.1,787,1.6,"00AF","Bromley",NA,17189,13963,16438,29100,18692,16758,20387,25843,1503,2795,3949,-3257
"663","Bromley 006B","E01000710","E02000132","Bromley 006","E09000006","Bromley","E12000007","London",1605,1583,22,29.6,862,1.8,"00AF","Bromley",NA,23327,25152,29286,30729,22202,22746,29725,21240,-1125,-2406,439,-9489
"664","Bromley 006C","E01000711","E02000132","Bromley 006","E09000006","Bromley","E12000007","London",1719,1683,36,61,1012,1.7,"00AF","Bromley",NA,18814,19469,20506,18147,20705,20117,22931,24212,1891,648,2425,6065
"695","Bromley 012A","E01000712","E02000138","Bromley 012","E09000006","Bromley","E12000007","London",1641,1641,0,45.6,862,1.9,"00AF","Bromley",NA,27500,28548,27516,26218,28289,26302,30802,31721,789,-2246,3286,5503
"696","Bromley 012B","E01000713","E02000138","Bromley 012","E09000006","Bromley","E12000007","London",1693,1693,0,40.8,885,1.9,"00AF","Bromley",NA,27770,27031,25482,29836,28139,25215,28537,30923,369,-1816,3055,1087
"665","Bromley 006D","E01000714","E02000132","Bromley 006","E09000006","Bromley","E12000007","London",1865,1863,2,56.2,1036,1.8,"00AF","Bromley",NA,19301,23075,25200,28337,21702,24437,26634,21022,2401,1362,1434,-7315
"697","Bromley 012C","E01000715","E02000138","Bromley 012","E09000006","Bromley","E12000007","London",1657,1648,9,55.1,885,1.9,"00AF","Bromley",NA,27202,27105,26609,31386,26976,27171,27839,29779,-226,66,1230,-1607
"692","Bromley 011C","E01000716","E02000137","Bromley 011","E09000006","Bromley","E12000007","London",1542,1463,79,38.3,702,2.1,"00AF","Bromley",NA,25889,22362,23980,31257,27114,24058,26066,31796,1225,1696,2086,539
"693","Bromley 011D","E01000717","E02000137","Bromley 011","E09000006","Bromley","E12000007","London",1609,1609,0,51.3,889,1.8,"00AF","Bromley",NA,19695,21248,21151,28360,26243,21884,26896,29862,6548,636,5745,1502
"666","Bromley 006E","E01000718","E02000132","Bromley 006","E09000006","Bromley","E12000007","London",2061,2061,0,61,971,2.1,"00AF","Bromley",NA,10368,7332,13763,18569,8039,6892,9937,11454,-2329,-440,-3826,-7115
"725","Bromley 019A","E01000719","E02000145","Bromley 019","E09000006","Bromley","E12000007","London",1896,1896,0,54.3,853,2.2,"00AF","Bromley",NA,9461,9727,10368,8415,8794,6944,10475,11711,-667,-2783,107,3296
"726","Bromley 019B","E01000720","E02000145","Bromley 019","E09000006","Bromley","E12000007","London",1632,1622,10,2.2,668,2.4,"00AF","Bromley",NA,5093,3107,7936,4306,2453,2585,4981,3216,-2640,-522,-2955,-1090
"727","Bromley 019C","E01000721","E02000145","Bromley 019","E09000006","Bromley","E12000007","London",1327,1327,0,49.8,524,2.5,"00AF","Bromley",NA,4255,1696,6035,2570,3015,2301,3255,6968,-1240,605,-2780,4398
"744","Bromley 023A","E01000722","E02000149","Bromley 023","E09000006","Bromley","E12000007","London",1636,1636,0,28.3,704,2.3,"00AF","Bromley",NA,14087,11875,15092,10222,12145,9673,11560,8083,-1942,-2202,-3532,-2139
"773","Bromley 029A","E01000723","E02000155","Bromley 029","E09000006","Bromley","E12000007","London",1247,1247,0,29.4,561,2.2,"00AF","Bromley",NA,21658,24136,16734,15984,20312,22922,17680,13676,-1346,-1214,946,-2308
"728","Bromley 019D","E01000724","E02000145","Bromley 019","E09000006","Bromley","E12000007","London",1760,1760,0,42.7,674,2.6,"00AF","Bromley",NA,4012,3104,4016,3232,4718,3318,4729,6460,706,214,713,3228
"745","Bromley 023B","E01000725","E02000149","Bromley 023","E09000006","Bromley","E12000007","London",1641,1641,0,48.4,775,2.1,"00AF","Bromley",NA,11562,7976,13232,12057,9847,7191,10834,10991,-1715,-785,-2398,-1066
"774","Bromley 029B","E01000726","E02000155","Bromley 029","E09000006","Bromley","E12000007","London",1282,1282,0,45.5,590,2.2,"00AF","Bromley",NA,21644,23901,23876,15835,18935,19249,19285,15403,-2709,-4652,-4591,-432
"768","Bromley 028A","E01000727","E02000154","Bromley 028","E09000006","Bromley","E12000007","London",1553,1553,0,40.4,687,2.3,"00AF","Bromley",NA,21670,17619,22855,14359,17215,16086,17648,16100,-4455,-1533,-5207,1741
"729","Bromley 019E","E01000728","E02000145","Bromley 019","E09000006","Bromley","E12000007","London",1471,1471,0,5.4,657,2.2,"00AF","Bromley",NA,14026,10530,11153,11370,11545,10267,12678,7138,-2481,-263,1525,-4232
"705","Bromley 014A","E01000729","E02000140","Bromley 014","E09000006","Bromley","E12000007","London",1783,1783,0,68.5,824,2.2,"00AF","Bromley",NA,3305,3474,1701,7243,3934,2621,3792,5347,629,-853,2091,-1896
"706","Bromley 014B","E01000730","E02000140","Bromley 014","E09000006","Bromley","E12000007","London",1724,1724,0,46.2,649,2.7,"00AF","Bromley",NA,5087,2978,4709,3518,3654,1952,4016,5584,-1433,-1026,-693,2066
"746","Bromley 023C","E01000731","E02000149","Bromley 023","E09000006","Bromley","E12000007","London",1363,1361,2,58.3,532,2.6,"00AF","Bromley",NA,9517,6621,9350,6738,10361,9287,10240,7815,844,2666,890,1077
"747","Bromley 023D","E01000732","E02000149","Bromley 023","E09000006","Bromley","E12000007","London",1475,1475,0,41.6,587,2.5,"00AF","Bromley",NA,18228,15253,15663,17315,20864,17108,15335,20251,2636,1855,-328,2936
"748","Bromley 023E","E01000733","E02000149","Bromley 023","E09000006","Bromley","E12000007","London",1593,1593,0,42.6,651,2.4,"00AF","Bromley",NA,11975,10162,10478,12960,12449,9707,12922,12769,474,-455,2444,-191
"769","Bromley 028B","E01000734","E02000154","Bromley 028","E09000006","Bromley","E12000007","London",1360,1360,0,42,507,2.7,"00AF","Bromley",NA,17380,11890,18931,15848,22290,17288,21938,18570,4910,5398,3007,2722
"707","Bromley 014C","E01000735","E02000140","Bromley 014","E09000006","Bromley","E12000007","London",1484,1484,0,28.9,562,2.6,"00AF","Bromley",NA,7361,4414,7703,5044,7132,6703,6573,4207,-229,2289,-1130,-837
"688","Bromley 010C","E01000736","E02000136","Bromley 010","E09000006","Bromley","E12000007","London",1560,1560,0,39.3,618,2.5,"00AF","Bromley",NA,10091,8445,8037,7333,9408,8114,7852,8536,-683,-331,-185,1203
"689","Bromley 010D","E01000737","E02000136","Bromley 010","E09000006","Bromley","E12000007","London",1377,1329,48,37.4,580,2.3,"00AF","Bromley",NA,12103,9238,12139,13609,6804,6232,6182,8473,-5299,-3006,-5957,-5136
"708","Bromley 014D","E01000738","E02000140","Bromley 014","E09000006","Bromley","E12000007","London",1527,1527,0,29.6,632,2.4,"00AF","Bromley",NA,17529,13598,15616,9982,13858,12766,14678,12839,-3671,-832,-938,2857
"709","Bromley 014E","E01000739","E02000140","Bromley 014","E09000006","Bromley","E12000007","London",1523,1523,0,67.8,634,2.4,"00AF","Bromley",NA,6047,4355,4402,4520,3547,2812,3751,5596,-2500,-1543,-651,1076
"657","Bromley 005A","E01000740","E02000131","Bromley 005","E09000006","Bromley","E12000007","London",1734,1734,0,24.3,871,2,"00AF","Bromley",NA,7024,7685,10643,15657,7472,9896,11604,18426,448,2211,961,2769
"658","Bromley 005B","E01000741","E02000131","Bromley 005","E09000006","Bromley","E12000007","London",1586,1586,0,116.5,842,1.9,"00AF","Bromley",NA,6658,5036,6404,16022,7000,8714,9387,12685,342,3678,2983,-3337
"659","Bromley 005C","E01000742","E02000131","Bromley 005","E09000006","Bromley","E12000007","London",2019,1996,23,75.7,1044,1.9,"00AF","Bromley",NA,7174,6461,9729,10187,9590,8054,11940,18680,2416,1593,2211,8493
"680","Bromley 009A","E01000743","E02000135","Bromley 009","E09000006","Bromley","E12000007","London",1770,1703,67,56.6,841,2,"00AF","Bromley",NA,4170,2907,4652,9989,3906,4738,3585,8117,-264,1831,-1067,-1872
"681","Bromley 009B","E01000744","E02000135","Bromley 009","E09000006","Bromley","E12000007","London",1531,1484,47,71.4,682,2.2,"00AF","Bromley",NA,3312,1589,2576,6032,2720,2069,2086,8000,-592,480,-490,1968
"660","Bromley 005D","E01000745","E02000131","Bromley 005","E09000006","Bromley","E12000007","London",1757,1720,37,37.5,883,1.9,"00AF","Bromley",NA,9501,8806,10987,13130,12544,11766,16245,18443,3043,2960,5258,5313
"661","Bromley 005E","E01000746","E02000131","Bromley 005","E09000006","Bromley","E12000007","London",1858,1858,0,102.8,949,2,"00AF","Bromley",NA,12207,10468,11381,22689,13001,11558,16841,19749,794,1090,5460,-2940
"835","Bromley 042B","E01000747","E02006789","Bromley 042","E09000006","Bromley","E12000007","London",1920,1914,6,1.9,773,2.5,"00AF","Bromley",NA,15235,19074,21642,18673,14083,18775,21398,17692,-1152,-299,-244,-981
"836","Bromley 042C","E01000748","E02006789","Bromley 042","E09000006","Bromley","E12000007","London",1602,1602,0,1.6,670,2.4,"00AF","Bromley",NA,23393,31326,24635,22641,19725,26228,25617,19787,-3668,-5098,982,-2854
"810","Bromley 036A","E01000749","E02000162","Bromley 036","E09000006","Bromley","E12000007","London",1588,1588,0,1.7,639,2.5,"00AF","Bromley",NA,24510,24818,27012,24107,23358,27013,29542,23966,-1152,2195,2530,-141
"811","Bromley 036B","E01000750","E02000162","Bromley 036","E09000006","Bromley","E12000007","London",1492,1492,0,48,665,2.2,"00AF","Bromley",NA,9629,8476,4644,13373,8075,7644,5441,8256,-1554,-832,797,-5117
"812","Bromley 036C","E01000751","E02000162","Bromley 036","E09000006","Bromley","E12000007","London",2007,1961,46,10.9,807,2.4,"00AF","Bromley",NA,28041,28024,23542,23571,27641,25836,26317,25445,-400,-2188,2775,1874
"813","Bromley 036D","E01000752","E02000162","Bromley 036","E09000006","Bromley","E12000007","London",1606,1606,0,11.6,778,2.1,"00AF","Bromley",NA,27540,23900,25592,22311,26261,21974,26148,24401,-1279,-1926,556,2090
"786","Bromley 031A","E01000753","E02000157","Bromley 031","E09000006","Bromley","E12000007","London",1806,1806,0,20.7,750,2.4,"00AF","Bromley",NA,31408,31707,30346,29561,29656,31446,29904,27230,-1752,-261,-442,-2331
"787","Bromley 031B","E01000754","E02000157","Bromley 031","E09000006","Bromley","E12000007","London",1675,1675,0,43.2,743,2.3,"00AF","Bromley",NA,27643,26135,26125,27190,26697,26205,28892,27060,-946,70,2767,-130
"788","Bromley 031C","E01000755","E02000157","Bromley 031","E09000006","Bromley","E12000007","London",1505,1505,0,43.9,615,2.4,"00AF","Bromley",NA,30559,27405,27040,27211,29581,30354,28520,29904,-978,2949,1480,2693
"799","Bromley 033D","E01000756","E02000159","Bromley 033","E09000006","Bromley","E12000007","London",1563,1563,0,15.4,594,2.6,"00AF","Bromley",NA,30350,32243,30657,28812,30584,31486,29641,28666,234,-757,-1016,-146
"789","Bromley 031D","E01000757","E02000157","Bromley 031","E09000006","Bromley","E12000007","London",1499,1499,0,27.6,601,2.5,"00AF","Bromley",NA,31890,31966,31035,30560,30855,32342,31732,29625,-1035,376,697,-935
"790","Bromley 031E","E01000758","E02000157","Bromley 031","E09000006","Bromley","E12000007","London",1479,1479,0,48.7,591,2.5,"00AF","Bromley",NA,30961,29949,29977,31017,30587,29588,30989,31412,-374,-361,1012,395
"800","Bromley 034A","E01000759","E02000160","Bromley 034","E09000006","Bromley","E12000007","London",1542,1542,0,3.4,549,2.8,"00AF","Bromley",NA,28541,31232,27708,26414,26812,29862,27632,25457,-1729,-1370,-76,-957
"801","Bromley 034B","E01000760","E02000160","Bromley 034","E09000006","Bromley","E12000007","London",1503,1417,86,29.8,550,2.6,"00AF","Bromley",NA,23785,20656,23275,24760,23802,25406,27215,23418,17,4750,3940,-1342
"802","Bromley 034C","E01000761","E02000160","Bromley 034","E09000006","Bromley","E12000007","London",1552,1552,0,26.9,577,2.7,"00AF","Bromley",NA,27375,28483,25829,25440,27001,29001,26963,24788,-374,518,1134,-652
"723","Bromley 018D","E01000762","E02000144","Bromley 018","E09000006","Bromley","E12000007","London",1623,1623,0,50.7,743,2.2,"00AF","Bromley",NA,28933,28019,25527,27759,28927,25732,26012,28675,-6,-2287,485,916
"763","Bromley 027A","E01000763","E02000153","Bromley 027","E09000006","Bromley","E12000007","London",1452,1452,0,17.2,523,2.8,"00AF","Bromley",NA,30326,31805,27366,25518,30299,31455,29888,23384,-27,-350,2522,-2134
"764","Bromley 027B","E01000764","E02000153","Bromley 027","E09000006","Bromley","E12000007","London",1615,1615,0,31.9,633,2.6,"00AF","Bromley",NA,19016,13510,19314,19084,22581,19095,19669,21503,3565,5585,355,2419
"803","Bromley 034D","E01000765","E02000160","Bromley 034","E09000006","Bromley","E12000007","London",1704,1697,7,7.4,679,2.5,"00AF","Bromley",NA,25880,23344,25236,28346,27894,25578,24711,26347,2014,2234,-525,-1999
"765","Bromley 027C","E01000766","E02000153","Bromley 027","E09000006","Bromley","E12000007","London",1714,1714,0,46.4,645,2.7,"00AF","Bromley",NA,30992,31694,24926,26420,32312,31642,28854,27765,1320,-52,3928,1345
"766","Bromley 027D","E01000767","E02000153","Bromley 027","E09000006","Bromley","E12000007","London",1646,1646,0,52,598,2.8,"00AF","Bromley",NA,31312,31674,29675,26557,31699,31576,31548,29038,387,-98,1873,2481
"804","Bromley 034E","E01000768","E02000160","Bromley 034","E09000006","Bromley","E12000007","London",1555,1517,38,32.2,613,2.5,"00AF","Bromley",NA,26324,24344,26242,30955,28379,26713,26858,30675,2055,2369,616,-280
"749","Bromley 024A","E01000769","E02000150","Bromley 024","E09000006","Bromley","E12000007","London",1417,1301,116,11.8,454,2.9,"00AF","Bromley",NA,12212,15532,5571,21188,10836,16884,10185,21862,-1376,1352,4614,674
"698","Bromley 012D","E01000770","E02000138","Bromley 012","E09000006","Bromley","E12000007","London",1429,1429,0,20.8,691,2.1,"00AF","Bromley",NA,29059,31540,29685,31016,28291,31206,30305,31595,-768,-334,620,579
"831","Bromley 041C","E01000771","E02006787","Bromley 041","E09000006","Bromley","E12000007","London",1635,1616,19,44.4,620,2.6,"00AF","Bromley",NA,27456,30552,29353,29104,29400,30890,30883,29872,1944,338,1530,768
"699","Bromley 012E","E01000772","E02000138","Bromley 012","E09000006","Bromley","E12000007","London",1516,1516,0,46.9,734,2.1,"00AF","Bromley",NA,31090,27697,29697,31034,30824,28478,29837,31418,-266,781,140,384
"750","Bromley 024B","E01000773","E02000150","Bromley 024","E09000006","Bromley","E12000007","London",1521,1521,0,48.9,605,2.5,"00AF","Bromley",NA,30324,29096,29101,28370,28643,29529,29194,25386,-1681,433,93,-2984
"832","Bromley 041D","E01000774","E02006787","Bromley 041","E09000006","Bromley","E12000007","London",1473,1473,0,38.9,581,2.5,"00AF","Bromley",NA,24079,23838,25559,23328,23213,25551,19984,21557,-866,1713,-5575,-1771
"751","Bromley 024C","E01000775","E02000150","Bromley 024","E09000006","Bromley","E12000007","London",2266,2266,0,20.4,867,2.6,"00AF","Bromley",NA,29129,24942,28862,28974,28412,28065,29742,26493,-717,3123,880,-2481
"752","Bromley 024D","E01000777","E02000150","Bromley 024","E09000006","Bromley","E12000007","London",1567,1567,0,62.9,565,2.8,"00AF","Bromley",NA,26036,22526,25590,27681,24898,26411,26189,26202,-1138,3885,599,-1479
"753","Bromley 024E","E01000778","E02000150","Bromley 024","E09000006","Bromley","E12000007","London",1580,1580,0,76.6,618,2.6,"00AF","Bromley",NA,19189,16251,15946,17840,19203,20701,19171,19983,14,4450,3225,2143
"641","Bromley 001A","E01000779","E02000127","Bromley 001","E09000006","Bromley","E12000007","London",1233,1185,48,10.6,551,2.2,"00AF","Bromley",NA,16835,18286,17496,25048,15467,14732,18117,23433,-1368,-3554,621,-1615
"642","Bromley 001B","E01000780","E02000127","Bromley 001","E09000006","Bromley","E12000007","London",1480,1480,0,70.4,628,2.4,"00AF","Bromley",NA,10853,7607,10676,11422,10314,8185,10580,12709,-539,578,-96,1287
"643","Bromley 001C","E01000781","E02000127","Bromley 001","E09000006","Bromley","E12000007","London",1445,1445,0,84,614,2.4,"00AF","Bromley",NA,7799,3850,8326,5114,4030,3083,6088,4828,-3769,-767,-2238,-286
"644","Bromley 001D","E01000782","E02000127","Bromley 001","E09000006","Bromley","E12000007","London",1441,1441,0,50.8,647,2.2,"00AF","Bromley",NA,5893,4007,4672,4444,1663,1303,1307,4084,-4230,-2704,-3365,-360
"645","Bromley 001E","E01000783","E02000127","Bromley 001","E09000006","Bromley","E12000007","London",1503,1503,0,79.6,626,2.4,"00AF","Bromley",NA,7967,4137,7942,5707,4767,3368,6157,6391,-3200,-769,-1785,684
"651","Bromley 002E","E01000784","E02000128","Bromley 002","E09000006","Bromley","E12000007","London",1504,1504,0,67.2,582,2.6,"00AF","Bromley",NA,24852,19902,25868,22960,24285,22336,25545,23541,-567,2434,-323,581
"646","Bromley 001F","E01000785","E02000127","Bromley 001","E09000006","Bromley","E12000007","London",1381,1381,0,65.7,609,2.3,"00AF","Bromley",NA,8748,4914,7151,7151,6044,4054,5718,9915,-2704,-860,-1433,2764
"791","Bromley 032A","E01000786","E02000158","Bromley 032","E09000006","Bromley","E12000007","London",1421,1421,0,15,627,2.3,"00AF","Bromley",NA,25527,26516,25176,24771,19783,28977,23932,27502,-5744,2461,-1244,2731
"775","Bromley 029C","E01000787","E02000155","Bromley 029","E09000006","Bromley","E12000007","London",1405,1405,0,41.2,667,2.1,"00AF","Bromley",NA,13250,10670,12952,11381,11851,12319,11836,8933,-1399,1649,-1116,-2448
"776","Bromley 029D","E01000788","E02000155","Bromley 029","E09000006","Bromley","E12000007","London",1526,1526,0,41.4,618,2.5,"00AF","Bromley",NA,17110,15237,18277,16397,11290,12816,14091,16224,-5820,-2421,-4186,-173
"792","Bromley 032B","E01000789","E02000158","Bromley 032","E09000006","Bromley","E12000007","London",1800,1800,0,125.5,657,2.7,"00AF","Bromley",NA,3659,1375,6775,3514,4271,1977,4350,3716,612,602,-2425,202
"770","Bromley 028C","E01000790","E02000154","Bromley 028","E09000006","Bromley","E12000007","London",2018,1982,36,38.7,872,2.3,"00AF","Bromley",NA,16276,22233,18080,26962,17330,17305,20187,27310,1054,-4928,2107,348
"777","Bromley 029E","E01000791","E02000155","Bromley 029","E09000006","Bromley","E12000007","London",1445,1445,0,36,621,2.3,"00AF","Bromley",NA,21722,27179,19257,17234,22670,22385,18538,22054,948,-4794,-719,4820
"793","Bromley 032C","E01000792","E02000158","Bromley 032","E09000006","Bromley","E12000007","London",1142,1142,0,36.2,483,2.4,"00AF","Bromley",NA,11596,9092,11666,10080,12963,9757,11701,14625,1367,665,35,4545
"794","Bromley 032D","E01000793","E02000158","Bromley 032","E09000006","Bromley","E12000007","London",1589,1589,0,34,643,2.5,"00AF","Bromley",NA,30075,31052,27080,29834,31424,31869,30734,30100,1349,817,3654,266
"809","Bromley 035E","E01000794","E02000161","Bromley 035","E09000006","Bromley","E12000007","London",1553,1546,7,33.5,611,2.5,"00AF","Bromley",NA,30933,31037,26686,27113,31439,31330,27087,29374,506,293,401,2261
"795","Bromley 032E","E01000795","E02000158","Bromley 032","E09000006","Bromley","E12000007","London",1412,1412,0,49.4,542,2.6,"00AF","Bromley",NA,20480,13650,16352,17941,18537,14142,15429,22229,-1943,492,-923,4288
"682","Bromley 009C","E01000796","E02000135","Bromley 009","E09000006","Bromley","E12000007","London",1630,1630,0,164.3,638,2.6,"00AF","Bromley",NA,5826,2297,5283,8266,4679,2560,4569,6536,-1147,263,-714,-1730
"704","Bromley 013E","E01000797","E02000139","Bromley 013","E09000006","Bromley","E12000007","London",1562,1562,0,23.8,679,2.3,"00AF","Bromley",NA,18935,15455,15965,29347,20483,23731,21582,30075,1548,8276,5617,728
"683","Bromley 009D","E01000798","E02000135","Bromley 009","E09000006","Bromley","E12000007","London",1464,1464,0,108.3,693,2.1,"00AF","Bromley",NA,3154,2094,2367,8046,2458,2127,3030,7593,-696,33,663,-453
"652","Bromley 004A","E01000799","E02000130","Bromley 004","E09000006","Bromley","E12000007","London",1642,1642,0,76,719,2.3,"00AF","Bromley",NA,11317,11947,10665,15894,11975,10480,11866,19362,658,-1467,1201,3468
"684","Bromley 009E","E01000800","E02000135","Bromley 009","E09000006","Bromley","E12000007","London",1618,1612,6,70,780,2.1,"00AF","Bromley",NA,8165,8035,8715,14679,7424,7215,8442,15003,-741,-820,-273,324
"714","Bromley 015E","E01000801","E02000141","Bromley 015","E09000006","Bromley","E12000007","London",1417,1410,7,76.5,650,2.2,"00AF","Bromley",NA,13048,9076,13179,17178,11305,9437,11884,12351,-1743,361,-1295,-4827
"653","Bromley 004B","E01000802","E02000130","Bromley 004","E09000006","Bromley","E12000007","London",1729,1729,0,93.4,750,2.3,"00AF","Bromley",NA,11283,8580,9583,20463,12747,11088,13515,24024,1464,2508,3932,3561
"654","Bromley 004C","E01000803","E02000130","Bromley 004","E09000006","Bromley","E12000007","London",1596,1587,9,61.1,730,2.2,"00AF","Bromley",NA,14364,11631,11822,22843,15277,12062,15409,25873,913,431,3587,3030
"655","Bromley 004D","E01000804","E02000130","Bromley 004","E09000006","Bromley","E12000007","London",1436,1426,10,21.6,548,2.6,"00AF","Bromley",NA,26241,27310,23999,30334,26657,25712,27605,30317,416,-1598,3606,-17
"656","Bromley 004E","E01000805","E02000130","Bromley 004","E09000006","Bromley","E12000007","London",1511,1505,6,94.1,717,2.1,"00AF","Bromley",NA,12660,9363,11516,21017,10802,12020,11455,14770,-1858,2657,-61,-6247
"685","Bromley 009F","E01000806","E02000135","Bromley 009","E09000006","Bromley","E12000007","London",1721,1721,0,104.7,768,2.2,"00AF","Bromley",NA,5438,3569,6081,14530,6872,5058,7932,13639,1434,1489,1851,-891
"742","Bromley 022C","E01000807","E02000148","Bromley 022","E09000006","Bromley","E12000007","London",1532,1532,0,19.1,595,2.6,"00AF","Bromley",NA,28754,26119,28487,29128,28870,27254,28189,29010,116,1135,-298,-118
"754","Bromley 025A","E01000808","E02000151","Bromley 025","E09000006","Bromley","E12000007","London",1604,1604,0,48.1,625,2.6,"00AF","Bromley",NA,24694,20157,19046,27537,29307,26223,24034,27872,4613,6066,4988,335
"743","Bromley 022D","E01000809","E02000148","Bromley 022","E09000006","Bromley","E12000007","London",1517,1517,0,27.9,629,2.4,"00AF","Bromley",NA,31675,29947,30818,28342,31745,30838,30474,26895,70,891,-344,-1447
"755","Bromley 025B","E01000810","E02000151","Bromley 025","E09000006","Bromley","E12000007","London",1503,1503,0,40.4,599,2.5,"00AF","Bromley",NA,31484,32270,31387,30352,32700,32584,31666,30748,1216,314,279,396
"756","Bromley 025C","E01000811","E02000151","Bromley 025","E09000006","Bromley","E12000007","London",1320,1320,0,44.2,571,2.3,"00AF","Bromley",NA,29023,24965,28396,24720,30306,29124,30271,26365,1283,4159,1875,1645
"771","Bromley 028D","E01000812","E02000154","Bromley 028","E09000006","Bromley","E12000007","London",1497,1491,6,39.4,663,2.2,"00AF","Bromley",NA,19295,19432,22011,27403,21408,17786,17397,26166,2113,-1646,-4614,-1237
"757","Bromley 025D","E01000813","E02000151","Bromley 025","E09000006","Bromley","E12000007","London",1610,1610,0,26.4,637,2.5,"00AF","Bromley",NA,30887,30162,27128,25953,31348,29829,29596,26082,461,-333,2468,129
"772","Bromley 028E","E01000814","E02000154","Bromley 028","E09000006","Bromley","E12000007","London",1531,1531,0,32.1,564,2.7,"00AF","Bromley",NA,27378,32408,31482,31586,32147,32733,32316,32263,4769,325,834,677
"758","Bromley 025E","E01000815","E02000151","Bromley 025","E09000006","Bromley","E12000007","London",1537,1537,0,31.5,562,2.7,"00AF","Bromley",NA,31453,32189,32169,30830,32616,32712,32640,30389,1163,523,471,-441
"824","Bromley 040A","E01000816","E02006782","Bromley 040","E09000006","Bromley","E12000007","London",1481,1481,0,48.9,592,2.5,"00AF","Bromley",NA,21338,20724,21499,19466,17426,16829,16461,16121,-3912,-3895,-5038,-3345
"825","Bromley 040B","E01000818","E02006782","Bromley 040","E09000006","Bromley","E12000007","London",1467,1467,0,11.3,568,2.6,"00AF","Bromley",NA,22328,17750,26776,21991,20435,24147,22282,21467,-1893,6397,-4494,-524
"826","Bromley 040C","E01000819","E02006782","Bromley 040","E09000006","Bromley","E12000007","London",1710,1710,0,43.8,740,2.3,"00AF","Bromley",NA,8860,7300,6719,15217,7388,6402,7074,13084,-1472,-898,355,-2133
"675","Bromley 008C","E01000820","E02000134","Bromley 008","E09000006","Bromley","E12000007","London",1405,1346,59,23.7,643,2.1,"00AF","Bromley",NA,14876,12380,11173,27390,13277,10604,8806,26490,-1599,-1776,-2367,-900
"676","Bromley 008D","E01000822","E02000134","Bromley 008","E09000006","Bromley","E12000007","London",1614,1570,44,72.7,727,2.2,"00AF","Bromley",NA,19174,14253,18920,27737,20185,14900,18173,25432,1011,647,-747,-2305
"677","Bromley 008E","E01000823","E02000134","Bromley 008","E09000006","Bromley","E12000007","London",1676,1671,5,68.6,747,2.2,"00AF","Bromley",NA,22345,21960,21787,30859,25329,23637,23126,31342,2984,1677,1339,483
"678","Bromley 008F","E01000824","E02000134","Bromley 008","E09000006","Bromley","E12000007","London",1206,1206,0,72.9,514,2.3,"00AF","Bromley",NA,19237,15540,19027,29856,16345,13584,14980,28645,-2892,-1956,-4047,-1211
"679","Bromley 008G","E01000825","E02000134","Bromley 008","E09000006","Bromley","E12000007","London",1573,1547,26,89.3,807,1.9,"00AF","Bromley",NA,18586,15559,18114,26101,16211,15008,12348,29147,-2375,-551,-5766,3046
"735","Bromley 021A","E01000826","E02000147","Bromley 021","E09000006","Bromley","E12000007","London",1625,1625,0,31.4,563,2.9,"00AF","Bromley",NA,31945,32190,30370,31406,31618,32480,31806,31786,-327,290,1436,380
"736","Bromley 021B","E01000827","E02000147","Bromley 021","E09000006","Bromley","E12000007","London",1692,1692,0,45.2,790,2.1,"00AF","Bromley",NA,28469,23388,23995,31641,29280,23544,27727,29804,811,156,3732,-1837
"694","Bromley 011E","E01000828","E02000137","Bromley 011","E09000006","Bromley","E12000007","London",1584,1584,0,46.4,766,2.1,"00AF","Bromley",NA,20627,18969,22569,29372,23758,23923,22726,30651,3131,4954,157,1279
"724","Bromley 018E","E01000829","E02000144","Bromley 018","E09000006","Bromley","E12000007","London",1733,1733,0,77.7,734,2.4,"00AF","Bromley",NA,26113,22236,26013,28318,27975,24261,28486,28978,1862,2025,2473,660
"737","Bromley 021C","E01000830","E02000147","Bromley 021","E09000006","Bromley","E12000007","London",1550,1550,0,26.1,544,2.8,"00AF","Bromley",NA,32069,31912,31478,31758,31992,32470,32297,31758,-77,558,819,0
"738","Bromley 021D","E01000831","E02000147","Bromley 021","E09000006","Bromley","E12000007","London",1640,1622,18,40.4,789,2.1,"00AF","Bromley",NA,29862,25322,27862,31152,26845,24531,27909,31688,-3017,-791,47,536
"778","Bromley 030A","E01000832","E02000156","Bromley 030","E09000006","Bromley","E12000007","London",1488,1488,0,17.2,572,2.6,"00AF","Bromley",NA,28910,29678,31432,28763,29462,28994,31159,30313,552,-684,-273,1550
"739","Bromley 021E","E01000833","E02000147","Bromley 021","E09000006","Bromley","E12000007","London",1462,1462,0,40.7,497,2.9,"00AF","Bromley",NA,31923,30407,29737,30740,32301,31855,31722,30581,378,1448,1985,-159
"767","Bromley 027E","E01000834","E02000153","Bromley 027","E09000006","Bromley","E12000007","London",1328,1328,0,63,461,2.9,"00AF","Bromley",NA,30921,30376,29455,24099,31955,31270,31236,25598,1034,894,1781,1499
"779","Bromley 030B","E01000835","E02000156","Bromley 030","E09000006","Bromley","E12000007","London",1614,1588,26,48.5,648,2.5,"00AF","Bromley",NA,23289,20496,26998,26496,26198,20620,26739,24722,2909,124,-259,-1774
"780","Bromley 030C","E01000836","E02000156","Bromley 030","E09000006","Bromley","E12000007","London",1419,1419,0,66.6,500,2.8,"00AF","Bromley",NA,31357,28042,31729,28622,31158,30659,31454,27698,-199,2617,-275,-924
"781","Bromley 030D","E01000837","E02000156","Bromley 030","E09000006","Bromley","E12000007","London",1512,1512,0,31.6,647,2.3,"00AF","Bromley",NA,23135,21781,17866,27317,22031,19073,17716,24944,-1104,-2708,-150,-2373
"782","Bromley 030E","E01000838","E02000156","Bromley 030","E09000006","Bromley","E12000007","London",1462,1416,46,27.1,548,2.6,"00AF","Bromley",NA,28214,24967,25137,27260,30201,30008,29092,26602,1987,5041,3955,-658
"783","Bromley 030F","E01000839","E02000156","Bromley 030","E09000006","Bromley","E12000007","London",1488,1488,0,54.1,550,2.7,"00AF","Bromley",NA,31562,31668,31657,29913,31539,31748,32375,29278,-23,80,718,-635
"784","Bromley 030G","E01000840","E02000156","Bromley 030","E09000006","Bromley","E12000007","London",1552,1552,0,19.5,685,2.3,"00AF","Bromley",NA,24684,29594,25092,29473,26310,26295,26661,28494,1626,-3299,1569,-979
"785","Bromley 030H","E01000841","E02000156","Bromley 030","E09000006","Bromley","E12000007","London",1559,1559,0,45.7,606,2.6,"00AF","Bromley",NA,26144,29646,29846,25506,30869,29133,29517,27278,4725,-513,-329,1772
"889","Camden 011A","E01000842","E02000176","Camden 011","E09000007","Camden","E12000007","London",1444,1368,76,137.3,724,1.9,"00AG","Camden",NA,18352,19944,21386,29445,21358,24713,25891,22443,3006,4769,4505,-7002
"903","Camden 014A","E01000843","E02000179","Camden 014","E09000007","Camden","E12000007","London",1678,1678,0,201.4,846,2,"00AG","Camden",NA,14930,11510,21661,29908,15915,11383,21407,21342,985,-127,-254,-8566
"890","Camden 011B","E01000844","E02000176","Camden 011","E09000007","Camden","E12000007","London",1772,1772,0,155.6,870,2,"00AG","Camden",NA,17074,20687,22231,26560,19087,25807,25996,20151,2013,5120,3765,-6409
"904","Camden 014B","E01000845","E02000179","Camden 014","E09000007","Camden","E12000007","London",1464,1444,20,124.1,731,2,"00AG","Camden",NA,14667,13800,20827,18990,21173,19616,27758,26050,6506,5816,6931,7060
"905","Camden 014C","E01000846","E02000179","Camden 014","E09000007","Camden","E12000007","London",1501,1499,2,181.5,616,2.4,"00AG","Camden",NA,8147,4080,9980,23410,9951,6007,7699,25442,1804,1927,-2281,2032
"906","Camden 014D","E01000847","E02000179","Camden 014","E09000007","Camden","E12000007","London",1686,1684,2,171.2,677,2.5,"00AG","Camden",NA,10209,7839,12304,18764,14584,8219,13346,25327,4375,380,1042,6563
"891","Camden 011C","E01000848","E02000176","Camden 011","E09000007","Camden","E12000007","London",1588,1580,8,157.2,805,2,"00AG","Camden",NA,20716,20492,22244,32084,24561,26724,29823,26890,3845,6232,7579,-5194
"892","Camden 011D","E01000849","E02000176","Camden 011","E09000007","Camden","E12000007","London",1569,1569,0,201.9,862,1.8,"00AG","Camden",NA,16597,19835,19984,24147,22980,26404,30583,24713,6383,6569,10599,566
"959","Camden 026A","E01000850","E02000191","Camden 026","E09000007","Camden","E12000007","London",1694,1281,413,86.7,664,1.9,"00AG","Camden",NA,12765,21392,26184,26216,15786,23813,30222,24203,3021,2421,4038,-2013
"960","Camden 026B","E01000851","E02000191","Camden 026","E09000007","Camden","E12000007","London",2383,1645,738,178.5,861,1.9,"00AG","Camden",NA,15943,21836,25602,20832,18390,28785,30903,29067,2447,6949,5301,8235
"961","Camden 026C","E01000852","E02000191","Camden 026","E09000007","Camden","E12000007","London",1587,976,611,127.4,625,1.6,"00AG","Camden",NA,14726,19178,20922,26741,14834,22528,24028,29908,108,3350,3106,3167
"954","Camden 025A","E01000853","E02000190","Camden 025","E09000007","Camden","E12000007","London",1631,1596,35,278.3,840,1.9,"00AG","Camden",NA,6774,6807,7483,20679,5767,5231,5038,16473,-1007,-1576,-2445,-4206
"962","Camden 026D","E01000854","E02000191","Camden 026","E09000007","Camden","E12000007","London",1833,1643,190,97.1,718,2.3,"00AG","Camden",NA,10673,9425,16310,25384,13893,15888,19370,25365,3220,6463,3060,-19
"967","Camden 028A","E01000855","E02000193","Camden 028","E09000007","Camden","E12000007","London",1764,1714,50,55,1111,1.5,"00AG","Camden",NA,15859,26242,27912,22037,16377,25212,27661,31228,518,-1030,-251,9191
"926","Camden 019A","E01000856","E02000184","Camden 019","E09000007","Camden","E12000007","London",1645,1645,0,138.6,628,2.6,"00AG","Camden",NA,4548,3612,7876,14429,4833,4747,7428,19883,285,1135,-448,5454
"921","Camden 018A","E01000857","E02000183","Camden 018","E09000007","Camden","E12000007","London",1447,1443,4,178.2,686,2.1,"00AG","Camden",NA,14836,13057,17461,23887,17464,11847,15754,30724,2628,-1210,-1707,6837
"922","Camden 018B","E01000858","E02000183","Camden 018","E09000007","Camden","E12000007","London",1861,1861,0,85.4,775,2.4,"00AG","Camden",NA,1970,1411,3003,12114,2960,1758,3685,18609,990,347,682,6495
"923","Camden 018C","E01000859","E02000183","Camden 018","E09000007","Camden","E12000007","London",1586,1586,0,164,807,2,"00AG","Camden",NA,20381,23863,23488,28573,24133,25053,26305,31500,3752,1190,2817,2927
"924","Camden 018D","E01000860","E02000183","Camden 018","E09000007","Camden","E12000007","London",1307,1307,0,63.5,797,1.6,"00AG","Camden",NA,11064,11408,12687,21394,12856,10238,14557,26193,1792,-1170,1870,4799
"927","Camden 019B","E01000861","E02000184","Camden 019","E09000007","Camden","E12000007","London",1574,1574,0,138.1,729,2.2,"00AG","Camden",NA,4555,5710,5944,26387,6012,8482,10186,24822,1457,2772,4242,-1565
"925","Camden 018E","E01000862","E02000183","Camden 018","E09000007","Camden","E12000007","London",1712,1712,0,100.7,816,2.1,"00AG","Camden",NA,22680,26511,28508,30806,20692,24613,27430,32389,-1988,-1898,-1078,1583
"936","Camden 021A","E01000863","E02000186","Camden 021","E09000007","Camden","E12000007","London",1481,1383,98,91.8,667,2.1,"00AG","Camden",NA,2937,5348,934,15875,5313,8666,9050,16507,2376,3318,8116,632
"907","Camden 015A","E01000864","E02000180","Camden 015","E09000007","Camden","E12000007","London",1537,1537,0,157.5,717,2.1,"00AG","Camden",NA,10094,9997,10098,21207,10648,11112,12959,31532,554,1115,2861,10325
"908","Camden 015B","E01000865","E02000180","Camden 015","E09000007","Camden","E12000007","London",1505,977,528,138.5,451,2.2,"00AG","Camden",NA,14743,18641,19460,23471,16639,21469,23171,29720,1896,2828,3711,6249
"879","Camden 009A","E01000866","E02000174","Camden 009","E09000007","Camden","E12000007","London",2030,2030,0,139.5,926,2.2,"00AG","Camden",NA,6588,5677,6593,24206,7609,8253,8344,27592,1021,2576,1751,3386
"909","Camden 015C","E01000867","E02000180","Camden 015","E09000007","Camden","E12000007","London",1608,1608,0,198.8,675,2.4,"00AG","Camden",NA,3896,3240,5164,16036,4491,3574,6074,12065,595,334,910,-3971
"910","Camden 015D","E01000868","E02000180","Camden 015","E09000007","Camden","E12000007","London",1442,1442,0,172.3,584,2.5,"00AG","Camden",NA,4092,2950,2843,11154,2826,3884,3084,10481,-1266,934,241,-673
"911","Camden 015E","E01000869","E02000180","Camden 015","E09000007","Camden","E12000007","London",2110,2098,12,184.3,967,2.2,"00AG","Camden",NA,7346,3997,8065,25841,9869,9744,12946,22996,2523,5747,4881,-2845
"880","Camden 009B","E01000870","E02000174","Camden 009","E09000007","Camden","E12000007","London",1693,1693,0,133.6,774,2.2,"00AG","Camden",NA,5036,5905,6155,22632,6040,5492,6026,22157,1004,-413,-129,-475
"858","Camden 005A","E01000871","E02000170","Camden 005","E09000007","Camden","E12000007","London",1664,1653,11,54.3,632,2.6,"00AG","Camden",NA,11821,10239,14346,28221,16657,14418,16274,29520,4836,4179,1928,1299
"859","Camden 005B","E01000872","E02000170","Camden 005","E09000007","Camden","E12000007","London",1902,1896,6,129.5,913,2.1,"00AG","Camden",NA,8334,7012,9278,25941,8689,10159,9573,23119,355,3147,295,-2822
"860","Camden 005C","E01000873","E02000170","Camden 005","E09000007","Camden","E12000007","London",1639,1639,0,134.3,710,2.3,"00AG","Camden",NA,20081,19357,25083,21667,23092,20241,25579,22114,3011,884,496,447
"861","Camden 005D","E01000874","E02000170","Camden 005","E09000007","Camden","E12000007","London",1559,1559,0,182.1,704,2.2,"00AG","Camden",NA,23829,25033,27669,24697,25712,27655,30441,27892,1883,2622,2772,3195
"898","Camden 013A","E01000875","E02000178","Camden 013","E09000007","Camden","E12000007","London",1654,1646,8,141.4,839,2,"00AG","Camden",NA,10457,12512,14976,17629,10416,12044,11799,12641,-41,-468,-3177,-4988
"899","Camden 013B","E01000876","E02000178","Camden 013","E09000007","Camden","E12000007","London",1748,1748,0,149.7,800,2.2,"00AG","Camden",NA,5345,3622,6321,16882,5505,4013,5344,18868,160,391,-977,1986
"862","Camden 005E","E01000877","E02000170","Camden 005","E09000007","Camden","E12000007","London",1574,1546,28,142.4,726,2.1,"00AG","Camden",NA,19103,20730,23644,22405,21878,20277,22053,31261,2775,-453,-1591,8856
"853","Camden 004A","E01000878","E02000169","Camden 004","E09000007","Camden","E12000007","London",1624,1246,378,84.5,550,2.3,"00AG","Camden",NA,18719,18158,25503,26390,25464,24140,30876,17322,6745,5982,5373,-9068
"854","Camden 004B","E01000879","E02000169","Camden 004","E09000007","Camden","E12000007","London",1458,1305,153,82.2,602,2.2,"00AG","Camden",NA,20582,24205,26256,23315,26898,29121,30612,31540,6316,4916,4356,8225
"855","Camden 004C","E01000880","E02000169","Camden 004","E09000007","Camden","E12000007","London",1602,1558,44,78.6,621,2.5,"00AG","Camden",NA,20469,25286,29924,27772,24930,28904,32048,30082,4461,3618,2124,2310
"874","Camden 008A","E01000881","E02000173","Camden 008","E09000007","Camden","E12000007","London",1510,1451,59,102.2,632,2.3,"00AG","Camden",NA,12745,16048,20280,21228,16468,19770,23692,23390,3723,3722,3412,2162
"875","Camden 008B","E01000882","E02000173","Camden 008","E09000007","Camden","E12000007","London",1513,1512,1,124.1,728,2.1,"00AG","Camden",NA,15597,17174,16405,23943,28585,29688,32522,29986,12988,12514,16117,6043
"876","Camden 008C","E01000883","E02000173","Camden 008","E09000007","Camden","E12000007","London",1326,1319,7,94.4,638,2.1,"00AG","Camden",NA,10269,9705,14668,22645,20181,24064,31688,27754,9912,14359,17020,5109
"856","Camden 004D","E01000884","E02000169","Camden 004","E09000007","Camden","E12000007","London",1469,1462,7,59.9,577,2.5,"00AG","Camden",NA,21781,22871,29678,28494,26879,29552,28049,32416,5098,6681,-1629,3922
"857","Camden 004E","E01000885","E02000169","Camden 004","E09000007","Camden","E12000007","London",1484,1410,74,48.8,592,2.4,"00AG","Camden",NA,18696,19923,28631,22456,25679,29758,31631,22086,6983,9835,3000,-370
"863","Camden 006A","E01000886","E02000171","Camden 006","E09000007","Camden","E12000007","London",1445,1445,0,140.2,606,2.4,"00AG","Camden",NA,13138,14368,16783,31086,20609,16518,22535,27820,7471,2150,5752,-3266
"864","Camden 006B","E01000887","E02000171","Camden 006","E09000007","Camden","E12000007","London",1486,1478,8,148.7,690,2.1,"00AG","Camden",NA,14802,14261,15954,22780,17044,15557,19189,28265,2242,1296,3235,5485
"865","Camden 006C","E01000888","E02000171","Camden 006","E09000007","Camden","E12000007","London",1605,1605,0,170.4,697,2.3,"00AG","Camden",NA,11377,12344,13131,24110,15650,12919,16311,30774,4273,575,3180,6664
"868","Camden 007A","E01000889","E02000172","Camden 007","E09000007","Camden","E12000007","London",1670,1670,0,142.4,657,2.5,"00AG","Camden",NA,3459,1336,3153,13997,4708,3744,4492,10149,1249,2408,1339,-3848
"869","Camden 007B","E01000890","E02000172","Camden 007","E09000007","Camden","E12000007","London",1640,1625,15,214.9,767,2.1,"00AG","Camden",NA,2159,1370,1065,10936,1735,1494,950,6337,-424,124,-115,-4599
"870","Camden 007C","E01000891","E02000172","Camden 007","E09000007","Camden","E12000007","London",1575,1534,41,203,672,2.3,"00AG","Camden",NA,1561,974,1283,9924,1468,1390,2576,6772,-93,416,1293,-3152
"866","Camden 006D","E01000892","E02000171","Camden 006","E09000007","Camden","E12000007","London",1843,1843,0,150.7,823,2.2,"00AG","Camden",NA,10694,8183,11267,20962,14436,10580,14575,25338,3742,2397,3308,4376
"843","Camden 002A","E01000893","E02000167","Camden 002","E09000007","Camden","E12000007","London",1566,1566,0,29.7,715,2.2,"00AG","Camden",NA,15141,25309,21060,31099,26042,30039,28516,32153,10901,4730,7456,1054
"844","Camden 002B","E01000894","E02000167","Camden 002","E09000007","Camden","E12000007","London",1389,1376,13,62.7,619,2.2,"00AG","Camden",NA,22222,30770,31314,30202,27281,30702,31843,30535,5059,-68,529,333
"845","Camden 002C","E01000895","E02000167","Camden 002","E09000007","Camden","E12000007","London",1630,1629,1,166.2,841,1.9,"00AG","Camden",NA,16707,13497,26976,19844,19926,15649,22039,23800,3219,2152,-4937,3956
"846","Camden 002D","E01000896","E02000167","Camden 002","E09000007","Camden","E12000007","London",1692,1692,0,112,756,2.2,"00AG","Camden",NA,25338,31117,28970,30142,26131,29885,29308,24774,793,-1232,338,-5368
"877","Camden 008D","E01000897","E02000173","Camden 008","E09000007","Camden","E12000007","London",1597,1595,2,80.7,721,2.2,"00AG","Camden",NA,23187,29232,31040,30589,27673,31796,31801,28934,4486,2564,761,-1655
"878","Camden 008E","E01000898","E02000173","Camden 008","E09000007","Camden","E12000007","London",1729,1688,41,101.4,850,2,"00AG","Camden",NA,10359,8605,11006,23666,17047,14207,19947,21095,6688,5602,8941,-2571
"847","Camden 002E","E01000899","E02000167","Camden 002","E09000007","Camden","E12000007","London",1667,1606,61,15.4,698,2.3,"00AG","Camden",NA,17404,29455,29786,27657,27418,32621,32707,31007,10014,3166,2921,3350
"893","Camden 012A","E01000900","E02000177","Camden 012","E09000007","Camden","E12000007","London",1801,1795,6,181.2,757,2.4,"00AG","Camden",NA,5858,5828,6277,12915,7559,6956,9154,13914,1701,1128,2877,999
"871","Camden 007D","E01000901","E02000172","Camden 007","E09000007","Camden","E12000007","London",1977,1821,156,186.5,703,2.6,"00AG","Camden",NA,6067,2817,5786,12075,5192,2998,5624,11182,-875,181,-162,-893
"894","Camden 012B","E01000902","E02000177","Camden 012","E09000007","Camden","E12000007","London",1451,1451,0,172.5,590,2.5,"00AG","Camden",NA,4589,2327,5678,16785,4816,2382,5033,15583,227,55,-645,-1202
"867","Camden 006E","E01000903","E02000171","Camden 006","E09000007","Camden","E12000007","London",1439,1418,21,141.2,686,2.1,"00AG","Camden",NA,9579,7892,12638,26337,13819,10781,14453,30500,4240,2889,1815,4163
"895","Camden 012C","E01000904","E02000177","Camden 012","E09000007","Camden","E12000007","London",2120,2120,0,182,918,2.3,"00AG","Camden",NA,4642,3299,4082,12864,6451,6106,8456,17642,1809,2807,4374,4778
"896","Camden 012D","E01000905","E02000177","Camden 012","E09000007","Camden","E12000007","London",2044,1965,79,237.7,812,2.4,"00AG","Camden",NA,2211,1004,2753,10568,3312,1708,3845,10375,1101,704,1092,-193
"897","Camden 012E","E01000906","E02000177","Camden 012","E09000007","Camden","E12000007","London",1532,1532,0,111.3,788,1.9,"00AG","Camden",NA,15455,16964,22191,25592,19353,19200,22643,29317,3898,2236,452,3725
"838","Camden 001A","E01000907","E02000166","Camden 001","E09000007","Camden","E12000007","London",1430,1430,0,133.4,627,2.3,"00AG","Camden",NA,5165,3176,3744,18127,5950,2940,3386,16662,785,-236,-358,-1465
"839","Camden 001B","E01000908","E02000166","Camden 001","E09000007","Camden","E12000007","London",1581,1581,0,90.3,827,1.9,"00AG","Camden",NA,5959,6491,7743,15851,7784,6764,6809,17213,1825,273,-934,1362
"840","Camden 001C","E01000909","E02000166","Camden 001","E09000007","Camden","E12000007","London",1614,1614,0,70.6,661,2.4,"00AG","Camden",NA,18366,17540,17415,31060,20563,18015,16767,28406,2197,475,-648,-2654
"848","Camden 003A","E01000910","E02000168","Camden 003","E09000007","Camden","E12000007","London",1472,1472,0,113.1,588,2.5,"00AG","Camden",NA,17652,18964,16136,32177,23104,24576,24620,30942,5452,5612,8484,-1235
"849","Camden 003B","E01000911","E02000168","Camden 003","E09000007","Camden","E12000007","London",1559,1549,10,177,663,2.3,"00AG","Camden",NA,12294,11238,12837,22473,14249,10564,11749,23288,1955,-674,-1088,815
"841","Camden 001D","E01000912","E02000166","Camden 001","E09000007","Camden","E12000007","London",1589,1589,0,17.7,700,2.3,"00AG","Camden",NA,8288,7135,10622,20479,8639,5966,9184,14982,351,-1169,-1438,-5497
"842","Camden 001E","E01000913","E02000166","Camden 001","E09000007","Camden","E12000007","London",1710,1702,8,10.6,722,2.4,"00AG","Camden",NA,19608,31165,28561,30514,25499,31878,31750,32426,5891,713,3189,1912
"968","Camden 028B","E01000914","E02000193","Camden 028","E09000007","Camden","E12000007","London",1762,1753,9,39.4,970,1.8,"00AG","Camden",NA,11658,13150,15614,28340,16853,19061,22776,27560,5195,5911,7162,-780
"963","Camden 027A","E01000915","E02000192","Camden 027","E09000007","Camden","E12000007","London",1527,1527,0,206.1,635,2.4,"00AG","Camden",NA,7083,3532,10707,15000,8859,5962,10418,20172,1776,2430,-289,5172
"964","Camden 027B","E01000916","E02000192","Camden 027","E09000007","Camden","E12000007","London",1796,1718,78,121.9,881,2,"00AG","Camden",NA,9254,6814,13689,12821,11323,11317,16389,19492,2069,4503,2700,6671
"965","Camden 027C","E01000917","E02000192","Camden 027","E09000007","Camden","E12000007","London",1888,1855,33,249.7,913,2,"00AG","Camden",NA,4057,3530,2702,20001,3168,2494,3264,7642,-889,-1036,562,-12359
"969","Camden 028C","E01000918","E02000193","Camden 028","E09000007","Camden","E12000007","London",2090,1885,205,124.3,935,2,"00AG","Camden",NA,4938,6434,3494,18049,9145,9675,10572,25395,4207,3241,7078,7346
"970","Camden 028D","E01000919","E02000193","Camden 028","E09000007","Camden","E12000007","London",2014,1658,356,131.8,834,2,"00AG","Camden",NA,7733,8670,8615,20220,9904,13533,17692,22779,2171,4863,9077,2559
"966","Camden 027D","E01000920","E02000192","Camden 027","E09000007","Camden","E12000007","London",1946,1921,25,143.7,946,2,"00AG","Camden",NA,10625,9434,11231,22838,14970,12827,18289,27219,4345,3393,7058,4381
"850","Camden 003C","E01000921","E02000168","Camden 003","E09000007","Camden","E12000007","London",1966,1963,3,158,946,2.1,"00AG","Camden",NA,7519,9782,10878,27115,12366,14592,19163,28534,4847,4810,8285,1419
"872","Camden 007E","E01000922","E02000172","Camden 007","E09000007","Camden","E12000007","London",1547,1537,10,81,653,2.4,"00AG","Camden",NA,6806,5332,5219,16593,7634,6778,9838,17236,828,1446,4619,643
"851","Camden 003D","E01000923","E02000168","Camden 003","E09000007","Camden","E12000007","London",1494,1436,58,174.9,656,2.2,"00AG","Camden",NA,7726,8453,8753,24769,10129,9516,8848,27568,2403,1063,95,2799
"881","Camden 009C","E01000924","E02000174","Camden 009","E09000007","Camden","E12000007","London",1637,1637,0,166.5,795,2.1,"00AG","Camden",NA,12833,11270,11181,24569,17091,15328,18676,29644,4258,4058,7495,5075
"882","Camden 009D","E01000925","E02000174","Camden 009","E09000007","Camden","E12000007","London",1563,1552,11,188.8,629,2.5,"00AG","Camden",NA,4633,2490,5981,13233,4845,2384,4835,15596,212,-106,-1146,2363
"883","Camden 009E","E01000926","E02000174","Camden 009","E09000007","Camden","E12000007","London",1791,1791,0,193.8,698,2.6,"00AG","Camden",NA,7567,4482,6732,20103,11476,9021,13815,22347,3909,4539,7083,2244
"873","Camden 007F","E01000927","E02000172","Camden 007","E09000007","Camden","E12000007","London",1738,1732,6,172.8,734,2.4,"00AG","Camden",NA,10624,9301,11729,26145,13412,14432,15954,24758,2788,5131,4225,-1387
"852","Camden 003E","E01000928","E02000168","Camden 003","E09000007","Camden","E12000007","London",1681,1620,61,66.6,682,2.4,"00AG","Camden",NA,7296,5859,8127,24047,10216,8885,9773,26684,2920,3026,1646,2637
"931","Camden 020A","E01000929","E02000185","Camden 020","E09000007","Camden","E12000007","London",1675,1675,0,171.3,685,2.4,"00AG","Camden",NA,4437,1427,5029,18096,7212,3370,8268,15811,2775,1943,3239,-2285
"932","Camden 020B","E01000930","E02000185","Camden 020","E09000007","Camden","E12000007","London",1910,1910,0,164.4,1076,1.8,"00AG","Camden",NA,3322,2382,4774,16234,4763,3079,7453,13411,1441,697,2679,-2823
"900","Camden 013C","E01000931","E02000178","Camden 013","E09000007","Camden","E12000007","London",1910,1902,8,129.8,873,2.2,"00AG","Camden",NA,4152,4027,4680,13533,3738,3718,6175,16587,-414,-309,1495,3054
"901","Camden 013D","E01000932","E02000178","Camden 013","E09000007","Camden","E12000007","London",1838,1825,13,278.1,947,1.9,"00AG","Camden",NA,9417,9304,11894,20939,12166,8611,12967,23990,2749,-693,1073,3051
"933","Camden 020C","E01000933","E02000185","Camden 020","E09000007","Camden","E12000007","London",1671,1671,0,153.3,821,2,"00AG","Camden",NA,7193,7610,4565,25141,7555,10496,9088,28120,362,2886,4523,2979
"934","Camden 020D","E01000934","E02000185","Camden 020","E09000007","Camden","E12000007","London",1619,1542,77,185.9,732,2.1,"00AG","Camden",NA,4448,3437,4939,17130,3896,3039,5145,23455,-552,-398,206,6325
"935","Camden 020E","E01000935","E02000185","Camden 020","E09000007","Camden","E12000007","London",1415,1415,0,227.9,624,2.3,"00AG","Camden",NA,4272,2253,4467,14252,3894,1669,3702,19699,-378,-584,-765,5447
"950","Camden 024A","E01000936","E02000189","Camden 024","E09000007","Camden","E12000007","London",1839,1360,479,207.1,536,2.5,"00AG","Camden",NA,8560,6593,15822,18075,9789,10183,15448,15177,1229,3590,-374,-2898
"955","Camden 025B","E01000937","E02000190","Camden 025","E09000007","Camden","E12000007","London",1504,943,561,119.8,502,1.9,"00AG","Camden",NA,10201,15342,29872,18413,14974,23120,30158,19402,4773,7778,286,989
"951","Camden 024B","E01000938","E02000189","Camden 024","E09000007","Camden","E12000007","London",1752,1726,26,214.7,737,2.3,"00AG","Camden",NA,3464,3085,2458,15458,4996,6900,8367,16829,1532,3815,5909,1371
"952","Camden 024C","E01000939","E02000189","Camden 024","E09000007","Camden","E12000007","London",1223,1197,26,155.6,446,2.7,"00AG","Camden",NA,2691,1455,3020,14249,3200,2349,3341,8071,509,894,321,-6178
"953","Camden 024D","E01000940","E02000189","Camden 024","E09000007","Camden","E12000007","London",1130,1124,6,232,534,2.1,"00AG","Camden",NA,11511,9022,19646,17628,10345,9198,14057,17500,-1166,176,-5589,-128
"956","Camden 025C","E01000941","E02000190","Camden 025","E09000007","Camden","E12000007","London",1230,1203,27,283.4,557,2.2,"00AG","Camden",NA,3274,3540,2392,14863,3905,4712,4114,14068,631,1172,1722,-795
"957","Camden 025D","E01000942","E02000190","Camden 025","E09000007","Camden","E12000007","London",2111,1181,930,289.2,686,1.7,"00AG","Camden",NA,12637,16473,20205,20233,18207,26200,30963,22722,5570,9727,10758,2489
"958","Camden 025E","E01000943","E02000190","Camden 025","E09000007","Camden","E12000007","London",1054,991,63,150.6,596,1.7,"00AG","Camden",NA,8726,9006,11526,21551,12152,16660,17748,29486,3426,7654,6222,7935
"945","Camden 023A","E01000944","E02000188","Camden 023","E09000007","Camden","E12000007","London",1899,1899,0,325.2,667,2.8,"00AG","Camden",NA,3543,1005,4494,10859,9156,6630,13418,10017,5613,5625,8924,-842
"946","Camden 023B","E01000945","E02000188","Camden 023","E09000007","Camden","E12000007","London",1821,1493,328,67.1,611,2.4,"00AG","Camden",NA,5944,5299,7681,16381,9047,10773,15855,17917,3103,5474,8174,1536
"937","Camden 021B","E01000946","E02000186","Camden 021","E09000007","Camden","E12000007","London",1516,1475,41,31,715,2.1,"00AG","Camden",NA,17954,17888,26036,24269,18986,12910,22043,26345,1032,-4978,-3993,2076
"938","Camden 021C","E01000947","E02000186","Camden 021","E09000007","Camden","E12000007","London",1954,1925,29,125.3,871,2.2,"00AG","Camden",NA,4894,5333,7002,20655,7439,8013,11038,23763,2545,2680,4036,3108
"939","Camden 021D","E01000948","E02000186","Camden 021","E09000007","Camden","E12000007","London",1736,1708,28,88.3,846,2,"00AG","Camden",NA,5479,9133,7916,23628,6962,10116,9645,24160,1483,983,1729,532
"947","Camden 023C","E01000949","E02000188","Camden 023","E09000007","Camden","E12000007","London",1633,1578,55,262.5,739,2.1,"00AG","Camden",NA,9801,7018,7731,16841,11624,9230,12811,16170,1823,2212,5080,-671
"948","Camden 023D","E01000950","E02000188","Camden 023","E09000007","Camden","E12000007","London",1431,1431,0,210.8,550,2.6,"00AG","Camden",NA,2540,995,5375,12970,3980,3417,5903,6096,1440,2422,528,-6874
"949","Camden 023E","E01000951","E02000188","Camden 023","E09000007","Camden","E12000007","London",1538,1538,0,319.1,603,2.6,"00AG","Camden",NA,4909,2523,5418,15056,6085,4226,7489,11387,1176,1703,2071,-3669
"940","Camden 022A","E01000952","E02000187","Camden 022","E09000007","Camden","E12000007","London",1729,1728,1,198.7,675,2.6,"00AG","Camden",NA,4355,2398,4231,12701,4561,3908,6342,12050,206,1510,2111,-651
"941","Camden 022B","E01000953","E02000187","Camden 022","E09000007","Camden","E12000007","London",1643,1643,0,27.2,708,2.3,"00AG","Camden",NA,3088,2029,3752,11696,2502,1882,4774,10633,-586,-147,1022,-1063
"942","Camden 022C","E01000954","E02000187","Camden 022","E09000007","Camden","E12000007","London",1656,1656,0,298.4,642,2.6,"00AG","Camden",NA,4970,1658,4143,11081,5051,3233,4682,5392,81,1575,539,-5689
"943","Camden 022D","E01000955","E02000187","Camden 022","E09000007","Camden","E12000007","London",1595,1505,90,249.6,657,2.3,"00AG","Camden",NA,5118,2716,4651,9619,5471,5573,6293,8177,353,2857,1642,-1442
"944","Camden 022E","E01000956","E02000187","Camden 022","E09000007","Camden","E12000007","London",1532,1532,0,96.5,608,2.5,"00AG","Camden",NA,3704,2295,3888,10613,5235,4800,6887,11500,1531,2505,2999,887
"928","Camden 019C","E01000957","E02000184","Camden 019","E09000007","Camden","E12000007","London",1729,1729,0,148.2,765,2.3,"00AG","Camden",NA,9248,6137,9957,15742,6578,3811,7248,15533,-2670,-2326,-2709,-209
"929","Camden 019D","E01000958","E02000184","Camden 019","E09000007","Camden","E12000007","London",2264,2108,156,93.5,835,2.5,"00AG","Camden",NA,3782,2733,3118,13410,6439,4615,9204,13342,2657,1882,6086,-68
"930","Camden 019E","E01000959","E02000184","Camden 019","E09000007","Camden","E12000007","London",1670,1670,0,228.1,698,2.4,"00AG","Camden",NA,4340,2020,3810,17617,4299,3883,5478,11494,-41,1863,1668,-6123
"917","Camden 017A","E01000960","E02000182","Camden 017","E09000007","Camden","E12000007","London",1774,1774,0,156.2,841,2.1,"00AG","Camden",NA,10415,10234,19740,17778,12885,13914,19656,18977,2470,3680,-84,1199
"918","Camden 017B","E01000961","E02000182","Camden 017","E09000007","Camden","E12000007","London",1591,1591,0,133.2,652,2.4,"00AG","Camden",NA,5253,3339,9029,19973,9385,6486,8100,19892,4132,3147,-929,-81
"912","Camden 016A","E01000962","E02000181","Camden 016","E09000007","Camden","E12000007","London",1592,1592,0,167.1,745,2.1,"00AG","Camden",NA,18171,23871,27800,20703,25248,27514,30692,32258,7077,3643,2892,11555
"919","Camden 017C","E01000963","E02000182","Camden 017","E09000007","Camden","E12000007","London",1923,1864,59,99.8,851,2.2,"00AG","Camden",NA,19854,21955,30489,28315,21779,20280,31800,26000,1925,-1675,1311,-2315
"913","Camden 016B","E01000964","E02000181","Camden 016","E09000007","Camden","E12000007","London",1577,1577,0,125,713,2.2,"00AG","Camden",NA,12279,9808,15491,23619,14067,10862,12592,22946,1788,1054,-2899,-673
"914","Camden 016C","E01000965","E02000181","Camden 016","E09000007","Camden","E12000007","London",1522,1522,0,141.6,764,2,"00AG","Camden",NA,11883,13090,14761,18958,11314,8549,16881,26784,-569,-4541,2120,7826
"915","Camden 016D","E01000966","E02000181","Camden 016","E09000007","Camden","E12000007","London",1512,1508,4,116,675,2.2,"00AG","Camden",NA,21999,26074,29156,30667,24974,30892,32148,29833,2975,4818,2992,-834
"920","Camden 017D","E01000967","E02000182","Camden 017","E09000007","Camden","E12000007","London",1409,1409,0,37.9,619,2.3,"00AG","Camden",NA,18803,19181,27538,22415,23476,27173,30044,24833,4673,7992,2506,2418
"916","Camden 016E","E01000968","E02000181","Camden 016","E09000007","Camden","E12000007","London",1505,1504,1,184.7,760,2,"00AG","Camden",NA,16120,14358,23145,20352,16367,14454,21259,25440,247,96,-1886,5088
"884","Camden 010A","E01000969","E02000175","Camden 010","E09000007","Camden","E12000007","London",2032,2032,0,121.8,954,2.1,"00AG","Camden",NA,18858,26123,29497,23735,24914,24724,30378,30349,6056,-1399,881,6614
"885","Camden 010B","E01000970","E02000175","Camden 010","E09000007","Camden","E12000007","London",1444,1444,0,209.3,831,1.7,"00AG","Camden",NA,16627,19703,20513,25238,18621,22884,26724,29173,1994,3181,6211,3935
"886","Camden 010C","E01000971","E02000175","Camden 010","E09000007","Camden","E12000007","London",1478,1478,0,184.1,649,2.3,"00AG","Camden",NA,18634,18323,23961,23929,22246,22185,24566,31300,3612,3862,605,7371
"887","Camden 010D","E01000972","E02000175","Camden 010","E09000007","Camden","E12000007","London",2009,2009,0,143.5,949,2.1,"00AG","Camden",NA,4958,3486,5985,17750,6077,3806,6476,23602,1119,320,491,5852
"888","Camden 010E","E01000973","E02000175","Camden 010","E09000007","Camden","E12000007","London",1885,1883,2,80,894,2.1,"00AG","Camden",NA,8465,7043,11161,14460,8335,8131,11689,18245,-130,1088,528,3785
"902","Camden 013E","E01000974","E02000178","Camden 013","E09000007","Camden","E12000007","London",1707,1702,5,148.7,821,2.1,"00AG","Camden",NA,5548,5681,5891,15230,6902,6147,7658,20092,1354,466,1767,4862
"1078","Croydon 022A","E01000975","E02000215","Croydon 022","E09000008","Croydon","E12000007","London",1613,1607,6,85.2,710,2.3,"00AH","Croydon",NA,14748,13468,16659,22129,13468,12829,17457,19857,-1280,-639,798,-2272
"1079","Croydon 022B","E01000976","E02000215","Croydon 022","E09000008","Croydon","E12000007","London",1867,1867,0,114.1,824,2.3,"00AH","Croydon",NA,12378,11928,17845,18784,11632,10808,16125,23610,-746,-1120,-1720,4826
"1080","Croydon 022C","E01000977","E02000215","Croydon 022","E09000008","Croydon","E12000007","London",1731,1677,54,100,918,1.8,"00AH","Croydon",NA,5966,7813,3565,12790,7258,6658,6368,19353,1292,-1155,2803,6563
"1081","Croydon 022D","E01000978","E02000215","Croydon 022","E09000008","Croydon","E12000007","London",1775,1775,0,113,927,1.9,"00AH","Croydon",NA,15243,18637,20413,27632,11820,17253,18813,25712,-3423,-1384,-1600,-1920
"1082","Croydon 022E","E01000979","E02000215","Croydon 022","E09000008","Croydon","E12000007","London",1703,1703,0,130,790,2.2,"00AH","Croydon",NA,19162,20912,22013,25604,14704,17525,20393,21908,-4458,-3387,-1620,-3696
"1054","Croydon 017A","E01000980","E02000210","Croydon 017","E09000008","Croydon","E12000007","London",1407,1407,0,97.2,566,2.5,"00AH","Croydon",NA,15646,11271,18672,17097,11977,9879,12227,21913,-3669,-1392,-6445,4816
"1055","Croydon 017B","E01000981","E02000210","Croydon 017","E09000008","Croydon","E12000007","London",1642,1642,0,96,647,2.5,"00AH","Croydon",NA,16489,14221,19489,17067,17600,14929,19200,19354,1111,708,-289,2287
"1056","Croydon 017C","E01000982","E02000210","Croydon 017","E09000008","Croydon","E12000007","London",1604,1599,5,117.2,684,2.3,"00AH","Croydon",NA,14543,11967,16833,15479,14674,10989,16606,15215,131,-978,-227,-264
"1057","Croydon 017D","E01000983","E02000210","Croydon 017","E09000008","Croydon","E12000007","London",1712,1712,0,109.7,665,2.6,"00AH","Croydon",NA,21676,18633,24748,20656,21233,20266,23584,24476,-443,1633,-1164,3820
"1083","Croydon 022F","E01000984","E02000215","Croydon 022","E09000008","Croydon","E12000007","London",1829,1785,44,106.1,822,2.2,"00AH","Croydon",NA,9580,6096,12022,19292,8865,7486,10502,17742,-715,1390,-1520,-1550
"1074","Croydon 021A","E01000985","E02000214","Croydon 021","E09000008","Croydon","E12000007","London",1447,1447,0,38,515,2.8,"00AH","Croydon",NA,21036,21465,23158,22004,25998,23663,25494,24493,4962,2198,2336,2489
"1075","Croydon 021B","E01000986","E02000214","Croydon 021","E09000008","Croydon","E12000007","London",1738,1721,17,53.4,677,2.5,"00AH","Croydon",NA,21139,19848,22486,29606,21863,19610,20675,25807,724,-238,-1811,-3799
"1076","Croydon 021C","E01000987","E02000214","Croydon 021","E09000008","Croydon","E12000007","London",1431,1431,0,89.2,513,2.8,"00AH","Croydon",NA,23889,25348,23188,24114,27608,27775,28260,23591,3719,2427,5072,-523
"1059","Croydon 018A","E01000989","E02000211","Croydon 018","E09000008","Croydon","E12000007","London",1707,1707,0,65.6,628,2.7,"00AH","Croydon",NA,24499,19445,26039,18609,23667,22494,24128,18549,-832,3049,-1911,-60
"1192","Croydon 045A","E01000990","E02006788","Croydon 045","E09000008","Croydon","E12000007","London",1420,1420,0,84.5,538,2.6,"00AH","Croydon",NA,4836,2562,4531,4828,4608,3614,4102,5695,-228,1052,-429,867
"1060","Croydon 018B","E01000991","E02000211","Croydon 018","E09000008","Croydon","E12000007","London",1649,1649,0,36.9,662,2.5,"00AH","Croydon",NA,24707,26069,27264,21089,27738,27375,30364,22902,3031,1306,3100,1813
"1039","Croydon 014A","E01000992","E02000207","Croydon 014","E09000008","Croydon","E12000007","London",1978,1973,5,39.9,723,2.7,"00AH","Croydon",NA,4646,3525,4240,8879,6442,6287,5445,11285,1796,2762,1205,2406
"1077","Croydon 021D","E01000993","E02000214","Croydon 021","E09000008","Croydon","E12000007","London",1620,1620,0,98.6,616,2.6,"00AH","Croydon",NA,23851,22613,23375,22240,20898,19320,20931,21786,-2953,-3293,-2444,-454
"1016","Croydon 009A","E01000994","E02000202","Croydon 009","E09000008","Croydon","E12000007","London",1592,1592,0,90.7,536,3,"00AH","Croydon",NA,14321,10443,14104,21301,13229,10372,14370,20001,-1092,-71,266,-1300
"1017","Croydon 009B","E01000995","E02000202","Croydon 009","E09000008","Croydon","E12000007","London",1631,1631,0,113.7,597,2.7,"00AH","Croydon",NA,13557,11022,16162,18423,12625,12565,15521,18916,-932,1543,-641,493
"1018","Croydon 009C","E01000996","E02000202","Croydon 009","E09000008","Croydon","E12000007","London",1254,1254,0,119.2,443,2.8,"00AH","Croydon",NA,18551,13534,17486,25829,14691,11233,15535,20988,-3860,-2301,-1951,-4841
"1019","Croydon 009D","E01000997","E02000202","Croydon 009","E09000008","Croydon","E12000007","London",1396,1351,45,131.2,471,2.9,"00AH","Croydon",NA,13632,9437,14757,20124,10052,7896,10604,17889,-3580,-1541,-4153,-2235
"1022","Croydon 010A","E01000998","E02000203","Croydon 010","E09000008","Croydon","E12000007","London",1551,1551,0,111.7,629,2.5,"00AH","Croydon",NA,10169,10095,9586,14214,6172,6678,4846,13446,-3997,-3417,-4740,-768
"1020","Croydon 009E","E01000999","E02000202","Croydon 009","E09000008","Croydon","E12000007","London",1332,1332,0,136.6,436,3.1,"00AH","Croydon",NA,16043,12951,13628,19030,11140,10314,11902,18618,-4903,-2637,-1726,-412
"1023","Croydon 010B","E01001000","E02000203","Croydon 010","E09000008","Croydon","E12000007","London",1267,1251,16,91.3,454,2.8,"00AH","Croydon",NA,11142,13925,12196,13984,6850,7937,8404,18232,-4292,-5988,-3792,4248
"1033","Croydon 013A","E01001001","E02000206","Croydon 013","E09000008","Croydon","E12000007","London",1195,1184,11,98.4,493,2.4,"00AH","Croydon",NA,10647,9077,10975,13399,5620,5385,5967,16371,-5027,-3692,-5008,2972
"1021","Croydon 009F","E01001002","E02000202","Croydon 009","E09000008","Croydon","E12000007","London",1343,1343,0,125.5,498,2.7,"00AH","Croydon",NA,14163,8128,19367,17596,11750,9824,13153,15923,-2413,1696,-6214,-1673
"1024","Croydon 010C","E01001003","E02000203","Croydon 010","E09000008","Croydon","E12000007","London",1511,1497,14,96.8,608,2.5,"00AH","Croydon",NA,12777,10453,14880,15827,9085,7116,12662,18330,-3692,-3337,-2218,2503
"1044","Croydon 015A","E01001004","E02000208","Croydon 015","E09000008","Croydon","E12000007","London",2129,2125,4,136.7,787,2.7,"00AH","Croydon",NA,12723,7403,17422,12003,9602,5318,10897,16060,-3121,-2085,-6525,4057
"1064","Croydon 019A","E01001005","E02000212","Croydon 019","E09000008","Croydon","E12000007","London",1687,1687,0,184.2,536,3.1,"00AH","Croydon",NA,10847,8058,11884,17919,10132,11455,17100,13579,-715,3397,5216,-4340
"1049","Croydon 016A","E01001006","E02000209","Croydon 016","E09000008","Croydon","E12000007","London",1558,1558,0,53.3,616,2.5,"00AH","Croydon",NA,7793,5976,19090,11177,5882,6055,9722,10549,-1911,79,-9368,-628
"1050","Croydon 016B","E01001007","E02000209","Croydon 016","E09000008","Croydon","E12000007","London",1968,1968,0,131.6,605,3.3,"00AH","Croydon",NA,11594,9300,18993,12724,12953,12549,17606,17343,1359,3249,-1387,4619
"1065","Croydon 019B","E01001008","E02000212","Croydon 019","E09000008","Croydon","E12000007","London",1608,1608,0,87.4,538,3,"00AH","Croydon",NA,6339,4380,12330,8285,6404,5637,9406,7549,65,1257,-2924,-736
"1066","Croydon 019C","E01001009","E02000212","Croydon 019","E09000008","Croydon","E12000007","London",1846,1846,0,160.9,609,3,"00AH","Croydon",NA,11196,7487,18673,17108,11374,11797,15943,19238,178,4310,-2730,2130
"1067","Croydon 019D","E01001010","E02000212","Croydon 019","E09000008","Croydon","E12000007","London",1514,1514,0,20.8,539,2.8,"00AH","Croydon",NA,6685,5637,9896,7425,3657,4586,6741,4058,-3028,-1051,-3155,-3367
"1068","Croydon 019E","E01001011","E02000212","Croydon 019","E09000008","Croydon","E12000007","London",1868,1867,1,152.7,755,2.5,"00AH","Croydon",NA,7986,5467,11037,11948,5821,8241,8560,14946,-2165,2774,-2477,2998
"1069","Croydon 020A","E01001012","E02000213","Croydon 020","E09000008","Croydon","E12000007","London",1922,1895,27,134.7,746,2.5,"00AH","Croydon",NA,5530,5275,6459,18905,3511,6679,6377,12072,-2019,1404,-82,-6833
"1070","Croydon 020B","E01001013","E02000213","Croydon 020","E09000008","Croydon","E12000007","London",2018,2010,8,101.5,899,2.2,"00AH","Croydon",NA,2093,1854,2768,12023,1275,2555,3299,9336,-818,701,531,-2687
"1088","Croydon 024A","E01001014","E02000217","Croydon 024","E09000008","Croydon","E12000007","London",2663,2663,0,41.5,1186,2.2,"00AH","Croydon",NA,6682,5811,6873,17145,5483,5972,9696,16870,-1199,161,2823,-275
"1173","Croydon 041A","E01001015","E02000234","Croydon 041","E09000008","Croydon","E12000007","London",1440,1440,0,35.9,515,2.8,"00AH","Croydon",NA,13289,8804,14754,12560,10819,9876,13383,10596,-2470,1072,-1371,-1964
"1174","Croydon 041B","E01001016","E02000234","Croydon 041","E09000008","Croydon","E12000007","London",1705,1705,0,16.3,665,2.6,"00AH","Croydon",NA,21004,20023,22351,27408,18888,20896,20229,23646,-2116,873,-2122,-3762
"1182","Croydon 043A","E01001017","E02000236","Croydon 043","E09000008","Croydon","E12000007","London",1624,1611,13,12.1,642,2.5,"00AH","Croydon",NA,26192,27597,27454,29791,26738,29703,27982,30119,546,2106,528,328
"1187","Croydon 044A","E01001018","E02000237","Croydon 044","E09000008","Croydon","E12000007","London",1556,1556,0,16.4,639,2.4,"00AH","Croydon",NA,30255,30735,30556,22830,28012,29359,28689,25696,-2243,-1376,-1867,2866
"1188","Croydon 044B","E01001019","E02000237","Croydon 044","E09000008","Croydon","E12000007","London",1511,1511,0,25.3,593,2.5,"00AH","Croydon",NA,31332,30619,30770,27588,29740,29814,28800,26069,-1592,-805,-1970,-1519
"1189","Croydon 044C","E01001020","E02000237","Croydon 044","E09000008","Croydon","E12000007","London",1630,1615,15,45.3,657,2.5,"00AH","Croydon",NA,27102,23690,26811,20212,26501,24551,25077,19778,-601,861,-1734,-434
"1190","Croydon 044D","E01001021","E02000237","Croydon 044","E09000008","Croydon","E12000007","London",1332,1332,0,6.5,590,2.3,"00AH","Croydon",NA,11817,8548,14416,10159,6245,4304,7643,5729,-5572,-4244,-6773,-4430
"1191","Croydon 044E","E01001022","E02000237","Croydon 044","E09000008","Croydon","E12000007","London",1446,1441,5,14.5,611,2.4,"00AH","Croydon",NA,24753,25291,22066,23743,24547,23481,24553,26676,-206,-1810,2487,2933
"1175","Croydon 041C","E01001023","E02000234","Croydon 041","E09000008","Croydon","E12000007","London",1314,1282,32,23,575,2.2,"00AH","Croydon",NA,13018,17693,16071,21681,12009,13948,12717,21844,-1009,-3745,-3354,163
"1183","Croydon 043B","E01001024","E02000236","Croydon 043","E09000008","Croydon","E12000007","London",1428,1428,0,51.2,532,2.7,"00AH","Croydon",NA,24657,24284,26023,22172,24586,22667,24479,24902,-71,-1617,-1544,2730
"1184","Croydon 043C","E01001025","E02000236","Croydon 043","E09000008","Croydon","E12000007","London",1296,1296,0,56.8,489,2.7,"00AH","Croydon",NA,26483,23465,28271,24547,26995,26344,29403,21430,512,2879,1132,-3117
"1185","Croydon 043D","E01001026","E02000236","Croydon 043","E09000008","Croydon","E12000007","London",1729,1729,0,62.4,641,2.7,"00AH","Croydon",NA,22745,16257,23050,18560,22420,18212,21485,18938,-325,1955,-1565,378
"1186","Croydon 043E","E01001027","E02000236","Croydon 043","E09000008","Croydon","E12000007","London",1582,1567,15,10.9,534,2.9,"00AH","Croydon",NA,21862,19154,19885,24091,22912,20810,22919,21670,1050,1656,3034,-2421
"1160","Croydon 038A","E01001028","E02000231","Croydon 038","E09000008","Croydon","E12000007","London",1630,1586,44,18.7,528,3,"00AH","Croydon",NA,29629,26157,27681,30097,28884,30961,27669,30667,-745,4804,-12,570
"1161","Croydon 038B","E01001029","E02000231","Croydon 038","E09000008","Croydon","E12000007","London",1593,1472,121,31.9,541,2.7,"00AH","Croydon",NA,17146,20572,15374,31112,16132,21394,18618,28302,-1014,822,3244,-2810
"1162","Croydon 038C","E01001030","E02000231","Croydon 038","E09000008","Croydon","E12000007","London",1411,1392,19,33.7,462,3,"00AH","Croydon",NA,26726,24749,23339,31189,24486,28905,29701,30887,-2240,4156,6362,-302
"1163","Croydon 038D","E01001031","E02000231","Croydon 038","E09000008","Croydon","E12000007","London",1466,1466,0,36.5,491,3,"00AH","Croydon",NA,28868,23115,28916,30985,25441,26657,25754,30701,-3427,3542,-3162,-284
"1145","Croydon 035A","E01001032","E02000228","Croydon 035","E09000008","Croydon","E12000007","London",1396,1365,31,21.6,520,2.6,"00AH","Croydon",NA,31884,31956,29624,31581,31178,32224,28435,31181,-706,268,-1189,-400
"1122","Croydon 031A","E01001033","E02000224","Croydon 031","E09000008","Croydon","E12000007","London",1616,1616,0,54.2,694,2.3,"00AH","Croydon",NA,19131,19609,26237,27873,16580,19877,26023,22951,-2551,268,-214,-4922
"1123","Croydon 031B","E01001034","E02000224","Croydon 031","E09000008","Croydon","E12000007","London",1516,1498,18,50.7,660,2.3,"00AH","Croydon",NA,18715,19133,21521,25929,17317,19462,19684,22435,-1398,329,-1837,-3494
"1102","Croydon 027A","E01001035","E02000220","Croydon 027","E09000008","Croydon","E12000007","London",1760,1647,113,80.6,834,2,"00AH","Croydon",NA,14974,15793,19099,27458,14055,14139,16105,21178,-919,-1654,-2994,-6280
"1112","Croydon 029A","E01001036","E02000222","Croydon 029","E09000008","Croydon","E12000007","London",1521,1459,62,18,628,2.3,"00AH","Croydon",NA,17334,20911,15703,30723,19807,25110,23394,31630,2473,4199,7691,907
"1113","Croydon 029B","E01001037","E02000222","Croydon 029","E09000008","Croydon","E12000007","London",1396,1396,0,89.2,624,2.2,"00AH","Croydon",NA,9966,8835,17115,10832,11359,12934,15432,14559,1393,4099,-1683,3727
"1114","Croydon 029C","E01001038","E02000222","Croydon 029","E09000008","Croydon","E12000007","London",1792,1778,14,88.5,941,1.9,"00AH","Croydon",NA,11692,16148,14696,22359,14547,15278,15533,20485,2855,-870,837,-1874
"1115","Croydon 029D","E01001039","E02000222","Croydon 029","E09000008","Croydon","E12000007","London",1474,1465,9,31.9,583,2.5,"00AH","Croydon",NA,26991,30412,26987,31829,26468,29460,27289,31314,-523,-952,302,-515
"1116","Croydon 029E","E01001040","E02000222","Croydon 029","E09000008","Croydon","E12000007","London",1708,1708,0,87.9,763,2.2,"00AH","Croydon",NA,17055,18384,22826,20912,16764,14700,18717,22675,-291,-3684,-4109,1763
"1124","Croydon 031C","E01001041","E02000224","Croydon 031","E09000008","Croydon","E12000007","London",1611,1605,6,80.6,752,2.1,"00AH","Croydon",NA,15781,16429,21574,20798,10413,9998,13429,20880,-5368,-6431,-8145,82
"1089","Croydon 024B","E01001042","E02000217","Croydon 024","E09000008","Croydon","E12000007","London",1818,1818,0,87.2,836,2.2,"00AH","Croydon",NA,6603,6802,12597,16409,4568,6234,9242,16253,-2035,-568,-3355,-156
"1103","Croydon 027B","E01001043","E02000220","Croydon 027","E09000008","Croydon","E12000007","London",2578,2559,19,75.4,1202,2.1,"00AH","Croydon",NA,10224,10333,14118,16848,7053,10875,17103,14366,-3171,542,2985,-2482
"1084","Croydon 023A","E01001044","E02000216","Croydon 023","E09000008","Croydon","E12000007","London",1922,1880,42,42.9,871,2.2,"00AH","Croydon",NA,24713,24743,28217,31600,24410,25786,29096,28893,-303,1043,879,-2707
"1104","Croydon 027C","E01001045","E02000220","Croydon 027","E09000008","Croydon","E12000007","London",1820,1692,128,36.7,953,1.8,"00AH","Croydon",NA,7819,10092,5649,21562,8371,8981,8309,18540,552,-1111,2660,-3022
"1085","Croydon 023B","E01001046","E02000216","Croydon 023","E09000008","Croydon","E12000007","London",1751,1751,0,89.3,850,2.1,"00AH","Croydon",NA,23980,28008,31104,26988,23261,26382,28956,29674,-719,-1626,-2148,2686
"1105","Croydon 027D","E01001047","E02000220","Croydon 027","E09000008","Croydon","E12000007","London",1673,1665,8,91.9,869,1.9,"00AH","Croydon",NA,16079,16215,21941,26313,12480,15112,20605,17057,-3599,-1103,-1336,-9256
"1071","Croydon 020C","E01001048","E02000213","Croydon 020","E09000008","Croydon","E12000007","London",1942,1936,6,55.6,949,2,"00AH","Croydon",NA,10934,12018,14966,18792,6636,7908,8851,22044,-4298,-4110,-6115,3252
"1086","Croydon 023C","E01001049","E02000216","Croydon 023","E09000008","Croydon","E12000007","London",1419,1393,26,10.2,505,2.8,"00AH","Croydon",NA,19102,25391,12742,28933,22225,27605,24667,31477,3123,2214,11925,2544
"1087","Croydon 023D","E01001050","E02000216","Croydon 023","E09000008","Croydon","E12000007","London",1646,1598,48,106.3,802,2,"00AH","Croydon",NA,14532,12737,20061,22067,12664,12251,18196,23363,-1868,-486,-1865,1296
"1117","Croydon 030A","E01001051","E02000223","Croydon 030","E09000008","Croydon","E12000007","London",1549,1549,0,60.6,581,2.7,"00AH","Croydon",NA,5250,1967,8668,2378,3665,3548,6670,3593,-1585,1581,-1998,1215
"1118","Croydon 030B","E01001052","E02000223","Croydon 030","E09000008","Croydon","E12000007","London",1447,1447,0,89.5,470,3.1,"00AH","Croydon",NA,6072,2486,6123,3649,3211,2145,4503,3767,-2861,-341,-1620,118
"1127","Croydon 032A","E01001053","E02000225","Croydon 032","E09000008","Croydon","E12000007","London",1513,1512,1,65.5,527,2.9,"00AH","Croydon",NA,7869,4955,11160,4312,7033,6722,8067,4394,-836,1767,-3093,82
"1119","Croydon 030C","E01001054","E02000223","Croydon 030","E09000008","Croydon","E12000007","London",1710,1710,0,68,594,2.9,"00AH","Croydon",NA,4730,3347,5215,2951,5264,4096,6359,4363,534,749,1144,1412
"1128","Croydon 032B","E01001055","E02000225","Croydon 032","E09000008","Croydon","E12000007","London",1595,1595,0,54.7,585,2.7,"00AH","Croydon",NA,5692,3944,7751,1144,4096,4385,4443,1964,-1596,441,-3308,820
"1120","Croydon 030D","E01001056","E02000223","Croydon 030","E09000008","Croydon","E12000007","London",1851,1851,0,119.5,593,3.1,"00AH","Croydon",NA,3570,650,3938,5726,3673,1732,4711,2434,103,1082,773,-3292
"1121","Croydon 030E","E01001057","E02000223","Croydon 030","E09000008","Croydon","E12000007","London",1814,1814,0,131.5,637,2.8,"00AH","Croydon",NA,2121,587,4239,2623,3723,2182,4353,4427,1602,1595,114,1804
"1137","Croydon 034A","E01001058","E02000227","Croydon 034","E09000008","Croydon","E12000007","London",1326,1326,0,67.4,521,2.5,"00AH","Croydon",NA,24423,19799,27344,25139,20029,22740,22103,20801,-4394,2941,-5241,-4338
"1138","Croydon 034B","E01001059","E02000227","Croydon 034","E09000008","Croydon","E12000007","London",1396,1396,0,75.7,692,2,"00AH","Croydon",NA,20358,20633,26124,16026,18464,19451,20897,20032,-1894,-1182,-5227,4006
"1139","Croydon 034C","E01001060","E02000227","Croydon 034","E09000008","Croydon","E12000007","London",1581,1581,0,10.4,657,2.4,"00AH","Croydon",NA,15584,16550,22224,18665,13866,14968,17638,16351,-1718,-1582,-4586,-2314
"1140","Croydon 034D","E01001061","E02000227","Croydon 034","E09000008","Croydon","E12000007","London",1533,1533,0,33.8,642,2.4,"00AH","Croydon",NA,11144,10693,18107,9168,10107,10669,10969,10912,-1037,-24,-7138,1744
"1097","Croydon 026A","E01001062","E02000219","Croydon 026","E09000008","Croydon","E12000007","London",1567,1531,36,12.6,571,2.7,"00AH","Croydon",NA,23661,20215,26001,25980,25583,20990,25425,26641,1922,775,-576,661
"1098","Croydon 026B","E01001063","E02000219","Croydon 026","E09000008","Croydon","E12000007","London",1539,1539,0,48.3,587,2.6,"00AH","Croydon",NA,25891,25492,22584,27904,27355,24891,27934,25368,1464,-601,5350,-2536
"1099","Croydon 026C","E01001064","E02000219","Croydon 026","E09000008","Croydon","E12000007","London",1568,1568,0,4.5,613,2.6,"00AH","Croydon",NA,23018,28540,27643,26292,19209,27632,28380,26898,-3809,-908,737,606
"1141","Croydon 034E","E01001065","E02000227","Croydon 034","E09000008","Croydon","E12000007","London",1334,1334,0,11.3,672,2,"00AH","Croydon",NA,16870,20222,22953,21559,16628,21442,21568,20114,-242,1220,-1385,-1445
"1142","Croydon 034F","E01001066","E02000227","Croydon 034","E09000008","Croydon","E12000007","London",1369,1369,0,83.9,493,2.8,"00AH","Croydon",NA,4868,2364,5499,6082,3583,2440,3401,4153,-1285,76,-2098,-1929
"1176","Croydon 041D","E01001067","E02000234","Croydon 041","E09000008","Croydon","E12000007","London",1631,1631,0,23.8,578,2.8,"00AH","Croydon",NA,28208,29932,31093,30719,28923,31385,30343,30778,715,1453,-750,59
"1178","Croydon 042A","E01001068","E02000235","Croydon 042","E09000008","Croydon","E12000007","London",1924,1924,0,25,784,2.5,"00AH","Croydon",NA,14450,11865,18682,17469,15172,14872,17679,14648,722,3007,-1003,-2821
"1169","Croydon 040A","E01001069","E02000233","Croydon 040","E09000008","Croydon","E12000007","London",1385,1306,79,34.7,500,2.6,"00AH","Croydon",NA,19613,25941,21508,23402,21514,25826,22450,24210,1901,-115,942,808
"1170","Croydon 040B","E01001070","E02000233","Croydon 040","E09000008","Croydon","E12000007","London",1726,1693,33,32.7,659,2.6,"00AH","Croydon",NA,14860,12243,17361,17532,17789,15630,15969,19232,2929,3387,-1392,1700
"1179","Croydon 042B","E01001071","E02000235","Croydon 042","E09000008","Croydon","E12000007","London",1891,1891,0,25.3,735,2.6,"00AH","Croydon",NA,20522,20712,23688,19858,21087,21505,21337,19652,565,793,-2351,-206
"1180","Croydon 042C","E01001072","E02000235","Croydon 042","E09000008","Croydon","E12000007","London",1488,1420,68,6.9,533,2.7,"00AH","Croydon",NA,27795,27171,30257,30979,26258,30101,30869,30805,-1537,2930,612,-174
"1154","Croydon 037A","E01001073","E02000230","Croydon 037","E09000008","Croydon","E12000007","London",1441,1422,19,47,618,2.3,"00AH","Croydon",NA,17389,17404,17942,27989,17568,18155,19704,28050,179,751,1762,61
"1177","Croydon 041E","E01001074","E02000234","Croydon 041","E09000008","Croydon","E12000007","London",1933,1922,11,47.7,828,2.3,"00AH","Croydon",NA,16849,16943,23113,25147,14363,13520,18230,19424,-2486,-3423,-4883,-5723
"1171","Croydon 040C","E01001075","E02000233","Croydon 040","E09000008","Croydon","E12000007","London",1547,1501,46,34.6,646,2.3,"00AH","Croydon",NA,20088,21759,23014,22424,18853,19650,22035,25342,-1235,-2109,-979,2918
"1150","Croydon 036A","E01001076","E02000229","Croydon 036","E09000008","Croydon","E12000007","London",1606,1606,0,46.8,581,2.8,"00AH","Croydon",NA,8064,6872,9092,4244,7079,6753,8721,4869,-985,-119,-371,625
"1129","Croydon 032C","E01001077","E02000225","Croydon 032","E09000008","Croydon","E12000007","London",1396,1396,0,76.7,523,2.7,"00AH","Croydon",NA,18378,16384,23812,7076,17217,15362,19789,8478,-1161,-1022,-4023,1402
"1130","Croydon 032D","E01001078","E02000225","Croydon 032","E09000008","Croydon","E12000007","London",1404,1404,0,37.5,513,2.7,"00AH","Croydon",NA,6259,3162,10957,4970,5677,4876,6890,4328,-582,1714,-4067,-642
"1151","Croydon 036B","E01001079","E02000229","Croydon 036","E09000008","Croydon","E12000007","London",1681,1681,0,55.5,639,2.6,"00AH","Croydon",NA,5946,4405,7632,3111,5674,4591,7827,4883,-272,186,195,1772
"1152","Croydon 036C","E01001080","E02000229","Croydon 036","E09000008","Croydon","E12000007","London",1678,1619,59,76.8,687,2.4,"00AH","Croydon",NA,947,599,1153,1771,1372,1941,1469,2393,425,1342,316,622
"1153","Croydon 036D","E01001081","E02000229","Croydon 036","E09000008","Croydon","E12000007","London",1409,1409,0,30.9,506,2.8,"00AH","Croydon",NA,6277,4803,7335,2893,5413,4930,8214,3877,-864,127,879,984
"1131","Croydon 032E","E01001082","E02000225","Croydon 032","E09000008","Croydon","E12000007","London",1627,1627,0,29.4,560,2.9,"00AH","Croydon",NA,8047,5404,11415,5106,6493,6306,7911,4216,-1554,902,-3504,-890
"987","Croydon 003A","E01001083","E02000196","Croydon 003","E09000008","Croydon","E12000007","London",1609,1609,0,49.9,536,3,"00AH","Croydon",NA,21659,16573,22113,28637,18362,20202,22095,25944,-3297,3629,-18,-2693
"982","Croydon 002A","E01001084","E02000195","Croydon 002","E09000008","Croydon","E12000007","London",1828,1794,34,30.6,665,2.7,"00AH","Croydon",NA,18686,18979,20857,30574,18653,19935,22156,27612,-33,956,1299,-2962
"991","Croydon 004A","E01001085","E02000197","Croydon 004","E09000008","Croydon","E12000007","London",1606,1606,0,88.3,612,2.6,"00AH","Croydon",NA,14805,10066,16461,21045,12104,11165,16022,20889,-2701,1099,-439,-156
"988","Croydon 003B","E01001086","E02000196","Croydon 003","E09000008","Croydon","E12000007","London",1750,1745,5,76,603,2.9,"00AH","Croydon",NA,18621,15663,17137,24241,16263,16491,16991,22696,-2358,828,-146,-1545
"989","Croydon 003C","E01001087","E02000196","Croydon 003","E09000008","Croydon","E12000007","London",2195,2163,32,58.4,848,2.6,"00AH","Croydon",NA,9149,7754,7842,22889,10517,13750,16596,17340,1368,5996,8754,-5549
"992","Croydon 004B","E01001088","E02000197","Croydon 004","E09000008","Croydon","E12000007","London",1709,1709,0,109.8,592,2.9,"00AH","Croydon",NA,16468,10012,18540,18262,15360,12472,14376,15888,-1108,2460,-4164,-2374
"993","Croydon 004C","E01001089","E02000197","Croydon 004","E09000008","Croydon","E12000007","London",1907,1891,16,121.4,715,2.6,"00AH","Croydon",NA,10798,5805,12514,14868,7599,6141,11417,16704,-3199,336,-1097,1836
"994","Croydon 004D","E01001090","E02000197","Croydon 004","E09000008","Croydon","E12000007","London",2287,2287,0,128.1,922,2.5,"00AH","Croydon",NA,10850,7000,13303,19707,11084,9103,12791,19806,234,2103,-512,99
"995","Croydon 004E","E01001091","E02000197","Croydon 004","E09000008","Croydon","E12000007","London",1585,1579,6,49.6,562,2.8,"00AH","Croydon",NA,17754,18824,20168,27226,16286,15532,16831,28305,-1468,-3292,-3337,1079
"1155","Croydon 037B","E01001092","E02000230","Croydon 037","E09000008","Croydon","E12000007","London",1777,1555,222,30.2,588,2.6,"00AH","Croydon",NA,14413,20618,11865,28745,13043,20572,12219,29216,-1370,-46,354,471
"1156","Croydon 037C","E01001093","E02000230","Croydon 037","E09000008","Croydon","E12000007","London",1738,1738,0,42.9,694,2.5,"00AH","Croydon",NA,17279,16896,20122,25054,18566,15619,19480,26433,1287,-1277,-642,1379
"1164","Croydon 038E","E01001094","E02000231","Croydon 038","E09000008","Croydon","E12000007","London",1585,1525,60,13.6,521,2.9,"00AH","Croydon",NA,25449,23232,29710,31404,25743,27177,29943,31134,294,3945,233,-270
"1125","Croydon 031D","E01001095","E02000224","Croydon 031","E09000008","Croydon","E12000007","London",1468,1455,13,61.1,584,2.5,"00AH","Croydon",NA,14107,15605,23159,17319,14633,14669,15847,21175,526,-936,-7312,3856
"1157","Croydon 037D","E01001096","E02000230","Croydon 037","E09000008","Croydon","E12000007","London",1534,1532,2,38.9,530,2.9,"00AH","Croydon",NA,28361,30361,28308,31531,28036,25678,29408,32007,-325,-4683,1100,476
"1158","Croydon 037E","E01001097","E02000230","Croydon 037","E09000008","Croydon","E12000007","London",2103,2066,37,47.7,1059,2,"00AH","Croydon",NA,13711,13045,17969,22729,11735,11464,13782,24167,-1976,-1581,-4187,1438
"1159","Croydon 037F","E01001098","E02000230","Croydon 037","E09000008","Croydon","E12000007","London",1452,1432,20,30.3,515,2.8,"00AH","Croydon",NA,26288,27778,28374,31556,26714,27966,27299,31568,426,188,-1075,12
"1172","Croydon 040D","E01001099","E02000233","Croydon 040","E09000008","Croydon","E12000007","London",1477,1477,0,69.7,586,2.5,"00AH","Croydon",NA,14398,10871,16574,22507,13959,10622,11242,19359,-439,-249,-5332,-3148
"1126","Croydon 031E","E01001100","E02000224","Croydon 031","E09000008","Croydon","E12000007","London",1473,1472,1,60.5,619,2.4,"00AH","Croydon",NA,22956,23423,25022,26559,23678,23213,26954,30759,722,-210,1932,4200
"1146","Croydon 035B","E01001101","E02000228","Croydon 035","E09000008","Croydon","E12000007","London",1423,1423,0,26,509,2.8,"00AH","Croydon",NA,29725,30517,29226,29844,30774,32291,31562,28385,1049,1774,2336,-1459
"1147","Croydon 035C","E01001102","E02000228","Croydon 035","E09000008","Croydon","E12000007","London",1463,1454,9,23,605,2.4,"00AH","Croydon",NA,25762,27318,28551,28566,29022,25411,28813,27848,3260,-1907,262,-718
"1165","Croydon 039A","E01001103","E02000232","Croydon 039","E09000008","Croydon","E12000007","London",1680,1680,0,22.8,651,2.6,"00AH","Croydon",NA,26527,22910,24082,24221,28569,26957,22587,23186,2042,4047,-1495,-1035
"1181","Croydon 042D","E01001104","E02000235","Croydon 042","E09000008","Croydon","E12000007","London",1665,1665,0,9.8,642,2.6,"00AH","Croydon",NA,27384,30028,27710,28793,28699,27769,26679,29334,1315,-2259,-1031,541
"1166","Croydon 039B","E01001105","E02000232","Croydon 039","E09000008","Croydon","E12000007","London",1729,1729,0,17.5,632,2.7,"00AH","Croydon",NA,15263,13027,15462,10776,14836,13164,13919,15027,-427,137,-1543,4251
"1167","Croydon 039C","E01001106","E02000232","Croydon 039","E09000008","Croydon","E12000007","London",1490,1490,0,34.6,540,2.8,"00AH","Croydon",NA,23522,18806,21443,18367,23179,21228,21974,18811,-343,2422,531,444
"1148","Croydon 035D","E01001107","E02000228","Croydon 035","E09000008","Croydon","E12000007","London",1616,1586,30,21.4,662,2.4,"00AH","Croydon",NA,26667,31368,30950,31506,28378,29392,30176,31797,1711,-1976,-774,291
"1149","Croydon 035E","E01001108","E02000228","Croydon 035","E09000008","Croydon","E12000007","London",1711,1711,0,31.4,628,2.7,"00AH","Croydon",NA,31311,31264,31531,30837,30730,31693,30726,30614,-581,429,-805,-223
"1034","Croydon 013B","E01001109","E02000206","Croydon 013","E09000008","Croydon","E12000007","London",2039,1935,104,43.3,845,2.3,"00AH","Croydon",NA,8809,5024,13077,10964,6832,5773,7568,11364,-1977,749,-5509,400
"1072","Croydon 020D","E01001110","E02000213","Croydon 020","E09000008","Croydon","E12000007","London",1787,1772,15,116.1,771,2.3,"00AH","Croydon",NA,6321,5612,7505,13306,4808,8314,8801,14138,-1513,2702,1296,832
"1025","Croydon 010D","E01001111","E02000203","Croydon 010","E09000008","Croydon","E12000007","London",1607,1604,3,78.6,610,2.6,"00AH","Croydon",NA,11117,8409,12331,16468,7993,7819,8670,15187,-3124,-590,-3661,-1281
"1035","Croydon 013C","E01001112","E02000206","Croydon 013","E09000008","Croydon","E12000007","London",1718,1693,25,48.3,763,2.2,"00AH","Croydon",NA,6183,3828,6578,10873,5418,3966,6647,13432,-765,138,69,2559
"1036","Croydon 013D","E01001113","E02000206","Croydon 013","E09000008","Croydon","E12000007","London",1828,1828,0,103.7,795,2.3,"00AH","Croydon",NA,8636,8388,9052,14279,6255,5252,6902,14985,-2381,-3136,-2150,706
"1037","Croydon 013E","E01001114","E02000206","Croydon 013","E09000008","Croydon","E12000007","London",1400,1400,0,78.5,585,2.4,"00AH","Croydon",NA,7128,7083,7788,13103,4209,4750,5627,8622,-2919,-2333,-2161,-4481
"1045","Croydon 015B","E01001115","E02000208","Croydon 015","E09000008","Croydon","E12000007","London",1706,1706,0,77.8,657,2.6,"00AH","Croydon",NA,4280,2940,4954,8919,3417,3561,5989,9166,-863,621,1035,247
"1038","Croydon 013F","E01001116","E02000206","Croydon 013","E09000008","Croydon","E12000007","London",1359,1359,0,86.1,528,2.6,"00AH","Croydon",NA,12376,9735,17396,13489,8633,6600,9890,14129,-3743,-3135,-7506,640
"1046","Croydon 015C","E01001117","E02000208","Croydon 015","E09000008","Croydon","E12000007","London",2761,2655,106,158.6,1113,2.4,"00AH","Croydon",NA,6998,6290,5280,21040,8296,10098,12997,20462,1298,3808,7717,-578
"1073","Croydon 020E","E01001118","E02000213","Croydon 020","E09000008","Croydon","E12000007","London",1882,1882,0,101.2,795,2.4,"00AH","Croydon",NA,5234,3055,6366,12731,4335,3555,4557,11299,-899,500,-1809,-1432
"1143","Croydon 034G","E01001119","E02000227","Croydon 034","E09000008","Croydon","E12000007","London",1470,1470,0,21.3,576,2.6,"00AH","Croydon",NA,27109,30859,27711,18774,27030,30796,26907,19154,-79,-63,-804,380
"1132","Croydon 033A","E01001120","E02000226","Croydon 033","E09000008","Croydon","E12000007","London",1263,1263,0,41.2,480,2.6,"00AH","Croydon",NA,26949,23884,27340,17632,22417,21885,19596,15894,-4532,-1999,-7744,-1738
"1168","Croydon 039D","E01001121","E02000232","Croydon 039","E09000008","Croydon","E12000007","London",1308,1279,29,5.9,501,2.6,"00AH","Croydon",NA,27614,31685,29689,26508,29635,28758,28687,25899,2021,-2927,-1002,-609
"1133","Croydon 033B","E01001122","E02000226","Croydon 033","E09000008","Croydon","E12000007","London",1539,1384,155,12.4,507,2.7,"00AH","Croydon",NA,25286,29867,27960,30465,25858,31300,31234,26967,572,1433,3274,-3498
"1134","Croydon 033C","E01001123","E02000226","Croydon 033","E09000008","Croydon","E12000007","London",1514,1514,0,20.2,598,2.5,"00AH","Croydon",NA,24218,26996,24399,26110,26779,26793,28285,24635,2561,-203,3886,-1475
"1135","Croydon 033D","E01001124","E02000226","Croydon 033","E09000008","Croydon","E12000007","London",1573,1539,34,26.2,609,2.5,"00AH","Croydon",NA,31230,31722,30581,31197,30751,30423,29859,30550,-479,-1299,-722,-647
"1136","Croydon 033E","E01001125","E02000226","Croydon 033","E09000008","Croydon","E12000007","London",1650,1650,0,42.5,602,2.7,"00AH","Croydon",NA,26178,21204,26384,23491,21121,18326,18391,19527,-5057,-2878,-7993,-3964
"1144","Croydon 034H","E01001126","E02000227","Croydon 034","E09000008","Croydon","E12000007","London",1402,1402,0,63.8,598,2.3,"00AH","Croydon",NA,26674,28412,26821,19063,26064,23412,29012,22153,-610,-5000,2191,3090
"1093","Croydon 025A","E01001127","E02000218","Croydon 025","E09000008","Croydon","E12000007","London",1607,1607,0,48.7,574,2.8,"00AH","Croydon",NA,27166,24372,24032,24766,27853,25957,22540,23044,687,1585,-1492,-1722
"1094","Croydon 025B","E01001128","E02000218","Croydon 025","E09000008","Croydon","E12000007","London",1611,1611,0,73.4,566,2.8,"00AH","Croydon",NA,6622,2036,8965,7066,5469,3330,5592,7467,-1153,1294,-3373,401
"1100","Croydon 026D","E01001129","E02000219","Croydon 026","E09000008","Croydon","E12000007","London",1455,1455,0,50.1,502,2.9,"00AH","Croydon",NA,30728,31468,28031,23636,30713,31203,28243,25431,-15,-265,212,1795
"1095","Croydon 025C","E01001130","E02000218","Croydon 025","E09000008","Croydon","E12000007","London",1776,1776,0,128.6,598,3,"00AH","Croydon",NA,3486,402,6814,4156,4663,2517,5411,7778,1177,2115,-1403,3622
"1061","Croydon 018C","E01001131","E02000211","Croydon 018","E09000008","Croydon","E12000007","London",1563,1563,0,95.4,685,2.3,"00AH","Croydon",NA,20280,14890,23747,22194,20406,15720,24731,16815,126,830,984,-5379
"1062","Croydon 018D","E01001132","E02000211","Croydon 018","E09000008","Croydon","E12000007","London",1464,1464,0,33.9,607,2.4,"00AH","Croydon",NA,26560,30825,25484,26066,26394,26165,23518,22844,-166,-4660,-1966,-3222
"1101","Croydon 026E","E01001133","E02000219","Croydon 026","E09000008","Croydon","E12000007","London",1557,1557,0,39,726,2.1,"00AH","Croydon",NA,25256,23462,25065,23171,23896,21672,20647,19125,-1360,-1790,-4418,-4046
"1063","Croydon 018E","E01001134","E02000211","Croydon 018","E09000008","Croydon","E12000007","London",1617,1617,0,43,697,2.3,"00AH","Croydon",NA,21830,19048,23934,24025,20905,18801,21256,24224,-925,-247,-2678,199
"1096","Croydon 025D","E01001135","E02000218","Croydon 025","E09000008","Croydon","E12000007","London",1646,1646,0,36.5,631,2.6,"00AH","Croydon",NA,26690,26436,26164,23829,26366,24146,27533,23144,-324,-2290,1369,-685
"1006","Croydon 007A","E01001136","E02000200","Croydon 007","E09000008","Croydon","E12000007","London",1880,1828,52,66.7,927,2,"00AH","Croydon",NA,6282,5569,5516,16170,4133,6599,6802,16754,-2149,1030,1286,584
"977","Croydon 001A","E01001137","E02000194","Croydon 001","E09000008","Croydon","E12000007","London",1769,1739,30,49.8,875,2,"00AH","Croydon",NA,8380,6832,5396,24714,10280,9176,10488,25483,1900,2344,5092,769
"978","Croydon 001B","E01001138","E02000194","Croydon 001","E09000008","Croydon","E12000007","London",1582,1582,0,60.3,774,2,"00AH","Croydon",NA,11411,8392,16311,17288,17106,14527,18326,26145,5695,6135,2015,8857
"1007","Croydon 007B","E01001139","E02000200","Croydon 007","E09000008","Croydon","E12000007","London",1602,1602,0,86.9,694,2.3,"00AH","Croydon",NA,15021,13751,13953,21802,12774,12855,12436,22871,-2247,-896,-1517,1069
"1008","Croydon 007C","E01001140","E02000200","Croydon 007","E09000008","Croydon","E12000007","London",1613,1573,40,46,773,2,"00AH","Croydon",NA,11963,9979,19119,14844,11875,10819,15650,19024,-88,840,-3469,4180
"1011","Croydon 008A","E01001141","E02000201","Croydon 008","E09000008","Croydon","E12000007","London",1246,1246,0,81.5,568,2.2,"00AH","Croydon",NA,9741,6961,12686,12768,8336,6721,9166,18941,-1405,-240,-3520,6173
"1009","Croydon 007D","E01001142","E02000200","Croydon 007","E09000008","Croydon","E12000007","London",1526,1526,0,49.2,620,2.5,"00AH","Croydon",NA,15988,17747,15975,20201,12986,11544,15101,23652,-3002,-6203,-874,3451
"1012","Croydon 008B","E01001143","E02000201","Croydon 008","E09000008","Croydon","E12000007","London",1941,1941,0,86.8,848,2.3,"00AH","Croydon",NA,9669,8099,13969,12920,6443,5958,8332,13867,-3226,-2141,-5637,947
"1010","Croydon 007E","E01001144","E02000200","Croydon 007","E09000008","Croydon","E12000007","London",1673,1663,10,139.2,797,2.1,"00AH","Croydon",NA,5439,4885,3842,9390,4986,4115,4680,16206,-453,-770,838,6816
"1013","Croydon 008C","E01001145","E02000201","Croydon 008","E09000008","Croydon","E12000007","London",1686,1686,0,120.7,848,2,"00AH","Croydon",NA,2782,2393,2633,13121,2632,3411,4732,15043,-150,1018,2099,1922
"1001","Croydon 006A","E01001146","E02000199","Croydon 006","E09000008","Croydon","E12000007","London",1615,1615,0,122.5,607,2.7,"00AH","Croydon",NA,13947,10204,12576,16420,12773,9366,11590,17137,-1174,-838,-986,717
"996","Croydon 005A","E01001147","E02000198","Croydon 005","E09000008","Croydon","E12000007","London",1622,1621,1,80.7,620,2.6,"00AH","Croydon",NA,9012,5529,10296,10417,6815,5770,6480,8982,-2197,241,-3816,-1435
"997","Croydon 005B","E01001148","E02000198","Croydon 005","E09000008","Croydon","E12000007","London",1613,1605,8,113.4,673,2.4,"00AH","Croydon",NA,11861,7878,10409,16821,12248,9140,13037,18256,387,1262,2628,1435
"1002","Croydon 006B","E01001149","E02000199","Croydon 006","E09000008","Croydon","E12000007","London",1572,1572,0,114.7,619,2.5,"00AH","Croydon",NA,16399,14059,17567,21292,15076,10234,13335,22889,-1323,-3825,-4232,1597
"1003","Croydon 006C","E01001150","E02000199","Croydon 006","E09000008","Croydon","E12000007","London",1655,1652,3,59.6,620,2.7,"00AH","Croydon",NA,18628,16480,19261,22947,11647,10825,13891,25123,-6981,-5655,-5370,2176
"998","Croydon 005C","E01001151","E02000198","Croydon 005","E09000008","Croydon","E12000007","London",1600,1569,31,95.8,671,2.3,"00AH","Croydon",NA,5789,3544,6018,12550,4535,4769,5102,8671,-1254,1225,-916,-3879
"999","Croydon 005D","E01001152","E02000198","Croydon 005","E09000008","Croydon","E12000007","London",1671,1662,9,97.1,674,2.5,"00AH","Croydon",NA,7962,8508,9635,17189,5844,6587,6646,14713,-2118,-1921,-2989,-2476
"1004","Croydon 006D","E01001153","E02000199","Croydon 006","E09000008","Croydon","E12000007","London",1619,1617,2,115.7,591,2.7,"00AH","Croydon",NA,12120,10538,10771,20039,10733,8630,9814,16381,-1387,-1908,-957,-3658
"1005","Croydon 006E","E01001154","E02000199","Croydon 006","E09000008","Croydon","E12000007","London",1969,1967,2,111.7,735,2.7,"00AH","Croydon",NA,9632,6107,11354,15603,7229,7230,9868,12564,-2403,1123,-1486,-3039
"1026","Croydon 010E","E01001155","E02000203","Croydon 010","E09000008","Croydon","E12000007","London",1603,1591,12,118.2,761,2.1,"00AH","Croydon",NA,4050,3165,3300,10202,2424,2252,3807,9774,-1626,-913,507,-428
"979","Croydon 001C","E01001156","E02000194","Croydon 001","E09000008","Croydon","E12000007","London",1718,1638,80,61.8,721,2.3,"00AH","Croydon",NA,8992,6862,8347,17995,9535,9275,13151,15822,543,2413,4804,-2173
"983","Croydon 002B","E01001157","E02000195","Croydon 002","E09000008","Croydon","E12000007","London",1703,1697,6,51.3,615,2.8,"00AH","Croydon",NA,13373,12618,12511,19829,13870,13980,15327,23084,497,1362,2816,3255
"1000","Croydon 005E","E01001158","E02000198","Croydon 005","E09000008","Croydon","E12000007","London",1564,1564,0,74.5,700,2.2,"00AH","Croydon",NA,13168,10853,16161,17495,12971,11507,15880,17881,-197,654,-281,386
"984","Croydon 002C","E01001159","E02000195","Croydon 002","E09000008","Croydon","E12000007","London",1801,1801,0,44.7,741,2.4,"00AH","Croydon",NA,15032,14844,17075,19353,17299,14645,20877,25582,2267,-199,3802,6229
"985","Croydon 002D","E01001160","E02000195","Croydon 002","E09000008","Croydon","E12000007","London",1881,1881,0,58.6,627,3,"00AH","Croydon",NA,17751,10647,17145,24939,18206,16576,19086,22180,455,5929,1941,-2759
"990","Croydon 003D","E01001161","E02000196","Croydon 003","E09000008","Croydon","E12000007","London",1849,1849,0,62.1,566,3.3,"00AH","Croydon",NA,3058,421,3145,7053,3606,2153,3100,7508,548,1732,-45,455
"980","Croydon 001D","E01001162","E02000194","Croydon 001","E09000008","Croydon","E12000007","London",1724,1698,26,54.9,767,2.2,"00AH","Croydon",NA,8770,5323,8195,15526,9087,9112,9116,20848,317,3789,921,5322
"986","Croydon 002E","E01001163","E02000195","Croydon 002","E09000008","Croydon","E12000007","London",1939,1939,0,68.7,798,2.4,"00AH","Croydon",NA,15675,16275,16646,21036,17615,17775,19510,24239,1940,1500,2864,3203
"981","Croydon 001E","E01001164","E02000194","Croydon 001","E09000008","Croydon","E12000007","London",1903,1879,24,104.2,962,2,"00AH","Croydon",NA,10117,10447,8234,16450,13923,15061,15727,25439,3806,4614,7493,8989
"1090","Croydon 024C","E01001165","E02000217","Croydon 024","E09000008","Croydon","E12000007","London",1656,1656,0,91.7,676,2.4,"00AH","Croydon",NA,15735,14454,17972,18557,12875,15692,18340,19758,-2860,1238,368,1201
"1091","Croydon 024D","E01001166","E02000217","Croydon 024","E09000008","Croydon","E12000007","London",1814,1814,0,103.2,835,2.2,"00AH","Croydon",NA,9435,9341,9436,19966,7702,7689,10893,19577,-1733,-1652,1457,-389
"1107","Croydon 028A","E01001167","E02000221","Croydon 028","E09000008","Croydon","E12000007","London",2193,2193,0,38.9,829,2.6,"00AH","Croydon",NA,11848,11543,18813,17976,12924,13603,17719,20807,1076,2060,-1094,2831
"1092","Croydon 024E","E01001168","E02000217","Croydon 024","E09000008","Croydon","E12000007","London",1737,1737,0,77.5,740,2.3,"00AH","Croydon",NA,16511,17450,20729,21933,14456,17019,17864,22745,-2055,-431,-2865,812
"1108","Croydon 028B","E01001169","E02000221","Croydon 028","E09000008","Croydon","E12000007","London",1680,1680,0,75.1,651,2.6,"00AH","Croydon",NA,7125,4528,8505,7675,6772,5550,7826,8703,-353,1022,-679,1028
"1106","Croydon 027E","E01001170","E02000220","Croydon 027","E09000008","Croydon","E12000007","London",2050,1946,104,79.6,989,2,"00AH","Croydon",NA,4538,7646,5955,18010,7791,10388,12145,12856,3253,2742,6190,-5154
"1109","Croydon 028C","E01001171","E02000221","Croydon 028","E09000008","Croydon","E12000007","London",1638,1484,154,55,681,2.2,"00AH","Croydon",NA,9089,7932,9664,16184,9773,8376,10359,22847,684,444,695,6663
"1110","Croydon 028D","E01001172","E02000221","Croydon 028","E09000008","Croydon","E12000007","London",1748,1726,22,24.9,616,2.8,"00AH","Croydon",NA,4276,1596,6286,4031,3689,3238,4038,5289,-587,1642,-2248,1258
"1111","Croydon 028E","E01001173","E02000221","Croydon 028","E09000008","Croydon","E12000007","London",2561,2547,14,25.2,1089,2.3,"00AH","Croydon",NA,12160,11422,16831,17291,12453,9243,14573,20411,293,-2179,-2258,3120
"1027","Croydon 011A","E01001174","E02000204","Croydon 011","E09000008","Croydon","E12000007","London",1620,1620,0,70.8,523,3.1,"00AH","Croydon",NA,15055,10631,15817,20410,12966,12315,12282,15986,-2089,1684,-3535,-4424
"1028","Croydon 011B","E01001175","E02000204","Croydon 011","E09000008","Croydon","E12000007","London",1542,1448,94,101.7,527,2.7,"00AH","Croydon",NA,9869,8600,8328,17776,6611,6707,8157,19905,-3258,-1893,-171,2129
"1029","Croydon 011C","E01001176","E02000204","Croydon 011","E09000008","Croydon","E12000007","London",1902,1899,3,75.4,628,3,"00AH","Croydon",NA,12225,8986,13105,17674,10519,11026,13387,17000,-1706,2040,282,-674
"1051","Croydon 016C","E01001177","E02000209","Croydon 016","E09000008","Croydon","E12000007","London",1617,1614,3,55,551,2.9,"00AH","Croydon",NA,7924,5297,7973,11235,6749,6921,7695,14537,-1175,1624,-278,3302
"1047","Croydon 015D","E01001178","E02000208","Croydon 015","E09000008","Croydon","E12000007","London",1365,1341,24,75.6,505,2.7,"00AH","Croydon",NA,7700,5073,9842,12715,1145,346,3182,6239,-6555,-4727,-6660,-6476
"1052","Croydon 016D","E01001179","E02000209","Croydon 016","E09000008","Croydon","E12000007","London",1534,1534,0,133.9,538,2.9,"00AH","Croydon",NA,16817,13441,20041,16825,12482,10972,15927,18589,-4335,-2469,-4114,1764
"1053","Croydon 016E","E01001180","E02000209","Croydon 016","E09000008","Croydon","E12000007","London",1737,1737,0,113.6,609,2.9,"00AH","Croydon",NA,11988,9399,18747,15553,9886,10732,12697,18285,-2102,1333,-6050,2732
"1048","Croydon 015E","E01001181","E02000208","Croydon 015","E09000008","Croydon","E12000007","London",1829,1818,11,125.4,759,2.4,"00AH","Croydon",NA,5714,5755,4075,15173,4114,5574,6667,13154,-1600,-181,2592,-2019
"1030","Croydon 011D","E01001182","E02000204","Croydon 011","E09000008","Croydon","E12000007","London",1422,1422,0,109.3,462,3.1,"00AH","Croydon",NA,18553,13863,20816,23065,12560,11374,13411,21510,-5993,-2489,-7405,-1555
"1031","Croydon 011E","E01001183","E02000204","Croydon 011","E09000008","Croydon","E12000007","London",1572,1572,0,116.4,550,2.9,"00AH","Croydon",NA,12403,11282,14610,22924,11360,11146,13848,17697,-1043,-136,-762,-5227
"1032","Croydon 011F","E01001184","E02000204","Croydon 011","E09000008","Croydon","E12000007","London",1349,1349,0,71.5,456,3,"00AH","Croydon",NA,18324,14271,18083,21230,16919,16068,19830,21388,-1405,1797,1747,158
"1040","Croydon 014B","E01001185","E02000207","Croydon 014","E09000008","Croydon","E12000007","London",1636,1636,0,81.4,717,2.3,"00AH","Croydon",NA,13791,13122,16011,13197,11572,11234,13817,15353,-2219,-1888,-2194,2156
"1041","Croydon 014C","E01001186","E02000207","Croydon 014","E09000008","Croydon","E12000007","London",1745,1743,2,96.9,841,2.1,"00AH","Croydon",NA,11722,9957,12083,17466,7371,5378,6515,19144,-4351,-4579,-5568,1678
"1058","Croydon 017E","E01001187","E02000210","Croydon 017","E09000008","Croydon","E12000007","London",1945,1940,5,117,809,2.4,"00AH","Croydon",NA,10130,7756,10915,15212,10451,8834,10010,17349,321,1078,-905,2137
"1042","Croydon 014D","E01001188","E02000207","Croydon 014","E09000008","Croydon","E12000007","London",1833,1818,15,97.5,728,2.5,"00AH","Croydon",NA,9184,6874,11734,11986,6934,5859,8524,15621,-2250,-1015,-3210,3635
"1193","Croydon 045B","E01001189","E02006788","Croydon 045","E09000008","Croydon","E12000007","London",1211,1211,0,102.7,465,2.6,"00AH","Croydon",NA,18611,14460,23396,13672,15587,12596,15556,16990,-3024,-1864,-7840,3318
"1194","Croydon 045C","E01001190","E02006788","Croydon 045","E09000008","Croydon","E12000007","London",1586,1586,0,62.9,616,2.6,"00AH","Croydon",NA,11250,7836,13708,16766,9456,7402,9043,22096,-1794,-434,-4665,5330
"1014","Croydon 008D","E01001191","E02000201","Croydon 008","E09000008","Croydon","E12000007","London",1764,1764,0,112.3,823,2.1,"00AH","Croydon",NA,7856,8244,9071,12530,6156,5856,8085,18684,-1700,-2388,-986,6154
"1015","Croydon 008E","E01001192","E02000201","Croydon 008","E09000008","Croydon","E12000007","London",1644,1644,0,88.5,727,2.3,"00AH","Croydon",NA,8473,6721,9867,12361,7605,7260,9540,17181,-868,539,-327,4820
"1043","Croydon 014E","E01001193","E02000207","Croydon 014","E09000008","Croydon","E12000007","London",1807,1807,0,102.5,583,3.1,"00AH","Croydon",NA,5645,915,8264,9977,6356,4573,5747,10725,711,3658,-2517,748
"1195","Croydon 045D","E01001194","E02006788","Croydon 045","E09000008","Croydon","E12000007","London",1572,1572,0,29,624,2.5,"00AH","Croydon",NA,16906,13278,21709,13964,12927,11093,15970,13929,-3979,-2185,-5739,-35
"1298","Ealing 021A","E01001195","E02000258","Ealing 021","E09000009","Ealing","E12000007","London",1833,1833,0,44.2,598,3.1,"00AJ","Ealing",NA,17249,13878,21627,26751,19170,14595,24159,21169,1921,717,2532,-5582
"1263","Ealing 015A","E01001196","E02000252","Ealing 015","E09000009","Ealing","E12000007","London",1766,1727,39,77.1,762,2.3,"00AJ","Ealing",NA,5387,3802,6908,20165,3183,3015,5286,12861,-2204,-787,-1622,-7304
"1299","Ealing 021B","E01001197","E02000258","Ealing 021","E09000009","Ealing","E12000007","London",1753,1700,53,43.5,668,2.5,"00AJ","Ealing",NA,10589,10151,10311,27767,11762,10561,10496,24821,1173,410,185,-2946
"1300","Ealing 021C","E01001198","E02000258","Ealing 021","E09000009","Ealing","E12000007","London",1440,1432,8,131.6,584,2.5,"00AJ","Ealing",NA,11976,16640,14781,31629,15817,16670,17876,29119,3841,30,3095,-2510
"1301","Ealing 021D","E01001199","E02000258","Ealing 021","E09000009","Ealing","E12000007","London",1704,1694,10,161.1,694,2.4,"00AJ","Ealing",NA,11650,8601,13518,28796,12980,8677,12671,26712,1330,76,-847,-2084
"1317","Ealing 025A","E01001200","E02000262","Ealing 025","E09000009","Ealing","E12000007","London",1516,1508,8,112,586,2.6,"00AJ","Ealing",NA,14056,17110,15274,29592,14850,16198,17751,28842,794,-912,2477,-750
"1318","Ealing 025B","E01001201","E02000262","Ealing 025","E09000009","Ealing","E12000007","London",1561,1537,24,127.3,642,2.4,"00AJ","Ealing",NA,9910,14044,13315,29070,15319,15279,16442,26662,5409,1235,3127,-2408
"1319","Ealing 025C","E01001202","E02000262","Ealing 025","E09000009","Ealing","E12000007","London",2120,2114,6,129.7,871,2.4,"00AJ","Ealing",NA,5843,3568,7323,22376,5282,5262,9543,20853,-561,1694,2220,-1523
"1320","Ealing 025D","E01001203","E02000262","Ealing 025","E09000009","Ealing","E12000007","London",1734,1732,2,188.1,861,2,"00AJ","Ealing",NA,5652,4788,4383,19601,7474,6770,7158,22506,1822,1982,2775,2905
"1279","Ealing 018A","E01001204","E02000255","Ealing 018","E09000009","Ealing","E12000007","London",1589,1586,3,94.4,585,2.7,"00AJ","Ealing",NA,20427,14428,25328,31284,21895,15729,19794,31663,1468,1301,-5534,379
"1280","Ealing 018B","E01001205","E02000255","Ealing 018","E09000009","Ealing","E12000007","London",1559,1559,0,63.3,598,2.6,"00AJ","Ealing",NA,5793,2992,8403,18843,6386,5164,7509,21444,593,2172,-894,2601
"1281","Ealing 018C","E01001206","E02000255","Ealing 018","E09000009","Ealing","E12000007","London",1714,1714,0,114.4,582,2.9,"00AJ","Ealing",NA,3891,781,6006,15126,2239,494,3367,9631,-1652,-287,-2639,-5495
"1282","Ealing 018D","E01001207","E02000255","Ealing 018","E09000009","Ealing","E12000007","London",1570,1570,0,98.4,668,2.4,"00AJ","Ealing",NA,16519,19193,19483,29384,19303,18892,21629,29318,2784,-301,2146,-66
"1283","Ealing 018E","E01001208","E02000255","Ealing 018","E09000009","Ealing","E12000007","London",1366,1366,0,25.3,498,2.7,"00AJ","Ealing",NA,22256,23165,25688,31989,24242,25503,26367,31834,1986,2338,679,-155
"1254","Ealing 013A","E01001209","E02000250","Ealing 013","E09000009","Ealing","E12000007","London",1712,1712,0,61.9,647,2.6,"00AJ","Ealing",NA,25933,25315,29148,31670,28320,27964,29891,31645,2387,2649,743,-25
"1268","Ealing 016A","E01001210","E02000253","Ealing 016","E09000009","Ealing","E12000007","London",1679,1675,4,74.2,740,2.3,"00AJ","Ealing",NA,2934,1647,3282,18384,1956,1049,2056,11821,-978,-598,-1226,-6563
"1255","Ealing 013B","E01001211","E02000250","Ealing 013","E09000009","Ealing","E12000007","London",1702,1649,53,94.5,705,2.3,"00AJ","Ealing",NA,21359,18661,19302,32090,23776,19821,23555,32329,2417,1160,4253,239
"1284","Ealing 018F","E01001212","E02000255","Ealing 018","E09000009","Ealing","E12000007","London",1667,1534,133,58.4,691,2.2,"00AJ","Ealing",NA,17119,22327,15936,31999,18703,21178,17957,32202,1584,-1149,2021,203
"1306","Ealing 023A","E01001213","E02000260","Ealing 023","E09000009","Ealing","E12000007","London",1830,1810,20,121.2,503,3.6,"00AJ","Ealing",NA,8393,6083,6526,14346,6951,9160,8419,10629,-1442,3077,1893,-3717
"1307","Ealing 023B","E01001214","E02000260","Ealing 023","E09000009","Ealing","E12000007","London",1749,1749,0,75.2,477,3.7,"00AJ","Ealing",NA,12754,12516,11099,15775,15498,14333,15313,19665,2744,1817,4214,3890
"1308","Ealing 023C","E01001215","E02000260","Ealing 023","E09000009","Ealing","E12000007","London",1765,1765,0,101.5,552,3.2,"00AJ","Ealing",NA,6488,6158,9117,19320,6416,7273,10701,14230,-72,1115,1584,-5090
"1309","Ealing 023D","E01001216","E02000260","Ealing 023","E09000009","Ealing","E12000007","London",1564,1537,27,110.4,476,3.2,"00AJ","Ealing",NA,10154,11419,14029,24304,11436,13676,15043,14443,1282,2257,1014,-9861
"1258","Ealing 014A","E01001217","E02000251","Ealing 014","E09000009","Ealing","E12000007","London",1539,1539,0,82.3,455,3.4,"00AJ","Ealing",NA,15255,12254,15233,23413,15228,15936,16506,17942,-27,3682,1273,-5471
"1250","Ealing 012A","E01001218","E02000249","Ealing 012","E09000009","Ealing","E12000007","London",1908,1908,0,69.1,692,2.8,"00AJ","Ealing",NA,5331,3418,6217,19669,5044,5585,6811,11184,-287,2167,594,-8485
"1339","Ealing 029A","E01001219","E02000266","Ealing 029","E09000009","Ealing","E12000007","London",2046,2015,31,123.9,674,3,"00AJ","Ealing",NA,3151,1233,3234,10307,4381,2230,5579,8895,1230,997,2345,-1412
"1340","Ealing 029B","E01001220","E02000266","Ealing 029","E09000009","Ealing","E12000007","London",1509,1509,0,16.2,471,3.2,"00AJ","Ealing",NA,1658,405,4460,6822,2282,1540,4548,5678,624,1135,88,-1144
"1290","Ealing 020A","E01001221","E02000257","Ealing 020","E09000009","Ealing","E12000007","London",1861,1837,24,61.5,952,1.9,"00AJ","Ealing",NA,10412,16557,18635,26922,11287,14933,16368,27768,875,-1624,-2267,846
"1285","Ealing 019A","E01001222","E02000256","Ealing 019","E09000009","Ealing","E12000007","London",2384,2381,3,126,1150,2.1,"00AJ","Ealing",NA,9383,13019,14185,28415,11713,13160,16659,28661,2330,141,2474,246
"1291","Ealing 020B","E01001223","E02000257","Ealing 020","E09000009","Ealing","E12000007","London",1517,1408,109,67.9,643,2.2,"00AJ","Ealing",NA,21505,23295,19546,30618,24117,24342,24698,32609,2612,1047,5152,1991
"1286","Ealing 019B","E01001224","E02000256","Ealing 019","E09000009","Ealing","E12000007","London",1616,1609,7,67.6,570,2.8,"00AJ","Ealing",NA,20759,29221,25839,32158,27947,29824,29523,32570,7188,603,3684,412
"1292","Ealing 020C","E01001225","E02000257","Ealing 020","E09000009","Ealing","E12000007","London",1790,1772,18,76.4,807,2.2,"00AJ","Ealing",NA,11396,16023,19819,26318,11443,15303,19060,31847,47,-720,-759,5529
"1287","Ealing 019C","E01001226","E02000256","Ealing 019","E09000009","Ealing","E12000007","London",1535,1491,44,67,668,2.2,"00AJ","Ealing",NA,17479,18093,22758,30600,20462,19264,20492,31083,2983,1171,-2266,483
"1288","Ealing 019D","E01001227","E02000256","Ealing 019","E09000009","Ealing","E12000007","London",1514,1490,24,87.6,602,2.5,"00AJ","Ealing",NA,18305,26968,24718,31956,26388,27694,25170,32602,8083,726,452,646
"1289","Ealing 019E","E01001228","E02000256","Ealing 019","E09000009","Ealing","E12000007","London",1812,1680,132,68.1,792,2.1,"00AJ","Ealing",NA,19635,17751,24830,30774,24704,21592,28204,31044,5069,3841,3374,270
"1350","Ealing 031A","E01001229","E02000268","Ealing 031","E09000009","Ealing","E12000007","London",1522,1522,0,74.7,597,2.5,"00AJ","Ealing",NA,8448,5132,8451,16412,7935,6664,7947,14967,-513,1532,-504,-1445
"1351","Ealing 031B","E01001230","E02000268","Ealing 031","E09000009","Ealing","E12000007","London",1488,1372,116,77.8,629,2.2,"00AJ","Ealing",NA,13683,17357,8289,32347,12451,12810,7341,31669,-1232,-4547,-948,-678
"1328","Ealing 027A","E01001231","E02000264","Ealing 027","E09000009","Ealing","E12000007","London",1866,1866,0,46.4,696,2.7,"00AJ","Ealing",NA,21258,23319,28174,29542,20207,20645,28513,29086,-1051,-2674,339,-456
"1352","Ealing 031C","E01001232","E02000268","Ealing 031","E09000009","Ealing","E12000007","London",1538,1538,0,71.3,612,2.5,"00AJ","Ealing",NA,12882,9408,14073,27313,13699,12197,15468,23064,817,2789,1395,-4249
"1353","Ealing 031D","E01001233","E02000268","Ealing 031","E09000009","Ealing","E12000007","London",1424,1424,0,83.5,599,2.4,"00AJ","Ealing",NA,11809,11367,14708,22812,12325,11142,14226,18682,516,-225,-482,-4130
"1329","Ealing 027B","E01001234","E02000264","Ealing 027","E09000009","Ealing","E12000007","London",1401,1391,10,45.8,640,2.2,"00AJ","Ealing",NA,9956,17097,22130,31502,11552,14724,20486,28220,1596,-2373,-1644,-3282
"1293","Ealing 020D","E01001235","E02000257","Ealing 020","E09000009","Ealing","E12000007","London",1597,1487,110,58.2,691,2.2,"00AJ","Ealing",NA,18016,19746,27831,26478,18586,22744,26347,25222,570,2998,-1484,-1256
"1294","Ealing 020E","E01001236","E02000257","Ealing 020","E09000009","Ealing","E12000007","London",1590,1587,3,113.5,741,2.1,"00AJ","Ealing",NA,18102,18274,21240,27652,16944,14034,21076,24801,-1158,-4240,-164,-2851
"1354","Ealing 031E","E01001237","E02000268","Ealing 031","E09000009","Ealing","E12000007","London",1593,1476,117,67.5,652,2.3,"00AJ","Ealing",NA,16105,17575,18358,31474,18737,23527,25666,31167,2632,5952,7308,-307
"1264","Ealing 015B","E01001238","E02000252","Ealing 015","E09000009","Ealing","E12000007","London",2868,2868,0,69.7,1236,2.3,"00AJ","Ealing",NA,6244,5774,10100,18788,8586,9347,15365,17725,2342,3573,5265,-1063
"1265","Ealing 015C","E01001239","E02000252","Ealing 015","E09000009","Ealing","E12000007","London",1542,1522,20,37.1,553,2.8,"00AJ","Ealing",NA,5500,3738,6045,15951,6810,6324,8897,13880,1310,2586,2852,-2071
"1311","Ealing 024A","E01001240","E02000261","Ealing 024","E09000009","Ealing","E12000007","London",1615,1615,0,82.3,512,3.2,"00AJ","Ealing",NA,11704,9410,17459,20013,9133,7233,14318,15675,-2571,-2177,-3141,-4338
"1312","Ealing 024B","E01001241","E02000261","Ealing 024","E09000009","Ealing","E12000007","London",1501,1501,0,42.5,503,3,"00AJ","Ealing",NA,11302,11192,19357,23043,11086,12452,17598,19444,-216,1260,-1759,-3599
"1313","Ealing 024C","E01001242","E02000261","Ealing 024","E09000009","Ealing","E12000007","London",1455,1441,14,69.8,524,2.8,"00AJ","Ealing",NA,12409,13413,12246,28391,9792,9518,9097,20412,-2617,-3895,-3149,-7979
"1314","Ealing 024D","E01001243","E02000261","Ealing 024","E09000009","Ealing","E12000007","London",1742,1742,0,78.5,649,2.7,"00AJ","Ealing",NA,8717,7832,11991,19980,7200,6555,9793,21067,-1517,-1277,-2198,1087
"1315","Ealing 024E","E01001244","E02000261","Ealing 024","E09000009","Ealing","E12000007","London",2539,2539,0,118.8,1099,2.3,"00AJ","Ealing",NA,4108,1918,6362,14672,7506,6551,13022,22057,3398,4633,6660,7385
"1316","Ealing 024F","E01001245","E02000261","Ealing 024","E09000009","Ealing","E12000007","London",1914,1914,0,172.7,823,2.3,"00AJ","Ealing",NA,12516,10426,17538,27003,16872,13778,24023,28229,4356,3352,6485,1226
"1266","Ealing 015D","E01001246","E02000252","Ealing 015","E09000009","Ealing","E12000007","London",1360,1360,0,13.5,492,2.8,"00AJ","Ealing",NA,6316,4182,9038,13535,5649,4555,9124,8684,-667,373,86,-4851
"1267","Ealing 015E","E01001247","E02000252","Ealing 015","E09000009","Ealing","E12000007","London",2170,2170,0,19.1,674,3.2,"00AJ","Ealing",NA,10982,11671,14834,20093,11807,10184,18765,17710,825,-1487,3931,-2383
"1370","Ealing 035A","E01001248","E02000272","Ealing 035","E09000009","Ealing","E12000007","London",1592,1547,45,23.9,581,2.7,"00AJ","Ealing",NA,14661,11268,16280,26895,15861,11907,14771,24136,1200,639,-1509,-2759
"1333","Ealing 028A","E01001249","E02000265","Ealing 028","E09000009","Ealing","E12000007","London",2370,2316,54,152.3,1025,2.3,"00AJ","Ealing",NA,2568,1568,2704,12907,3997,5279,5642,20071,1429,3711,2938,7164
"1334","Ealing 028B","E01001250","E02000265","Ealing 028","E09000009","Ealing","E12000007","London",2041,2005,36,82.5,983,2,"00AJ","Ealing",NA,5939,5729,5009,20434,5633,3973,5653,12354,-306,-1756,644,-8080
"1346","Ealing 030A","E01001251","E02000267","Ealing 030","E09000009","Ealing","E12000007","London",1654,1654,0,88.5,659,2.5,"00AJ","Ealing",NA,16273,18438,26259,28453,16749,17615,22478,25898,476,-823,-3781,-2555
"1347","Ealing 030B","E01001252","E02000267","Ealing 030","E09000009","Ealing","E12000007","London",1938,1938,0,100.1,768,2.5,"00AJ","Ealing",NA,10280,10226,10612,25852,9888,8371,12577,21348,-392,-1855,1965,-4504
"1348","Ealing 030C","E01001253","E02000267","Ealing 030","E09000009","Ealing","E12000007","London",1649,1646,3,101,670,2.5,"00AJ","Ealing",NA,13137,11765,14287,25978,18165,14098,18913,19970,5028,2333,4626,-6008
"1349","Ealing 030D","E01001254","E02000267","Ealing 030","E09000009","Ealing","E12000007","London",1685,1675,10,80.4,750,2.2,"00AJ","Ealing",NA,17315,16476,21519,26071,19508,17466,22902,26393,2193,990,1383,322
"1335","Ealing 028C","E01001255","E02000265","Ealing 028","E09000009","Ealing","E12000007","London",1610,1603,7,90.8,608,2.6,"00AJ","Ealing",NA,17997,18304,18043,28642,22159,21870,24193,28210,4162,3566,6150,-432
"1230","Ealing 008A","E01001257","E02000245","Ealing 008","E09000009","Ealing","E12000007","London",1783,1783,0,108.2,659,2.7,"00AJ","Ealing",NA,2232,1323,3348,6826,3720,2084,4311,8160,1488,761,963,1334
"1240","Ealing 010B","E01001258","E02000247","Ealing 010","E09000009","Ealing","E12000007","London",1690,1690,0,79.6,634,2.7,"00AJ","Ealing",NA,13698,13262,14939,22447,16515,14235,17707,19506,2817,973,2768,-2941
"1259","Ealing 014B","E01001259","E02000251","Ealing 014","E09000009","Ealing","E12000007","London",1457,1457,0,55.8,510,2.9,"00AJ","Ealing",NA,12657,12885,17837,25096,12079,13218,18306,14528,-578,333,469,-10568
"1251","Ealing 012B","E01001260","E02000249","Ealing 012","E09000009","Ealing","E12000007","London",1899,1899,0,70.8,660,2.9,"00AJ","Ealing",NA,10764,11286,15538,25857,11490,13962,16407,20038,726,2676,869,-5819
"1252","Ealing 012C","E01001261","E02000249","Ealing 012","E09000009","Ealing","E12000007","London",2178,2135,43,50.7,758,2.8,"00AJ","Ealing",NA,7877,9051,9126,16207,9875,11181,14493,13102,1998,2130,5367,-3105
"1241","Ealing 010C","E01001262","E02000247","Ealing 010","E09000009","Ealing","E12000007","London",1592,1522,70,61.3,558,2.7,"00AJ","Ealing",NA,7647,5375,11343,10896,7443,6616,8346,10187,-204,1241,-2997,-709
"1242","Ealing 010D","E01001263","E02000247","Ealing 010","E09000009","Ealing","E12000007","London",1672,1672,0,51,647,2.6,"00AJ","Ealing",NA,5553,3739,5775,15514,7954,4979,8339,11506,2401,1240,2564,-4008
"1243","Ealing 010E","E01001264","E02000247","Ealing 010","E09000009","Ealing","E12000007","London",1655,1655,0,54.5,612,2.7,"00AJ","Ealing",NA,8249,6062,10259,18968,9387,7602,11087,12625,1138,1540,828,-6343
"1221","Ealing 006A","E01001265","E02000243","Ealing 006","E09000009","Ealing","E12000007","London",1692,1692,0,33.8,627,2.7,"00AJ","Ealing",NA,10897,10388,13273,18495,14983,15135,18752,19519,4086,4747,5479,1024
"1222","Ealing 006B","E01001266","E02000243","Ealing 006","E09000009","Ealing","E12000007","London",1832,1832,0,25,578,3.2,"00AJ","Ealing",NA,16132,14906,19411,26511,17746,17170,20548,23708,1614,2264,1137,-2803
"1223","Ealing 006C","E01001267","E02000243","Ealing 006","E09000009","Ealing","E12000007","London",1953,1932,21,50.9,814,2.4,"00AJ","Ealing",NA,7173,6001,9422,15493,8410,7605,10737,16205,1237,1604,1315,712
"1253","Ealing 012D","E01001268","E02000249","Ealing 012","E09000009","Ealing","E12000007","London",1736,1736,0,57.1,629,2.8,"00AJ","Ealing",NA,18084,18580,20129,29036,16634,18416,18494,22976,-1450,-164,-1635,-6060
"1197","Ealing 001A","E01001269","E02000238","Ealing 001","E09000009","Ealing","E12000007","London",1983,1983,0,68.1,646,3.1,"00AJ","Ealing",NA,21539,17238,27626,27590,19425,21440,27668,20843,-2114,4202,42,-6747
"1213","Ealing 004A","E01001270","E02000241","Ealing 004","E09000009","Ealing","E12000007","London",1721,1721,0,61.1,565,3,"00AJ","Ealing",NA,18248,13922,21679,21400,18219,16461,21586,23117,-29,2539,-93,1717
"1198","Ealing 001B","E01001271","E02000238","Ealing 001","E09000009","Ealing","E12000007","London",1804,1802,2,53.2,593,3,"00AJ","Ealing",NA,13434,9729,18736,22832,15486,12111,16504,16826,2052,2382,-2232,-6006
"1224","Ealing 006D","E01001272","E02000243","Ealing 006","E09000009","Ealing","E12000007","London",1628,1607,21,29.7,542,3,"00AJ","Ealing",NA,17669,15150,22396,26302,18705,19710,22027,26341,1036,4560,-369,39
"1295","Ealing 020F","E01001273","E02000257","Ealing 020","E09000009","Ealing","E12000007","London",1623,1623,0,41.7,597,2.7,"00AJ","Ealing",NA,24026,28178,31827,32387,27898,28023,32260,30916,3872,-155,433,-1471
"1296","Ealing 020G","E01001274","E02000257","Ealing 020","E09000009","Ealing","E12000007","London",1630,1630,0,60.8,585,2.8,"00AJ","Ealing",NA,26769,27376,30190,30282,26664,22830,28361,26005,-105,-4546,-1829,-4277
"1297","Ealing 020H","E01001275","E02000257","Ealing 020","E09000009","Ealing","E12000007","London",1901,1866,35,54.5,857,2.2,"00AJ","Ealing",NA,11720,17808,14633,26235,16968,19383,19152,30231,5248,1575,4519,3996
"1246","Ealing 011A","E01001276","E02000248","Ealing 011","E09000009","Ealing","E12000007","London",1788,1788,0,49.6,651,2.7,"00AJ","Ealing",NA,14415,14172,22228,26946,12836,12797,18067,20536,-1579,-1375,-4161,-6410
"1247","Ealing 011B","E01001277","E02000248","Ealing 011","E09000009","Ealing","E12000007","London",1844,1844,0,34,668,2.8,"00AJ","Ealing",NA,16254,14256,20580,29424,15883,15274,23324,25051,-371,1018,2744,-4373
"1248","Ealing 011C","E01001278","E02000248","Ealing 011","E09000009","Ealing","E12000007","London",1962,1962,0,43.4,801,2.4,"00AJ","Ealing",NA,14477,12651,24950,30931,14092,13120,23582,25400,-385,469,-1368,-5531
"1256","Ealing 013C","E01001279","E02000250","Ealing 013","E09000009","Ealing","E12000007","London",1473,1473,0,58.2,564,2.6,"00AJ","Ealing",NA,26309,25879,30969,32430,29215,31372,31456,32375,2906,5493,487,-55
"1249","Ealing 011D","E01001280","E02000248","Ealing 011","E09000009","Ealing","E12000007","London",1740,1740,0,46.9,782,2.2,"00AJ","Ealing",NA,23250,27063,27321,28442,21914,20862,27614,23799,-1336,-6201,293,-4643
"1257","Ealing 013D","E01001281","E02000250","Ealing 013","E09000009","Ealing","E12000007","London",1600,1533,67,55.6,625,2.5,"00AJ","Ealing",NA,26126,27607,29914,31859,28259,28552,30314,32585,2133,945,400,726
"1269","Ealing 016B","E01001282","E02000253","Ealing 016","E09000009","Ealing","E12000007","London",1557,1557,0,103.7,627,2.5,"00AJ","Ealing",NA,6955,3257,6702,14656,7640,5317,6716,15731,685,2060,14,1075
"1270","Ealing 016C","E01001283","E02000253","Ealing 016","E09000009","Ealing","E12000007","London",1595,1595,0,61.2,712,2.2,"00AJ","Ealing",NA,6790,4485,6353,14817,5408,2820,5039,14317,-1382,-1665,-1314,-500
"1302","Ealing 022A","E01001284","E02000259","Ealing 022","E09000009","Ealing","E12000007","London",1539,1539,0,32.6,538,2.9,"00AJ","Ealing",NA,18841,18343,21099,26754,17323,17398,18730,24247,-1518,-945,-2369,-2507
"1271","Ealing 016D","E01001285","E02000253","Ealing 016","E09000009","Ealing","E12000007","London",1690,1627,63,79.3,562,2.9,"00AJ","Ealing",NA,11807,8942,14932,17203,12178,9728,12708,15179,371,786,-2224,-2024
"1272","Ealing 016E","E01001286","E02000253","Ealing 016","E09000009","Ealing","E12000007","London",1674,1674,0,78.4,620,2.7,"00AJ","Ealing",NA,11574,8153,12169,25606,11147,11456,11273,14457,-427,3303,-896,-11149
"1273","Ealing 016F","E01001287","E02000253","Ealing 016","E09000009","Ealing","E12000007","London",1437,1437,0,155.9,483,3,"00AJ","Ealing",NA,9079,4194,8631,18828,6762,3895,6236,16145,-2317,-299,-2395,-2683
"1303","Ealing 022B","E01001288","E02000259","Ealing 022","E09000009","Ealing","E12000007","London",1498,1497,1,86.6,531,2.8,"00AJ","Ealing",NA,17651,13553,18942,29258,18098,15614,17665,28126,447,2061,-1277,-1132
"1304","Ealing 022C","E01001289","E02000259","Ealing 022","E09000009","Ealing","E12000007","London",1383,1383,0,110.3,476,2.9,"00AJ","Ealing",NA,19058,13008,22318,30398,18904,18138,20676,30369,-154,5130,-1642,-29
"1305","Ealing 022D","E01001290","E02000259","Ealing 022","E09000009","Ealing","E12000007","London",1856,1856,0,36.6,738,2.5,"00AJ","Ealing",NA,17092,19524,23063,31387,21117,20243,24266,29771,4025,719,1203,-1616
"1260","Ealing 014C","E01001291","E02000251","Ealing 014","E09000009","Ealing","E12000007","London",1642,1642,0,99.1,495,3.3,"00AJ","Ealing",NA,13153,10840,13602,23061,13897,13710,15003,19841,744,2870,1401,-3220
"1261","Ealing 014D","E01001292","E02000251","Ealing 014","E09000009","Ealing","E12000007","London",1708,1708,0,91.6,504,3.4,"00AJ","Ealing",NA,16617,13575,20445,23143,19564,17161,21228,20643,2947,3586,783,-2500
"1262","Ealing 014E","E01001293","E02000251","Ealing 014","E09000009","Ealing","E12000007","London",1598,1598,0,109.6,478,3.3,"00AJ","Ealing",NA,11346,7974,10374,20260,15589,11694,15424,18760,4243,3720,5050,-1500
"1274","Ealing 017A","E01001294","E02000254","Ealing 017","E09000009","Ealing","E12000007","London",1894,1894,0,63.8,538,3.5,"00AJ","Ealing",NA,11039,8791,11687,18308,14135,12677,15924,15197,3096,3886,4237,-3111
"1275","Ealing 017B","E01001295","E02000254","Ealing 017","E09000009","Ealing","E12000007","London",1826,1826,0,114.1,521,3.5,"00AJ","Ealing",NA,13203,11393,13552,17224,17364,16515,16922,19259,4161,5122,3370,2035
"1276","Ealing 017C","E01001296","E02000254","Ealing 017","E09000009","Ealing","E12000007","London",1481,1481,0,93.6,404,3.7,"00AJ","Ealing",NA,9870,5961,10563,17413,12025,9900,11403,13915,2155,3939,840,-3498
"1277","Ealing 017D","E01001297","E02000254","Ealing 017","E09000009","Ealing","E12000007","London",1814,1814,0,72.4,495,3.7,"00AJ","Ealing",NA,9439,7236,9578,18723,10295,10560,10916,16779,856,3324,1338,-1944
"1278","Ealing 017E","E01001298","E02000254","Ealing 017","E09000009","Ealing","E12000007","London",1934,1812,122,110.3,529,3.4,"00AJ","Ealing",NA,9360,7500,8988,17646,9120,9102,11875,17444,-240,1602,2887,-202
"1371","Ealing 035B","E01001299","E02000272","Ealing 035","E09000009","Ealing","E12000007","London",1833,1833,0,80.4,651,2.8,"00AJ","Ealing",NA,25299,24325,25357,31810,28939,27107,28432,31010,3640,2782,3075,-800
"1385","Ealing 039A","E01001300","E02000276","Ealing 039","E09000009","Ealing","E12000007","London",1692,1688,4,123,608,2.8,"00AJ","Ealing",NA,23053,24202,28008,30732,26404,26956,29581,31901,3351,2754,1573,1169
"1386","Ealing 039B","E01001301","E02000276","Ealing 039","E09000009","Ealing","E12000007","London",1782,1523,259,70.9,707,2.2,"00AJ","Ealing",NA,14853,17855,23722,30673,14407,17569,24603,24052,-446,-286,881,-6621
"1387","Ealing 039C","E01001302","E02000276","Ealing 039","E09000009","Ealing","E12000007","London",1621,1621,0,48.1,614,2.6,"00AJ","Ealing",NA,22432,21670,28344,31079,23830,24156,24850,31710,1398,2486,-3494,631
"1356","Ealing 032A","E01001303","E02000269","Ealing 032","E09000009","Ealing","E12000007","London",1639,1639,0,102,624,2.6,"00AJ","Ealing",NA,22248,23206,26808,32233,26410,27317,30355,32192,4162,4111,3547,-41
"1388","Ealing 039D","E01001304","E02000276","Ealing 039","E09000009","Ealing","E12000007","London",1627,1627,0,140.6,705,2.3,"00AJ","Ealing",NA,17132,16295,19711,27150,21496,17613,22219,31374,4364,1318,2508,4224
"1372","Ealing 035C","E01001305","E02000272","Ealing 035","E09000009","Ealing","E12000007","London",1716,1716,0,113.9,634,2.7,"00AJ","Ealing",NA,26568,28808,25609,32072,29123,28830,29846,32458,2555,22,4237,386
"1373","Ealing 035D","E01001306","E02000272","Ealing 035","E09000009","Ealing","E12000007","London",1607,1607,0,104.6,713,2.3,"00AJ","Ealing",NA,23685,21802,26089,31638,28366,27355,29432,31037,4681,5553,3343,-601
"1202","Ealing 002A","E01001307","E02000239","Ealing 002","E09000009","Ealing","E12000007","London",1833,1833,0,32,633,2.9,"00AJ","Ealing",NA,22364,19659,23808,28617,20240,19811,25329,20082,-2124,152,1521,-8535
"1203","Ealing 002B","E01001308","E02000239","Ealing 002","E09000009","Ealing","E12000007","London",2042,2042,0,18.4,679,3,"00AJ","Ealing",NA,17226,16508,21473,28753,22059,20174,27831,26048,4833,3666,6358,-2705
"1199","Ealing 001C","E01001309","E02000238","Ealing 001","E09000009","Ealing","E12000007","London",1830,1830,0,54.8,614,3,"00AJ","Ealing",NA,17238,16129,21707,20745,18306,17762,27554,20137,1068,1633,5847,-608
"1200","Ealing 001D","E01001310","E02000238","Ealing 001","E09000009","Ealing","E12000007","London",1801,1789,12,75.8,663,2.7,"00AJ","Ealing",NA,13741,12375,19063,18517,15652,13582,19601,17822,1911,1207,538,-695
"1201","Ealing 001E","E01001311","E02000238","Ealing 001","E09000009","Ealing","E12000007","London",2082,1977,105,64.8,663,3,"00AJ","Ealing",NA,6167,3680,7778,7932,8651,6825,10598,10394,2484,3145,2820,2462
"1204","Ealing 002C","E01001312","E02000239","Ealing 002","E09000009","Ealing","E12000007","London",1839,1839,0,89.7,590,3.1,"00AJ","Ealing",NA,18827,14318,25173,23477,18355,16927,24450,21937,-472,2609,-723,-1540
"1205","Ealing 002D","E01001313","E02000239","Ealing 002","E09000009","Ealing","E12000007","London",1701,1701,0,98.4,516,3.3,"00AJ","Ealing",NA,17671,17272,18758,26412,21873,21296,24183,22768,4202,4024,5425,-3644
"1206","Ealing 002E","E01001314","E02000239","Ealing 002","E09000009","Ealing","E12000007","London",1585,1585,0,54.1,506,3.1,"00AJ","Ealing",NA,17254,12448,21954,25049,21452,19703,27348,22098,4198,7255,5394,-2951
"1207","Ealing 003A","E01001315","E02000240","Ealing 003","E09000009","Ealing","E12000007","London",1461,1461,0,88.9,495,3,"00AJ","Ealing",NA,12953,10700,13990,18041,15169,13126,16712,16578,2216,2426,2722,-1463
"1208","Ealing 003B","E01001316","E02000240","Ealing 003","E09000009","Ealing","E12000007","London",1583,1583,0,87,620,2.6,"00AJ","Ealing",NA,3585,3298,6402,7746,6082,4497,8059,10021,2497,1199,1657,2275
"1209","Ealing 003C","E01001317","E02000240","Ealing 003","E09000009","Ealing","E12000007","London",1862,1862,0,55.2,686,2.7,"00AJ","Ealing",NA,6631,5514,12666,11129,10375,8727,12056,11597,3744,3213,-610,468
"1210","Ealing 003D","E01001318","E02000240","Ealing 003","E09000009","Ealing","E12000007","London",1790,1790,0,70.3,677,2.6,"00AJ","Ealing",NA,4677,4266,7338,8857,7095,4813,8708,11700,2418,547,1370,2843
"1214","Ealing 004B","E01001319","E02000241","Ealing 004","E09000009","Ealing","E12000007","London",1498,1498,0,107.1,490,3.1,"00AJ","Ealing",NA,17718,11381,24314,20720,17298,14749,20776,16360,-420,3368,-3538,-4360
"1211","Ealing 003E","E01001320","E02000240","Ealing 003","E09000009","Ealing","E12000007","London",1548,1548,0,33.8,534,2.9,"00AJ","Ealing",NA,2009,962,4309,7538,4331,2405,4317,7861,2322,1443,8,323
"1212","Ealing 003F","E01001321","E02000240","Ealing 003","E09000009","Ealing","E12000007","London",2021,2021,0,61,758,2.7,"00AJ","Ealing",NA,8390,5405,14956,15433,10450,8771,10272,14081,2060,3366,-4684,-1352
"1215","Ealing 004C","E01001322","E02000241","Ealing 004","E09000009","Ealing","E12000007","London",1692,1692,0,31,627,2.7,"00AJ","Ealing",NA,13385,11953,15484,21568,14581,13328,18634,20664,1196,1375,3150,-904
"1216","Ealing 004D","E01001323","E02000241","Ealing 004","E09000009","Ealing","E12000007","London",1728,1728,0,51,684,2.5,"00AJ","Ealing",NA,11305,10896,17635,18397,11709,12203,17649,14190,404,1307,14,-4207
"1231","Ealing 008B","E01001324","E02000245","Ealing 008","E09000009","Ealing","E12000007","London",1553,1541,12,49.1,662,2.3,"00AJ","Ealing",NA,7974,6494,13865,21267,6893,7617,10741,15561,-1081,1123,-3124,-5706
"1235","Ealing 009A","E01001325","E02000246","Ealing 009","E09000009","Ealing","E12000007","London",1758,1758,0,18.5,602,2.9,"00AJ","Ealing",NA,6589,6381,10174,6499,9870,7519,10062,11258,3281,1138,-112,4759
"1232","Ealing 008C","E01001326","E02000245","Ealing 008","E09000009","Ealing","E12000007","London",1719,1719,0,23.2,674,2.6,"00AJ","Ealing",NA,3738,2435,7663,10863,6858,5662,10629,12782,3120,3227,2966,1919
"1236","Ealing 009B","E01001327","E02000246","Ealing 009","E09000009","Ealing","E12000007","London",1803,1803,0,64.8,600,3,"00AJ","Ealing",NA,6513,6837,9910,10958,8925,8156,9795,11824,2412,1319,-115,866
"1237","Ealing 009C","E01001328","E02000246","Ealing 009","E09000009","Ealing","E12000007","London",1730,1730,0,45.1,620,2.8,"00AJ","Ealing",NA,4457,3018,6580,9617,5689,4828,8459,10486,1232,1810,1879,869
"1238","Ealing 009D","E01001329","E02000246","Ealing 009","E09000009","Ealing","E12000007","London",1783,1783,0,59.1,631,2.8,"00AJ","Ealing",NA,9591,8536,14095,14502,10578,8265,12524,16472,987,-271,-1571,1970
"1233","Ealing 008D","E01001330","E02000245","Ealing 008","E09000009","Ealing","E12000007","London",1598,1598,0,53.8,636,2.5,"00AJ","Ealing",NA,1908,1110,4391,10137,3184,2725,4658,10996,1276,1615,267,859
"1239","Ealing 009E","E01001331","E02000246","Ealing 009","E09000009","Ealing","E12000007","London",1674,1674,0,117.6,618,2.7,"00AJ","Ealing",NA,4405,1970,7554,5851,4812,2785,5966,10782,407,815,-1588,4931
"1234","Ealing 008E","E01001332","E02000245","Ealing 008","E09000009","Ealing","E12000007","London",1503,1503,0,109.5,579,2.6,"00AJ","Ealing",NA,4135,3020,6032,9523,5075,3285,6281,12441,940,265,249,2918
"1381","Ealing 038A","E01001333","E02000275","Ealing 038","E09000009","Ealing","E12000007","London",1903,1806,97,68.4,563,3.2,"00AJ","Ealing",NA,3244,3262,3237,10594,3780,3232,7600,9977,536,-30,4363,-617
"1341","Ealing 029C","E01001334","E02000266","Ealing 029","E09000009","Ealing","E12000007","London",1623,1623,0,102.1,522,3.1,"00AJ","Ealing",NA,2452,647,3123,12314,3741,2233,5488,7773,1289,1586,2365,-4541
"1382","Ealing 038B","E01001335","E02000275","Ealing 038","E09000009","Ealing","E12000007","London",1781,1699,82,36.3,524,3.2,"00AJ","Ealing",NA,13991,14603,19665,27984,13344,13916,18431,25291,-647,-687,-1234,-2693
"1383","Ealing 038C","E01001336","E02000275","Ealing 038","E09000009","Ealing","E12000007","London",1572,1572,0,62,519,3,"00AJ","Ealing",NA,9971,8341,9538,21432,10515,8871,10003,19203,544,530,465,-2229
"1342","Ealing 029D","E01001337","E02000266","Ealing 029","E09000009","Ealing","E12000007","London",1470,1388,82,12.1,452,3.1,"00AJ","Ealing",NA,4804,4477,6041,14954,5739,6871,7331,14758,935,2394,1290,-196
"1343","Ealing 029E","E01001338","E02000266","Ealing 029","E09000009","Ealing","E12000007","London",1953,1894,59,35.7,518,3.7,"00AJ","Ealing",NA,7095,5733,6243,16769,8842,10663,11143,16572,1747,4930,4900,-197
"1344","Ealing 029F","E01001339","E02000266","Ealing 029","E09000009","Ealing","E12000007","London",1841,1841,0,25.4,568,3.2,"00AJ","Ealing",NA,4564,1378,5610,16698,5560,4171,5509,11837,996,2793,-101,-4861
"1345","Ealing 029G","E01001340","E02000266","Ealing 029","E09000009","Ealing","E12000007","London",1889,1368,521,155.2,506,2.7,"00AJ","Ealing",NA,2248,2826,338,14089,4365,5411,2597,10552,2117,2585,2259,-3537
"1217","Ealing 005A","E01001341","E02000242","Ealing 005","E09000009","Ealing","E12000007","London",1712,1712,0,74.7,529,3.2,"00AJ","Ealing",NA,17193,11409,19336,25824,19126,20284,25740,18058,1933,8875,6404,-7766
"1218","Ealing 005B","E01001342","E02000242","Ealing 005","E09000009","Ealing","E12000007","London",1867,1867,0,98.3,638,2.9,"00AJ","Ealing",NA,16438,13438,16067,27884,17344,14834,22084,21220,906,1396,6017,-6664
"1219","Ealing 005C","E01001343","E02000242","Ealing 005","E09000009","Ealing","E12000007","London",1504,1504,0,52.2,483,3.1,"00AJ","Ealing",NA,17447,13664,19193,28233,19720,17849,20998,19534,2273,4185,1805,-8699
"1226","Ealing 007A","E01001344","E02000244","Ealing 007","E09000009","Ealing","E12000007","London",2161,2161,0,44.7,880,2.5,"00AJ","Ealing",NA,12076,12446,15651,25782,13166,10730,14585,21788,1090,-1716,-1066,-3994
"1220","Ealing 005D","E01001345","E02000242","Ealing 005","E09000009","Ealing","E12000007","London",1680,1680,0,92.8,501,3.4,"00AJ","Ealing",NA,13747,10659,12315,17251,16056,15578,17017,15169,2309,4919,4702,-2082
"1227","Ealing 007B","E01001346","E02000244","Ealing 007","E09000009","Ealing","E12000007","London",1878,1878,0,81.7,634,3,"00AJ","Ealing",NA,17558,14841,20087,25356,22082,17715,25654,25509,4524,2874,5567,153
"1228","Ealing 007C","E01001347","E02000244","Ealing 007","E09000009","Ealing","E12000007","London",1534,1534,0,22.8,518,3,"00AJ","Ealing",NA,16215,16622,19033,22176,16537,18716,23451,19839,322,2094,4418,-2337
"1229","Ealing 007D","E01001348","E02000244","Ealing 007","E09000009","Ealing","E12000007","London",1599,1599,0,38.9,626,2.6,"00AJ","Ealing",NA,12503,12580,18358,28347,14890,14157,21744,21132,2387,1577,3386,-7215
"1225","Ealing 006E","E01001349","E02000243","Ealing 006","E09000009","Ealing","E12000007","London",1404,1404,0,20.6,507,2.8,"00AJ","Ealing",NA,4554,3962,4883,15096,6800,7746,8683,16211,2246,3784,3800,1115
"1330","Ealing 027C","E01001350","E02000264","Ealing 027","E09000009","Ealing","E12000007","London",1486,1483,3,49.8,621,2.4,"00AJ","Ealing",NA,15342,16470,16589,26643,16184,15526,16375,25611,842,-944,-214,-1032
"1321","Ealing 025E","E01001351","E02000262","Ealing 025","E09000009","Ealing","E12000007","London",1994,1864,130,102.8,811,2.3,"00AJ","Ealing",NA,6444,6846,8359,25599,6557,7572,11255,25303,113,726,2896,-296
"1331","Ealing 027D","E01001352","E02000264","Ealing 027","E09000009","Ealing","E12000007","London",1510,1495,15,94.3,571,2.6,"00AJ","Ealing",NA,15860,22394,23274,32055,17210,14794,20909,30283,1350,-7600,-2365,-1772
"1361","Ealing 033A","E01001353","E02000270","Ealing 033","E09000009","Ealing","E12000007","London",1667,1664,3,85.2,718,2.3,"00AJ","Ealing",NA,10341,10788,13067,26797,10715,10164,14480,18119,374,-624,1413,-8678
"1332","Ealing 027E","E01001354","E02000264","Ealing 027","E09000009","Ealing","E12000007","London",1840,1744,96,68,677,2.6,"00AJ","Ealing",NA,13456,18784,19828,30867,14336,13517,18407,28878,880,-5267,-1421,-1989
"1362","Ealing 033B","E01001355","E02000270","Ealing 033","E09000009","Ealing","E12000007","London",1664,1664,0,113.7,760,2.2,"00AJ","Ealing",NA,9183,11172,12809,24057,11391,10624,12456,23425,2208,-548,-353,-632
"1363","Ealing 033C","E01001356","E02000270","Ealing 033","E09000009","Ealing","E12000007","London",1969,1969,0,235,841,2.3,"00AJ","Ealing",NA,2471,876,2271,15681,1641,622,2003,9738,-830,-254,-268,-5943
"1364","Ealing 033D","E01001357","E02000270","Ealing 033","E09000009","Ealing","E12000007","London",1141,1141,0,102.5,426,2.7,"00AJ","Ealing",NA,4187,1978,2759,17818,3514,2208,4060,19710,-673,230,1301,1892
"1365","Ealing 033E","E01001358","E02000270","Ealing 033","E09000009","Ealing","E12000007","London",1602,1602,0,61.8,586,2.7,"00AJ","Ealing",NA,2174,692,2334,13527,1789,397,2394,9398,-385,-295,60,-4129
"1322","Ealing 026A","E01001359","E02000263","Ealing 026","E09000009","Ealing","E12000007","London",2201,2201,0,165.9,562,3.9,"00AJ","Ealing",NA,5576,5122,9977,13951,9327,11025,14265,8951,3751,5903,4288,-5000
"1323","Ealing 026B","E01001360","E02000263","Ealing 026","E09000009","Ealing","E12000007","London",1923,1923,0,136.9,505,3.8,"00AJ","Ealing",NA,8855,5643,10323,15571,7519,10881,13570,13625,-1336,5238,3247,-1946
"1310","Ealing 023E","E01001361","E02000260","Ealing 023","E09000009","Ealing","E12000007","London",1802,1671,131,46.6,460,3.6,"00AJ","Ealing",NA,2599,2582,4322,14125,4069,6157,7308,8197,1470,3575,2986,-5928
"1324","Ealing 026C","E01001362","E02000263","Ealing 026","E09000009","Ealing","E12000007","London",1935,1896,39,79.3,511,3.7,"00AJ","Ealing",NA,7494,7678,7642,15699,6715,8546,8575,9261,-779,868,933,-6438
"1325","Ealing 026D","E01001363","E02000263","Ealing 026","E09000009","Ealing","E12000007","London",1685,1685,0,124.5,471,3.6,"00AJ","Ealing",NA,9780,8688,9768,18402,8804,10201,12136,7004,-976,1513,2368,-11398
"1326","Ealing 026E","E01001364","E02000263","Ealing 026","E09000009","Ealing","E12000007","London",1676,1676,0,141.2,516,3.2,"00AJ","Ealing",NA,3751,1784,3613,9746,2970,2303,3801,7851,-781,519,188,-1895
"1327","Ealing 026F","E01001365","E02000263","Ealing 026","E09000009","Ealing","E12000007","London",2217,2194,23,47.8,590,3.7,"00AJ","Ealing",NA,5606,7327,8307,12387,8385,9619,11187,12228,2779,2292,2880,-159
"1374","Ealing 037A","E01001366","E02000274","Ealing 037","E09000009","Ealing","E12000007","London",1923,1914,9,112.9,543,3.5,"00AJ","Ealing",NA,7016,5054,7885,13098,7806,7513,10917,11054,790,2459,3032,-2044
"1375","Ealing 037B","E01001367","E02000274","Ealing 037","E09000009","Ealing","E12000007","London",1764,1764,0,86.8,527,3.3,"00AJ","Ealing",NA,3813,3871,6025,10541,5059,7547,10043,10538,1246,3676,4018,-3
"1376","Ealing 037C","E01001368","E02000274","Ealing 037","E09000009","Ealing","E12000007","London",1723,1723,0,133.9,456,3.8,"00AJ","Ealing",NA,9114,5648,8977,16225,8282,9026,10228,12965,-832,3378,1251,-3260
"1384","Ealing 038D","E01001369","E02000275","Ealing 038","E09000009","Ealing","E12000007","London",1846,1846,0,123,525,3.5,"00AJ","Ealing",NA,7461,6728,9028,16387,7176,9174,10316,9481,-285,2446,1288,-6906
"1377","Ealing 037D","E01001370","E02000274","Ealing 037","E09000009","Ealing","E12000007","London",1980,1980,0,44.2,532,3.7,"00AJ","Ealing",NA,9936,8850,11228,16018,8449,8955,11683,8203,-1487,105,455,-7815
"1378","Ealing 037E","E01001371","E02000274","Ealing 037","E09000009","Ealing","E12000007","London",2081,2081,0,102.8,594,3.5,"00AJ","Ealing",NA,6471,4368,8600,9805,7430,5817,10996,10657,959,1449,2396,852
"1379","Ealing 037F","E01001372","E02000274","Ealing 037","E09000009","Ealing","E12000007","London",1763,1763,0,137.1,493,3.6,"00AJ","Ealing",NA,5778,5516,9229,12912,5923,7176,7051,9344,145,1660,-2178,-3568
"1380","Ealing 037G","E01001373","E02000274","Ealing 037","E09000009","Ealing","E12000007","London",1499,1499,0,97.7,412,3.6,"00AJ","Ealing",NA,7107,5097,8358,12968,6860,7025,9802,10601,-247,1928,1444,-2367
"1389","Ealing 040A","E01001374","E02006791","Ealing 040","E09000009","Ealing","E12000007","London",1798,1798,0,138.5,805,2.2,"00AJ","Ealing",NA,19482,16166,22524,26295,19274,16175,22565,24720,-208,9,41,-1575
"1366","Ealing 034A","E01001375","E02000271","Ealing 034","E09000009","Ealing","E12000007","London",1665,1665,0,120.2,706,2.4,"00AJ","Ealing",NA,27256,31470,31413,31748,29114,31573,32141,31812,1858,103,728,64
"1390","Ealing 040B","E01001376","E02006791","Ealing 040","E09000009","Ealing","E12000007","London",1579,1579,0,101.5,743,2.1,"00AJ","Ealing",NA,10942,8554,13043,21652,10582,6680,8664,26529,-360,-1874,-4379,4877
"1367","Ealing 034B","E01001377","E02000271","Ealing 034","E09000009","Ealing","E12000007","London",1770,1764,6,92.9,718,2.5,"00AJ","Ealing",NA,21519,23582,28949,31221,25141,25877,31214,32541,3622,2295,2265,1320
"1368","Ealing 034C","E01001379","E02000271","Ealing 034","E09000009","Ealing","E12000007","London",1679,1679,0,126.1,709,2.4,"00AJ","Ealing",NA,25357,26167,30186,31463,28740,30260,31940,32699,3383,4093,1754,1236
"1391","Ealing 040C","E01001380","E02006791","Ealing 040","E09000009","Ealing","E12000007","London",1759,1759,0,100.2,762,2.3,"00AJ","Ealing",NA,18172,20338,26744,30683,20559,20119,27742,29604,2387,-219,998,-1079
"1369","Ealing 034D","E01001381","E02000271","Ealing 034","E09000009","Ealing","E12000007","London",1649,1649,0,57.8,738,2.2,"00AJ","Ealing",NA,11843,12630,13971,28840,14599,12755,16489,27482,2756,125,2518,-1358
"1357","Ealing 032B","E01001382","E02000269","Ealing 032","E09000009","Ealing","E12000007","London",1566,1566,0,76.8,564,2.8,"00AJ","Ealing",NA,23596,27753,29316,32236,27964,28919,31989,32604,4368,1166,2673,368
"1336","Ealing 028D","E01001383","E02000265","Ealing 028","E09000009","Ealing","E12000007","London",1791,1768,23,154.8,662,2.7,"00AJ","Ealing",NA,17795,19052,19011,30628,22985,21065,21942,31569,5190,2013,2931,941
"1358","Ealing 032C","E01001384","E02000269","Ealing 032","E09000009","Ealing","E12000007","London",1645,1645,0,151.1,677,2.4,"00AJ","Ealing",NA,23465,22019,26953,27499,25577,24880,29229,29678,2112,2861,2276,2179
"1359","Ealing 032D","E01001385","E02000269","Ealing 032","E09000009","Ealing","E12000007","London",1682,1682,0,105,667,2.5,"00AJ","Ealing",NA,27103,28071,29918,31679,26549,25047,29170,32669,-554,-3024,-748,990
"1355","Ealing 031F","E01001386","E02000268","Ealing 031","E09000009","Ealing","E12000007","London",1793,1793,0,58.1,735,2.4,"00AJ","Ealing",NA,21301,25702,29882,29375,26318,24961,26082,32650,5017,-741,-3800,3275
"1360","Ealing 032E","E01001387","E02000269","Ealing 032","E09000009","Ealing","E12000007","London",1546,1471,75,61.5,713,2.1,"00AJ","Ealing",NA,15624,15765,16848,32225,17739,18424,20202,31377,2115,2659,3354,-848
"1337","Ealing 028E","E01001388","E02000265","Ealing 028","E09000009","Ealing","E12000007","London",1640,1640,0,92.1,743,2.2,"00AJ","Ealing",NA,7720,5980,8230,27937,6229,6361,7748,24815,-1491,381,-482,-3122
"1338","Ealing 028F","E01001389","E02000265","Ealing 028","E09000009","Ealing","E12000007","London",1667,1649,18,119.5,726,2.3,"00AJ","Ealing",NA,11698,12621,19401,26251,13598,13075,18790,27668,1900,454,-611,1417
"1565","Enfield 036A","E01001390","E02000312","Enfield 036","E09000010","Enfield","E12000007","London",1971,1971,0,128.3,762,2.6,"00AK","Enfield",NA,17084,12844,18102,30770,24228,18608,25491,29997,7144,5764,7389,-773
"1566","Enfield 036B","E01001391","E02000312","Enfield 036","E09000010","Enfield","E12000007","London",1564,1529,35,118.1,687,2.2,"00AK","Enfield",NA,5824,4893,5493,18038,9821,10425,10354,18651,3997,5532,4861,613
"1548","Enfield 032A","E01001392","E02000308","Enfield 032","E09000010","Enfield","E12000007","London",1824,1824,0,113.9,665,2.7,"00AK","Enfield",NA,19082,15758,17101,28655,23576,21448,23727,28314,4494,5690,6626,-341
"1567","Enfield 036C","E01001393","E02000312","Enfield 036","E09000010","Enfield","E12000007","London",2112,2112,0,117.7,839,2.5,"00AK","Enfield",NA,10633,7667,12093,26562,16933,14461,18542,22792,6300,6794,6449,-3770
"1559","Enfield 035A","E01001394","E02000311","Enfield 035","E09000010","Enfield","E12000007","London",1653,1653,0,95.8,640,2.6,"00AK","Enfield",NA,7523,4816,6581,18264,8169,5275,12707,15032,646,459,6126,-3232
"1560","Enfield 035B","E01001395","E02000311","Enfield 035","E09000010","Enfield","E12000007","London",1590,1590,0,66.3,620,2.6,"00AK","Enfield",NA,5290,1988,5826,13846,6122,3474,5203,10797,832,1486,-623,-3049
"1568","Enfield 036D","E01001396","E02000312","Enfield 036","E09000010","Enfield","E12000007","London",1413,1413,0,95.5,511,2.8,"00AK","Enfield",NA,9120,6732,10247,18734,12062,8707,14801,15048,2942,1975,4554,-3686
"1561","Enfield 035C","E01001397","E02000311","Enfield 035","E09000010","Enfield","E12000007","London",1924,1924,0,64.4,783,2.5,"00AK","Enfield",NA,9549,7293,8637,23168,9632,5881,11619,18788,83,-1412,2982,-4380
"1490","Enfield 021A","E01001398","E02000297","Enfield 021","E09000010","Enfield","E12000007","London",1392,1368,24,79.7,491,2.8,"00AK","Enfield",NA,26204,21726,27142,28644,25915,21652,26030,26064,-289,-74,-1112,-2580
"1491","Enfield 021B","E01001399","E02000297","Enfield 021","E09000010","Enfield","E12000007","London",1437,1437,0,59.2,499,2.9,"00AK","Enfield",NA,22945,20101,22589,24120,22511,20203,22673,24101,-434,102,84,-19
"1492","Enfield 021C","E01001400","E02000297","Enfield 021","E09000010","Enfield","E12000007","London",1543,1528,15,63.3,587,2.6,"00AK","Enfield",NA,26925,27603,26489,27318,23265,20778,21192,28834,-3660,-6825,-5297,1516
"1465","Enfield 016A","E01001401","E02000292","Enfield 016","E09000010","Enfield","E12000007","London",1323,1323,0,89.7,501,2.6,"00AK","Enfield",NA,20191,18143,22196,24231,19695,17703,19654,21881,-496,-440,-2542,-2350
"1493","Enfield 021D","E01001402","E02000297","Enfield 021","E09000010","Enfield","E12000007","London",1833,1809,24,52.2,691,2.6,"00AK","Enfield",NA,22356,18267,20802,29335,24264,20791,22134,27078,1908,2524,1332,-2257
"1494","Enfield 021E","E01001403","E02000297","Enfield 021","E09000010","Enfield","E12000007","London",1602,1602,0,43.3,633,2.5,"00AK","Enfield",NA,15478,12168,16613,21279,15736,13560,13905,19670,258,1392,-2708,-1609
"1517","Enfield 026A","E01001404","E02000302","Enfield 026","E09000010","Enfield","E12000007","London",1473,1473,0,28.5,525,2.8,"00AK","Enfield",NA,10867,9253,13087,15503,13056,10818,14836,19623,2189,1565,1749,4120
"1460","Enfield 015A","E01001405","E02000291","Enfield 015","E09000010","Enfield","E12000007","London",1691,1641,50,61.4,862,1.9,"00AK","Enfield",NA,21060,20675,22242,31489,20125,17837,24103,25150,-935,-2838,1861,-6339
"1461","Enfield 015B","E01001406","E02000291","Enfield 015","E09000010","Enfield","E12000007","London",1629,1598,31,79.8,675,2.4,"00AK","Enfield",NA,10601,9093,12871,19382,11753,9351,12773,19287,1152,258,-98,-95
"1413","Enfield 005A","E01001407","E02000281","Enfield 005","E09000010","Enfield","E12000007","London",1637,1627,10,15.9,613,2.7,"00AK","Enfield",NA,13704,12131,16681,17093,15221,14424,15287,17165,1517,2293,-1394,72
"1408","Enfield 004A","E01001408","E02000280","Enfield 004","E09000010","Enfield","E12000007","London",1646,1646,0,113,731,2.3,"00AK","Enfield",NA,19392,15235,17438,24096,17206,12719,16085,23226,-2186,-2516,-1353,-870
"1414","Enfield 005B","E01001409","E02000281","Enfield 005","E09000010","Enfield","E12000007","London",1889,1881,8,100.1,806,2.3,"00AK","Enfield",NA,8873,7731,8016,15518,6700,5821,7486,13581,-2173,-1910,-530,-1937
"1415","Enfield 005C","E01001410","E02000281","Enfield 005","E09000010","Enfield","E12000007","London",1721,1667,54,108.1,755,2.2,"00AK","Enfield",NA,4469,2888,4856,8383,2185,1786,2177,6127,-2284,-1102,-2679,-2256
"1409","Enfield 004B","E01001411","E02000280","Enfield 004","E09000010","Enfield","E12000007","London",1840,1840,0,99,759,2.4,"00AK","Enfield",NA,19257,15673,18836,24320,21255,15229,18346,25512,1998,-444,-490,1192
"1410","Enfield 004C","E01001412","E02000280","Enfield 004","E09000010","Enfield","E12000007","London",1834,1834,0,1.3,677,2.7,"00AK","Enfield",NA,9152,10815,13698,12917,8522,10651,14080,12213,-630,-164,382,-704
"1411","Enfield 004D","E01001413","E02000280","Enfield 004","E09000010","Enfield","E12000007","London",1632,1581,51,32,612,2.6,"00AK","Enfield",NA,26985,26729,25076,24885,26192,25997,29721,25385,-793,-732,4645,500
"1412","Enfield 004E","E01001414","E02000280","Enfield 004","E09000010","Enfield","E12000007","London",1563,1563,0,39.6,687,2.3,"00AK","Enfield",NA,4986,2290,4625,8732,4640,3119,4442,5848,-346,829,-183,-2884
"1442","Enfield 011A","E01001415","E02000287","Enfield 011","E09000010","Enfield","E12000007","London",1541,1541,0,14.2,677,2.3,"00AK","Enfield",NA,20871,14704,24071,29320,19437,10746,21156,24333,-1434,-3958,-2915,-4987
"1452","Enfield 013A","E01001416","E02000289","Enfield 013","E09000010","Enfield","E12000007","London",1733,1733,0,53.4,598,2.9,"00AK","Enfield",NA,28472,25430,25394,29303,29863,25903,27998,28676,1391,473,2604,-627
"1443","Enfield 011B","E01001417","E02000287","Enfield 011","E09000010","Enfield","E12000007","London",1974,1673,301,3.5,601,2.8,"00AK","Enfield",NA,27777,31276,31709,30694,29113,32321,32600,29605,1336,1045,891,-1089
"1444","Enfield 011C","E01001418","E02000287","Enfield 011","E09000010","Enfield","E12000007","London",1650,1639,11,26.6,703,2.3,"00AK","Enfield",NA,13958,13230,10886,25731,13073,11654,9425,21843,-885,-1576,-1461,-3888
"1485","Enfield 020A","E01001419","E02000296","Enfield 020","E09000010","Enfield","E12000007","London",1946,1938,8,29.2,794,2.4,"00AK","Enfield",NA,17244,15446,16508,29966,18725,15047,16959,27643,1481,-399,451,-2323
"1486","Enfield 020B","E01001420","E02000296","Enfield 020","E09000010","Enfield","E12000007","London",1570,1553,17,44.1,569,2.7,"00AK","Enfield",NA,9761,7035,8414,18359,10422,8557,9214,15392,661,1522,800,-2967
"1487","Enfield 020C","E01001421","E02000296","Enfield 020","E09000010","Enfield","E12000007","London",1716,1672,44,88.6,714,2.3,"00AK","Enfield",NA,9655,4948,7949,21453,10685,7203,12772,15758,1030,2255,4823,-5695
"1445","Enfield 011D","E01001422","E02000287","Enfield 011","E09000010","Enfield","E12000007","London",1658,1641,17,11.3,559,2.9,"00AK","Enfield",NA,28374,31127,31805,31507,28757,31603,32551,31036,383,476,746,-471
"1522","Enfield 027A","E01001423","E02000303","Enfield 027","E09000010","Enfield","E12000007","London",1805,1800,5,94.2,643,2.8,"00AK","Enfield",NA,10731,6810,10911,11572,5284,4944,6883,7856,-5447,-1866,-4028,-3716
"1537","Enfield 030A","E01001424","E02000306","Enfield 030","E09000010","Enfield","E12000007","London",1210,1210,0,168.5,496,2.4,"00AK","Enfield",NA,736,40,3639,6459,2557,1676,4468,7892,1821,1636,829,1433
"1523","Enfield 027B","E01001425","E02000303","Enfield 027","E09000010","Enfield","E12000007","London",1862,1859,3,46.3,737,2.5,"00AK","Enfield",NA,2201,922,3891,11628,1335,1111,3717,4670,-866,189,-174,-6958
"1538","Enfield 030B","E01001426","E02000306","Enfield 030","E09000010","Enfield","E12000007","London",1821,1821,0,59.1,628,2.9,"00AK","Enfield",NA,3671,2587,3515,6947,3253,3910,5629,5892,-418,1323,2114,-1055
"1539","Enfield 030C","E01001427","E02000306","Enfield 030","E09000010","Enfield","E12000007","London",1840,1840,0,13.7,683,2.7,"00AK","Enfield",NA,2029,261,2788,7819,2773,2004,4904,4781,744,1743,2116,-3038
"1524","Enfield 027C","E01001428","E02000303","Enfield 027","E09000010","Enfield","E12000007","London",1677,1677,0,106.5,611,2.7,"00AK","Enfield",NA,4105,1543,3845,7085,4124,2407,4326,5162,19,864,481,-1923
"1540","Enfield 030D","E01001429","E02000306","Enfield 030","E09000010","Enfield","E12000007","London",2394,2394,0,98.4,1134,2.1,"00AK","Enfield",NA,891,77,1195,9089,1931,971,2975,6063,1040,894,1780,-3026
"1541","Enfield 030E","E01001430","E02000306","Enfield 030","E09000010","Enfield","E12000007","London",1884,1884,0,161.3,653,2.9,"00AK","Enfield",NA,1475,382,2491,5028,2455,1349,4176,4713,980,967,1685,-315
"1553","Enfield 033A","E01001431","E02000309","Enfield 033","E09000010","Enfield","E12000007","London",1549,1549,0,114.1,614,2.5,"00AK","Enfield",NA,3557,1641,4670,7120,2504,2370,3897,5542,-1053,729,-773,-1578
"1554","Enfield 033B","E01001432","E02000309","Enfield 033","E09000010","Enfield","E12000007","London",1907,1904,3,124.4,700,2.7,"00AK","Enfield",NA,3654,2087,3544,12190,3376,3553,6758,7149,-278,1466,3214,-5041
"1423","Enfield 007A","E01001433","E02000283","Enfield 007","E09000010","Enfield","E12000007","London",1827,1822,5,54.6,584,3.1,"00AK","Enfield",NA,5402,3078,5868,2773,4793,3189,6350,3709,-609,111,482,936
"1424","Enfield 007B","E01001434","E02000283","Enfield 007","E09000010","Enfield","E12000007","London",1572,1567,5,89.1,551,2.8,"00AK","Enfield",NA,11771,9405,15001,11130,8599,5989,12644,7031,-3172,-3416,-2357,-4099
"1425","Enfield 007C","E01001435","E02000283","Enfield 007","E09000010","Enfield","E12000007","London",1480,1480,0,94,489,3,"00AK","Enfield",NA,12373,8909,17354,7203,10750,6377,14238,8332,-1623,-2532,-3116,1129
"1426","Enfield 007D","E01001436","E02000283","Enfield 007","E09000010","Enfield","E12000007","London",1886,1883,3,96.5,653,2.9,"00AK","Enfield",NA,12897,8771,13228,14046,8796,5323,9149,10148,-4101,-3448,-4079,-3898
"1456","Enfield 014A","E01001437","E02000290","Enfield 014","E09000010","Enfield","E12000007","London",2373,2373,0,9,990,2.4,"00AK","Enfield",NA,6403,3321,4675,10366,4881,3282,4992,7237,-1522,-39,317,-3129
"1427","Enfield 007E","E01001438","E02000283","Enfield 007","E09000010","Enfield","E12000007","London",1659,1656,3,60,566,2.9,"00AK","Enfield",NA,8766,5645,8191,10119,5610,3665,7587,7098,-3156,-1980,-604,-3021
"1418","Enfield 006A","E01001439","E02000282","Enfield 006","E09000010","Enfield","E12000007","London",2075,2074,1,98.9,790,2.6,"00AK","Enfield",NA,4372,1974,5121,7030,4758,2548,6266,7219,386,574,1145,189
"1446","Enfield 012A","E01001440","E02000288","Enfield 012","E09000010","Enfield","E12000007","London",1641,1641,0,52.2,597,2.7,"00AK","Enfield",NA,7735,5775,9513,9798,7997,6784,9465,9704,262,1009,-48,-94
"1419","Enfield 006B","E01001441","E02000282","Enfield 006","E09000010","Enfield","E12000007","London",1514,1512,2,45.5,637,2.4,"00AK","Enfield",NA,6134,3177,5983,7937,4264,3439,5473,7434,-1870,262,-510,-503
"1397","Enfield 002A","E01001442","E02000278","Enfield 002","E09000010","Enfield","E12000007","London",1684,1661,23,146.3,617,2.7,"00AK","Enfield",NA,3385,1414,5660,4133,3523,1547,4757,5238,138,133,-903,1105
"1393","Enfield 001A","E01001444","E02000277","Enfield 001","E09000010","Enfield","E12000007","London",1676,1676,0,48.3,638,2.6,"00AK","Enfield",NA,15370,11091,19121,12327,12507,9179,17016,13040,-2863,-1912,-2105,713
"1402","Enfield 003B","E01001445","E02000279","Enfield 003","E09000010","Enfield","E12000007","London",2284,2281,3,16.1,980,2.3,"00AK","Enfield",NA,10127,7446,12182,13316,7386,4125,9901,10103,-2741,-3321,-2281,-3213
"1394","Enfield 001B","E01001446","E02000277","Enfield 001","E09000010","Enfield","E12000007","London",1817,1817,0,100.6,714,2.5,"00AK","Enfield",NA,11174,8881,10948,11788,7913,7021,9559,9128,-3261,-1860,-1389,-2660
"1403","Enfield 003C","E01001447","E02000279","Enfield 003","E09000010","Enfield","E12000007","London",1936,1936,0,104,783,2.5,"00AK","Enfield",NA,5168,2311,4178,7027,3436,1773,3279,9283,-1732,-538,-899,2256
"1404","Enfield 003D","E01001448","E02000279","Enfield 003","E09000010","Enfield","E12000007","London",1831,1831,0,116.3,655,2.8,"00AK","Enfield",NA,8533,4987,8015,11387,5513,2189,6948,10689,-3020,-2798,-1067,-698
"1405","Enfield 003E","E01001449","E02000279","Enfield 003","E09000010","Enfield","E12000007","London",1635,1635,0,69.4,575,2.8,"00AK","Enfield",NA,7389,5264,8899,6368,8730,6206,11520,6782,1341,942,2621,414
"1462","Enfield 015C","E01001450","E02000291","Enfield 015","E09000010","Enfield","E12000007","London",1878,1865,13,52.5,924,2,"00AK","Enfield",NA,13162,13380,16647,28351,12538,12486,16028,23088,-624,-894,-619,-5263
"1471","Enfield 017A","E01001451","E02000293","Enfield 017","E09000010","Enfield","E12000007","London",1641,1621,20,26.5,661,2.5,"00AK","Enfield",NA,17477,26229,20870,29958,17497,24195,22794,27620,20,-2034,1924,-2338
"1472","Enfield 017B","E01001452","E02000293","Enfield 017","E09000010","Enfield","E12000007","London",1356,1356,0,21.2,488,2.8,"00AK","Enfield",NA,24533,25973,30676,31210,24472,24278,27892,28417,-61,-1695,-2784,-2793
"1473","Enfield 017C","E01001453","E02000293","Enfield 017","E09000010","Enfield","E12000007","London",1677,1677,0,32.6,661,2.5,"00AK","Enfield",NA,29719,29809,29093,30828,27715,26479,27895,30467,-2004,-3330,-1198,-361
"1474","Enfield 017D","E01001454","E02000293","Enfield 017","E09000010","Enfield","E12000007","London",1633,1620,13,42.2,660,2.5,"00AK","Enfield",NA,25147,24132,27985,30013,28029,24393,27421,31476,2882,261,-564,1463
"1495","Enfield 021F","E01001455","E02000297","Enfield 021","E09000010","Enfield","E12000007","London",1491,1491,0,62.6,581,2.6,"00AK","Enfield",NA,23329,21225,22156,27345,21259,19346,22163,21128,-2070,-1879,7,-6217
"1496","Enfield 022A","E01001456","E02000298","Enfield 022","E09000010","Enfield","E12000007","London",1400,1400,0,52.6,481,2.9,"00AK","Enfield",NA,27367,28629,29058,31078,30341,29767,30152,31881,2974,1138,1094,803
"1437","Enfield 010A","E01001457","E02000286","Enfield 010","E09000010","Enfield","E12000007","London",1633,1576,57,61.6,798,2,"00AK","Enfield",NA,19163,21108,17977,29511,21125,17871,21476,28950,1962,-3237,3499,-561
"1571","Enfield 037A","E01001458","E02006793","Enfield 037","E09000010","Enfield","E12000007","London",1745,1724,21,107.1,664,2.6,"00AK","Enfield",NA,1761,892,2175,7586,3177,1795,3578,3640,1416,903,1403,-3946
"1506","Enfield 024A","E01001459","E02000300","Enfield 024","E09000010","Enfield","E12000007","London",1675,1675,0,77.3,556,3,"00AK","Enfield",NA,9926,7221,9667,13429,10373,6533,11259,10550,447,-688,1592,-2879
"1507","Enfield 024B","E01001460","E02000300","Enfield 024","E09000010","Enfield","E12000007","London",1711,1689,22,139.6,660,2.6,"00AK","Enfield",NA,3877,2772,3461,9487,3756,4452,5842,5867,-121,1680,2381,-3620
"1525","Enfield 027D","E01001461","E02000303","Enfield 027","E09000010","Enfield","E12000007","London",1716,1706,10,59.3,707,2.4,"00AK","Enfield",NA,4082,2174,3331,11782,2219,1086,2573,4648,-1863,-1088,-758,-7134
"1508","Enfield 024C","E01001462","E02000300","Enfield 024","E09000010","Enfield","E12000007","London",1339,1339,0,122.7,531,2.5,"00AK","Enfield",NA,7983,4592,9417,18811,5034,4221,6894,8847,-2949,-371,-2523,-9964
"1542","Enfield 031A","E01001463","E02000307","Enfield 031","E09000010","Enfield","E12000007","London",1573,1573,0,60.1,513,3.1,"00AK","Enfield",NA,10690,6428,11400,14799,11170,7967,12017,10871,480,1539,617,-3928
"1526","Enfield 027E","E01001464","E02000303","Enfield 027","E09000010","Enfield","E12000007","London",1330,1330,0,65.9,422,3.2,"00AK","Enfield",NA,6962,3249,6305,8195,4933,3982,5044,4106,-2029,733,-1261,-4089
"1543","Enfield 031B","E01001465","E02000307","Enfield 031","E09000010","Enfield","E12000007","London",1505,1505,0,65.9,506,3,"00AK","Enfield",NA,9916,6869,9860,16353,9583,6393,9455,12553,-333,-476,-405,-3800
"1544","Enfield 031C","E01001466","E02000307","Enfield 031","E09000010","Enfield","E12000007","London",1795,1795,0,181.7,620,2.9,"00AK","Enfield",NA,9087,3385,11835,12272,9181,5529,12057,7527,94,2144,222,-4745
"1545","Enfield 031D","E01001467","E02000307","Enfield 031","E09000010","Enfield","E12000007","London",1874,1874,0,177.8,634,3,"00AK","Enfield",NA,8884,3684,10136,14409,9099,5516,12302,11019,215,1832,2166,-3390
"1438","Enfield 010B","E01001468","E02000286","Enfield 010","E09000010","Enfield","E12000007","London",1339,1205,134,17.1,524,2.3,"00AK","Enfield",NA,9625,16683,3804,27263,8533,13395,5985,22212,-1092,-3288,2181,-5051
"1428","Enfield 008A","E01001469","E02000284","Enfield 008","E09000010","Enfield","E12000007","London",1645,1630,15,73.1,633,2.6,"00AK","Enfield",NA,13196,11016,12917,16831,13118,11092,12368,13571,-78,76,-549,-3260
"1453","Enfield 013B","E01001470","E02000289","Enfield 013","E09000010","Enfield","E12000007","London",1598,1598,0,8.4,641,2.5,"00AK","Enfield",NA,23369,20745,23517,26792,23544,19933,20832,27145,175,-812,-2685,353
"1439","Enfield 010C","E01001471","E02000286","Enfield 010","E09000010","Enfield","E12000007","London",1737,1710,27,47.6,930,1.8,"00AK","Enfield",NA,14493,18588,15372,29699,16238,15684,19201,27085,1745,-2904,3829,-2614
"1440","Enfield 010D","E01001472","E02000286","Enfield 010","E09000010","Enfield","E12000007","London",1682,1682,0,67.1,771,2.2,"00AK","Enfield",NA,19425,15118,21032,28104,20102,15499,20792,26691,677,381,-240,-1413
"1454","Enfield 013C","E01001473","E02000289","Enfield 013","E09000010","Enfield","E12000007","London",1534,1534,0,18.2,547,2.8,"00AK","Enfield",NA,15302,10738,13604,22509,14711,10519,11825,18173,-591,-219,-1779,-4336
"1441","Enfield 010E","E01001474","E02000286","Enfield 010","E09000010","Enfield","E12000007","London",1767,1767,0,45.8,840,2.1,"00AK","Enfield",NA,20917,25755,20449,30733,20682,21818,19855,30452,-235,-3937,-594,-281
"1455","Enfield 013D","E01001475","E02000289","Enfield 013","E09000010","Enfield","E12000007","London",1704,1704,0,50.5,635,2.7,"00AK","Enfield",NA,26891,24231,22776,30114,29926,27265,30538,27393,3035,3034,7762,-2721
"1475","Enfield 018A","E01001476","E02000294","Enfield 018","E09000010","Enfield","E12000007","London",1666,1666,0,82.3,593,2.8,"00AK","Enfield",NA,8343,7237,10216,16012,10409,6799,10450,10547,2066,-438,234,-5465
"1476","Enfield 018B","E01001477","E02000294","Enfield 018","E09000010","Enfield","E12000007","London",1850,1850,0,27.4,607,3,"00AK","Enfield",NA,6671,3770,6487,10334,5701,3826,5545,6752,-970,56,-942,-3582
"1466","Enfield 016B","E01001478","E02000292","Enfield 016","E09000010","Enfield","E12000007","London",1538,1531,7,48.4,544,2.8,"00AK","Enfield",NA,9719,11264,13214,14690,11362,10986,12225,13056,1643,-278,-989,-1634
"1501","Enfield 023A","E01001479","E02000299","Enfield 023","E09000010","Enfield","E12000007","London",1730,1683,47,70.7,639,2.6,"00AK","Enfield",NA,7187,3154,8467,10934,6629,4149,8343,9864,-558,995,-124,-1070
"1509","Enfield 024D","E01001480","E02000300","Enfield 024","E09000010","Enfield","E12000007","London",1549,1516,33,78.5,588,2.6,"00AK","Enfield",NA,9000,6702,11097,17984,10226,9430,10390,13158,1226,2728,-707,-4826
"1477","Enfield 018C","E01001481","E02000294","Enfield 018","E09000010","Enfield","E12000007","London",1647,1620,27,95.9,556,2.9,"00AK","Enfield",NA,8841,5670,10566,12658,9630,6142,11010,11005,789,472,444,-1653
"1502","Enfield 023B","E01001482","E02000299","Enfield 023","E09000010","Enfield","E12000007","London",1854,1854,0,105,690,2.7,"00AK","Enfield",NA,7162,3970,6884,11497,5535,4016,6029,7225,-1627,46,-855,-4272
"1511","Enfield 025A","E01001483","E02000301","Enfield 025","E09000010","Enfield","E12000007","London",1150,1150,0,20.6,609,1.9,"00AK","Enfield",NA,3574,2125,4004,11193,1321,1395,2081,6904,-2253,-730,-1923,-4289
"1467","Enfield 016C","E01001484","E02000292","Enfield 016","E09000010","Enfield","E12000007","London",1371,1362,9,41.6,516,2.6,"00AK","Enfield",NA,13251,8777,16684,15073,11217,9819,13226,12754,-2034,1042,-3458,-2319
"1512","Enfield 025B","E01001485","E02000301","Enfield 025","E09000010","Enfield","E12000007","London",1815,1815,0,143.8,682,2.7,"00AK","Enfield",NA,4226,2033,5894,9618,4939,2790,7372,7327,713,757,1478,-2291
"1513","Enfield 025C","E01001486","E02000301","Enfield 025","E09000010","Enfield","E12000007","London",2106,2106,0,116.6,818,2.6,"00AK","Enfield",NA,4062,1418,3871,8856,4241,2100,5154,6857,179,682,1283,-1999
"1503","Enfield 023C","E01001487","E02000299","Enfield 023","E09000010","Enfield","E12000007","London",1949,1949,0,150.5,723,2.7,"00AK","Enfield",NA,6472,3098,8119,13127,5213,2453,6757,8420,-1259,-645,-1362,-4707
"1510","Enfield 024E","E01001488","E02000300","Enfield 024","E09000010","Enfield","E12000007","London",1883,1883,0,143.2,663,2.8,"00AK","Enfield",NA,9844,5342,11245,14500,7171,3584,7848,11042,-2673,-1758,-3397,-3458
"1504","Enfield 023D","E01001489","E02000299","Enfield 023","E09000010","Enfield","E12000007","London",1803,1803,0,101.2,664,2.7,"00AK","Enfield",NA,7067,4512,6969,11053,8176,5228,10028,6951,1109,716,3059,-4102
"1505","Enfield 023E","E01001491","E02000299","Enfield 023","E09000010","Enfield","E12000007","London",1976,1973,3,133.3,722,2.7,"00AK","Enfield",NA,7094,3312,7802,12814,5747,2787,6041,8732,-1347,-525,-1761,-4082
"1514","Enfield 025E","E01001492","E02000301","Enfield 025","E09000010","Enfield","E12000007","London",1930,1930,0,125.7,680,2.8,"00AK","Enfield",NA,8079,3344,8293,14706,7086,4390,7392,7349,-993,1046,-901,-7357
"1518","Enfield 026B","E01001493","E02000302","Enfield 026","E09000010","Enfield","E12000007","London",1773,1767,6,76.1,735,2.4,"00AK","Enfield",NA,7703,6534,5232,19997,8821,6339,6800,13364,1118,-195,1568,-6633
"1519","Enfield 026C","E01001494","E02000302","Enfield 026","E09000010","Enfield","E12000007","London",1520,1515,5,93.7,510,3,"00AK","Enfield",NA,13101,10132,14275,18056,17818,13051,18409,20129,4717,2919,4134,2073
"1532","Enfield 029A","E01001495","E02000305","Enfield 029","E09000010","Enfield","E12000007","London",1715,1715,0,111.3,731,2.3,"00AK","Enfield",NA,16452,13242,14051,30819,21277,20150,21863,28346,4825,6908,7812,-2473
"1520","Enfield 026D","E01001496","E02000302","Enfield 026","E09000010","Enfield","E12000007","London",1705,1701,4,65.2,602,2.8,"00AK","Enfield",NA,18149,15888,17208,25034,17996,14345,18667,19161,-153,-1543,1459,-5873
"1546","Enfield 031E","E01001497","E02000307","Enfield 031","E09000010","Enfield","E12000007","London",1476,1476,0,72.6,531,2.8,"00AK","Enfield",NA,9129,7114,10035,22541,10618,6278,16309,15861,1489,-836,6274,-6680
"1533","Enfield 029B","E01001498","E02000305","Enfield 029","E09000010","Enfield","E12000007","London",1946,1939,7,102.1,746,2.6,"00AK","Enfield",NA,10317,10970,12534,28279,15909,13512,20896,23006,5592,2542,8362,-5273
"1547","Enfield 031F","E01001499","E02000307","Enfield 031","E09000010","Enfield","E12000007","London",1650,1650,0,79.2,564,2.9,"00AK","Enfield",NA,12751,9169,11314,20753,13370,9525,15221,20149,619,356,3907,-604
"1562","Enfield 035D","E01001500","E02000311","Enfield 035","E09000010","Enfield","E12000007","London",1527,1516,11,68,554,2.7,"00AK","Enfield",NA,12495,9337,10432,24140,13375,12942,16866,22248,880,3605,6434,-1892
"1569","Enfield 036E","E01001501","E02000312","Enfield 036","E09000010","Enfield","E12000007","London",1850,1816,34,61,818,2.2,"00AK","Enfield",NA,9007,6397,8517,25948,9831,9681,14847,21583,824,3284,6330,-4365
"1478","Enfield 018D","E01001502","E02000294","Enfield 018","E09000010","Enfield","E12000007","London",1872,1720,152,66.7,599,2.9,"00AK","Enfield",NA,9413,5903,11011,13220,7138,4393,8889,7015,-2275,-1510,-2122,-6205
"1479","Enfield 018E","E01001503","E02000294","Enfield 018","E09000010","Enfield","E12000007","London",1844,1844,0,108.2,654,2.8,"00AK","Enfield",NA,10030,7574,9517,16500,10032,6136,10389,10083,2,-1438,872,-6417
"1447","Enfield 012B","E01001504","E02000288","Enfield 012","E09000010","Enfield","E12000007","London",1549,1540,9,85.3,513,3,"00AK","Enfield",NA,8433,5601,6551,11902,7403,6782,9155,10203,-1030,1181,2604,-1699
"1448","Enfield 012C","E01001505","E02000288","Enfield 012","E09000010","Enfield","E12000007","London",1727,1727,0,88.8,567,3,"00AK","Enfield",NA,6691,3261,7219,10367,7039,4967,6683,9968,348,1706,-536,-399
"1457","Enfield 014B","E01001506","E02000290","Enfield 014","E09000010","Enfield","E12000007","London",1635,1635,0,8.4,565,2.9,"00AK","Enfield",NA,3994,1776,5384,6632,4451,1930,5414,8704,457,154,30,2072
"1449","Enfield 012D","E01001507","E02000288","Enfield 012","E09000010","Enfield","E12000007","London",1870,1870,0,69.8,766,2.4,"00AK","Enfield",NA,3786,3113,7271,14433,2600,2361,2841,8397,-1186,-752,-4430,-6036
"1450","Enfield 012E","E01001508","E02000288","Enfield 012","E09000010","Enfield","E12000007","London",1933,1914,19,93.2,718,2.7,"00AK","Enfield",NA,7093,2805,8178,17807,7663,4472,9656,10953,570,1667,1478,-6854
"1458","Enfield 014C","E01001509","E02000290","Enfield 014","E09000010","Enfield","E12000007","London",1738,1738,0,119.2,688,2.5,"00AK","Enfield",NA,7425,3420,8018,15933,5710,3421,7316,8474,-1715,1,-702,-7459
"1459","Enfield 014D","E01001510","E02000290","Enfield 014","E09000010","Enfield","E12000007","London",1496,1496,0,99.5,610,2.5,"00AK","Enfield",NA,1915,518,3664,4875,2037,1324,1820,3172,122,806,-1844,-1703
"1468","Enfield 016D","E01001511","E02000292","Enfield 016","E09000010","Enfield","E12000007","London",1751,1747,4,45.1,648,2.7,"00AK","Enfield",NA,14501,8632,19600,16843,13106,10436,14955,17606,-1395,1804,-4645,763
"1463","Enfield 015D","E01001512","E02000291","Enfield 015","E09000010","Enfield","E12000007","London",1780,1767,13,93.4,782,2.3,"00AK","Enfield",NA,12198,11998,14160,21790,12698,10495,13780,23133,500,-1503,-380,1343
"1451","Enfield 012F","E01001513","E02000288","Enfield 012","E09000010","Enfield","E12000007","London",1770,1770,0,18.6,623,2.8,"00AK","Enfield",NA,8218,4453,10325,8047,6706,4265,7306,11608,-1512,-188,-3019,3561
"1469","Enfield 016E","E01001514","E02000292","Enfield 016","E09000010","Enfield","E12000007","London",1768,1765,3,129.2,685,2.6,"00AK","Enfield",NA,10441,7098,10184,17844,12633,7770,12083,12800,2192,672,1899,-5044
"1464","Enfield 015E","E01001515","E02000291","Enfield 015","E09000010","Enfield","E12000007","London",1946,1938,8,150.3,755,2.6,"00AK","Enfield",NA,4615,2078,4417,7245,5312,3171,5723,7981,697,1093,1306,736
"1416","Enfield 005D","E01001516","E02000281","Enfield 005","E09000010","Enfield","E12000007","London",1834,1825,9,55.9,648,2.8,"00AK","Enfield",NA,7329,6232,7009,6165,7934,5567,8635,11149,605,-665,1626,4984
"1420","Enfield 006C","E01001517","E02000282","Enfield 006","E09000010","Enfield","E12000007","London",1890,1890,0,104.1,696,2.7,"00AK","Enfield",NA,1797,373,2776,4326,2758,1026,3598,2435,961,653,822,-1891
"1470","Enfield 016F","E01001518","E02000292","Enfield 016","E09000010","Enfield","E12000007","London",1767,1767,0,31.6,684,2.6,"00AK","Enfield",NA,16596,15850,22169,23318,11492,12822,15536,23544,-5104,-3028,-6633,226
"1488","Enfield 020D","E01001519","E02000296","Enfield 020","E09000010","Enfield","E12000007","London",2496,2496,0,70.8,1141,2.2,"00AK","Enfield",NA,17068,12502,21797,29770,18882,13340,22226,28651,1814,838,429,-1119
"1480","Enfield 019A","E01001520","E02000295","Enfield 019","E09000010","Enfield","E12000007","London",1680,1680,0,47.6,673,2.5,"00AK","Enfield",NA,14787,11986,11951,30022,15675,12731,13456,24382,888,745,1505,-5640
"1527","Enfield 028A","E01001521","E02000304","Enfield 028","E09000010","Enfield","E12000007","London",1777,1756,21,36.7,698,2.5,"00AK","Enfield",NA,22153,19018,21760,31620,26551,22622,29512,31483,4398,3604,7752,-137
"1481","Enfield 019B","E01001522","E02000295","Enfield 019","E09000010","Enfield","E12000007","London",1805,1727,78,88,751,2.3,"00AK","Enfield",NA,19438,13320,18430,23762,16763,11569,16216,22952,-2675,-1751,-2214,-810
"1482","Enfield 019C","E01001523","E02000295","Enfield 019","E09000010","Enfield","E12000007","London",1739,1739,0,33.4,738,2.4,"00AK","Enfield",NA,27829,23980,26122,31130,24641,20516,26559,27993,-3188,-3464,437,-3137
"1483","Enfield 019D","E01001524","E02000295","Enfield 019","E09000010","Enfield","E12000007","London",1531,1522,9,59.4,546,2.8,"00AK","Enfield",NA,15015,7986,15668,24818,13841,9894,11617,19525,-1174,1908,-4051,-5293
"1489","Enfield 020E","E01001525","E02000296","Enfield 020","E09000010","Enfield","E12000007","London",1807,1747,60,77.1,723,2.4,"00AK","Enfield",NA,16506,14374,14085,28236,13943,12520,18947,27687,-2563,-1854,4862,-549
"1484","Enfield 019E","E01001526","E02000295","Enfield 019","E09000010","Enfield","E12000007","London",1619,1619,0,57,639,2.5,"00AK","Enfield",NA,25165,21937,23868,29878,25192,23513,27780,28678,27,1576,3912,-1200
"1570","Enfield 036F","E01001527","E02000312","Enfield 036","E09000010","Enfield","E12000007","London",1563,1563,0,39.7,645,2.4,"00AK","Enfield",NA,12735,14016,11761,29317,16644,14831,16525,27275,3909,815,4764,-2042
"1549","Enfield 032B","E01001528","E02000308","Enfield 032","E09000010","Enfield","E12000007","London",1445,1445,0,69.3,553,2.6,"00AK","Enfield",NA,3581,2335,4457,8421,5826,4890,6426,8507,2245,2555,1969,86
"1550","Enfield 032C","E01001529","E02000308","Enfield 032","E09000010","Enfield","E12000007","London",1546,1490,56,92.9,635,2.3,"00AK","Enfield",NA,4230,2830,3869,17523,4896,4867,6624,11012,666,2037,2755,-6511
"1551","Enfield 032D","E01001530","E02000308","Enfield 032","E09000010","Enfield","E12000007","London",1290,1290,0,61.8,467,2.8,"00AK","Enfield",NA,10496,8144,9880,22436,14864,12018,16209,22787,4368,3874,6329,351
"1528","Enfield 028B","E01001531","E02000304","Enfield 028","E09000010","Enfield","E12000007","London",1498,1462,36,65.7,544,2.7,"00AK","Enfield",NA,23778,25307,25886,32066,26592,24423,27575,31990,2814,-884,1689,-76
"1529","Enfield 028C","E01001532","E02000304","Enfield 028","E09000010","Enfield","E12000007","London",1764,1764,0,61.1,687,2.6,"00AK","Enfield",NA,26121,25031,26187,32178,28652,27341,28103,32303,2531,2310,1916,125
"1530","Enfield 028D","E01001533","E02000304","Enfield 028","E09000010","Enfield","E12000007","London",1568,1533,35,47.9,530,2.9,"00AK","Enfield",NA,29195,24634,27741,30157,30328,26711,29103,31101,1133,2077,1362,944
"1552","Enfield 032E","E01001534","E02000308","Enfield 032","E09000010","Enfield","E12000007","London",1631,1612,19,40.4,588,2.7,"00AK","Enfield",NA,17657,15217,18594,30158,21310,18809,24330,28933,3653,3592,5736,-1225
"1531","Enfield 028E","E01001535","E02000304","Enfield 028","E09000010","Enfield","E12000007","London",1482,1482,0,37.8,505,2.9,"00AK","Enfield",NA,19251,20249,21669,28767,22890,22827,27630,29527,3639,2578,5961,760
"1429","Enfield 008B","E01001536","E02000284","Enfield 008","E09000010","Enfield","E12000007","London",1717,1699,18,39.6,742,2.3,"00AK","Enfield",NA,13823,17949,17669,30071,14780,14293,15054,26603,957,-3656,-2615,-3468
"1417","Enfield 005E","E01001537","E02000281","Enfield 005","E09000010","Enfield","E12000007","London",1754,1705,49,92.3,709,2.4,"00AK","Enfield",NA,14988,17264,19634,24072,22073,18151,24442,21140,7085,887,4808,-2932
"1433","Enfield 009A","E01001538","E02000285","Enfield 009","E09000010","Enfield","E12000007","London",1660,1660,0,65.2,603,2.8,"00AK","Enfield",NA,21912,18558,25952,22650,20350,20128,19834,21456,-1562,1570,-6118,-1194
"1434","Enfield 009B","E01001539","E02000285","Enfield 009","E09000010","Enfield","E12000007","London",1668,1653,15,76.1,657,2.5,"00AK","Enfield",NA,20896,17118,22376,24700,19346,16780,17030,22769,-1550,-338,-5346,-1931
"1430","Enfield 008C","E01001540","E02000284","Enfield 008","E09000010","Enfield","E12000007","London",1763,1763,0,68.1,794,2.2,"00AK","Enfield",NA,22591,19920,23184,29981,19085,13604,19318,25364,-3506,-6316,-3866,-4617
"1431","Enfield 008D","E01001541","E02000284","Enfield 008","E09000010","Enfield","E12000007","London",1504,1497,7,82.8,650,2.3,"00AK","Enfield",NA,26147,26325,23833,29063,24779,22704,25115,25805,-1368,-3621,1282,-3258
"1432","Enfield 008E","E01001542","E02000284","Enfield 008","E09000010","Enfield","E12000007","London",1571,1563,8,85.2,678,2.3,"00AK","Enfield",NA,13133,9000,14716,21693,14490,9452,14601,19458,1357,452,-115,-2235
"1435","Enfield 009C","E01001543","E02000285","Enfield 009","E09000010","Enfield","E12000007","London",1672,1672,0,80.3,596,2.8,"00AK","Enfield",NA,22737,22644,24503,22385,23339,19533,24297,21623,602,-3111,-206,-762
"1436","Enfield 009D","E01001544","E02000285","Enfield 009","E09000010","Enfield","E12000007","London",1597,1583,14,52.7,610,2.6,"00AK","Enfield",NA,24658,20964,21010,27392,24334,21526,17635,27007,-324,562,-3375,-385
"1398","Enfield 002B","E01001545","E02000278","Enfield 002","E09000010","Enfield","E12000007","London",1843,1841,2,53.4,665,2.8,"00AK","Enfield",NA,2524,1409,2563,4080,1965,706,3036,4028,-559,-703,473,-52
"1395","Enfield 001C","E01001546","E02000277","Enfield 001","E09000010","Enfield","E12000007","London",1783,1783,0,74.7,640,2.8,"00AK","Enfield",NA,9656,6456,10578,8603,8782,5452,9550,8153,-874,-1004,-1028,-450
"1399","Enfield 002C","E01001547","E02000278","Enfield 002","E09000010","Enfield","E12000007","London",1758,1758,0,70.7,659,2.7,"00AK","Enfield",NA,7846,7605,8344,14158,6935,6022,9399,8731,-911,-1583,1055,-5427
"1400","Enfield 002D","E01001548","E02000278","Enfield 002","E09000010","Enfield","E12000007","London",1819,1819,0,60.7,676,2.7,"00AK","Enfield",NA,8198,5448,8930,7833,6727,3573,9052,8072,-1471,-1875,122,239
"1421","Enfield 006D","E01001549","E02000282","Enfield 006","E09000010","Enfield","E12000007","London",1975,1975,0,61.6,798,2.5,"00AK","Enfield",NA,3145,785,4171,5788,2266,1275,3308,5993,-879,490,-863,205
"1422","Enfield 006E","E01001550","E02000282","Enfield 006","E09000010","Enfield","E12000007","London",1661,1661,0,76.3,570,2.9,"00AK","Enfield",NA,8791,5531,11576,7430,5129,3925,6327,6469,-3662,-1606,-5249,-961
"1401","Enfield 002E","E01001551","E02000278","Enfield 002","E09000010","Enfield","E12000007","London",1733,1692,41,56.6,661,2.6,"00AK","Enfield",NA,5701,2948,5654,7999,3427,2700,4296,5646,-2274,-248,-1358,-2353
"1396","Enfield 001D","E01001552","E02000277","Enfield 001","E09000010","Enfield","E12000007","London",1805,1762,43,64.3,659,2.7,"00AK","Enfield",NA,10151,8707,16372,11287,9693,7661,13075,11822,-458,-1046,-3297,535
"1572","Enfield 037B","E01001553","E02006793","Enfield 037","E09000010","Enfield","E12000007","London",1597,1597,0,79.7,530,3,"00AK","Enfield",NA,4063,1998,5588,6690,4175,3520,5254,5354,112,1522,-334,-1336
"1573","Enfield 037C","E01001554","E02006793","Enfield 037","E09000010","Enfield","E12000007","London",1791,1791,0,148.3,756,2.4,"00AK","Enfield",NA,1849,868,3005,8052,2083,1907,4368,4032,234,1039,1363,-4020
"1555","Enfield 033C","E01001555","E02000309","Enfield 033","E09000010","Enfield","E12000007","London",1783,1783,0,127.4,624,2.9,"00AK","Enfield",NA,6000,2980,7816,8728,6001,7185,8364,8303,1,4205,548,-425
"1563","Enfield 035E","E01001556","E02000311","Enfield 035","E09000010","Enfield","E12000007","London",1579,1579,0,72.8,543,2.9,"00AK","Enfield",NA,10925,8648,10564,15824,15607,11296,17362,16629,4682,2648,6798,805
"1556","Enfield 033D","E01001557","E02000309","Enfield 033","E09000010","Enfield","E12000007","London",1586,1586,0,123.2,546,2.9,"00AK","Enfield",NA,7810,3844,8524,8906,5497,3122,6401,8276,-2313,-722,-2123,-630
"1557","Enfield 033E","E01001558","E02000309","Enfield 033","E09000010","Enfield","E12000007","London",1613,1613,0,108.4,558,2.9,"00AK","Enfield",NA,2332,926,4805,4363,3124,3138,6158,7598,792,2212,1353,3235
"1558","Enfield 033F","E01001559","E02000309","Enfield 033","E09000010","Enfield","E12000007","London",2051,1977,74,22.2,743,2.7,"00AK","Enfield",NA,3846,2428,4946,7275,3068,2388,5542,9896,-778,-40,596,2621
"1564","Enfield 035F","E01001560","E02000311","Enfield 035","E09000010","Enfield","E12000007","London",1599,1599,0,60.5,516,3.1,"00AK","Enfield",NA,7528,4777,10799,9979,6289,6017,9912,8310,-1239,1240,-887,-1669
"1574","Enfield 037D","E01001562","E02006793","Enfield 037","E09000010","Enfield","E12000007","London",1716,1654,62,120.4,711,2.3,"00AK","Enfield",NA,3140,1423,5912,10106,2617,2268,3975,5631,-523,845,-1937,-4475
"1534","Enfield 029C","E01001563","E02000305","Enfield 029","E09000010","Enfield","E12000007","London",1615,1585,30,83,669,2.4,"00AK","Enfield",NA,14199,12639,17475,28899,17947,16705,19326,29095,3748,4066,1851,196
"1497","Enfield 022B","E01001564","E02000298","Enfield 022","E09000010","Enfield","E12000007","London",1666,1624,42,72,646,2.5,"00AK","Enfield",NA,18542,17792,20278,31571,21714,19463,24026,31329,3172,1671,3748,-242
"1535","Enfield 029D","E01001565","E02000305","Enfield 029","E09000010","Enfield","E12000007","London",1636,1636,0,73.3,709,2.3,"00AK","Enfield",NA,17211,17227,18438,31131,17501,13871,21555,28908,290,-3356,3117,-2223
"1536","Enfield 029E","E01001566","E02000305","Enfield 029","E09000010","Enfield","E12000007","London",1721,1598,123,86.7,626,2.6,"00AK","Enfield",NA,13743,14115,12277,32076,17745,18124,15576,29243,4002,4009,3299,-2833
"1498","Enfield 022C","E01001567","E02000298","Enfield 022","E09000010","Enfield","E12000007","London",1583,1583,0,51.1,632,2.5,"00AK","Enfield",NA,26040,28219,26235,30960,28913,29241,30886,31369,2873,1022,4651,409
"1499","Enfield 022D","E01001568","E02000298","Enfield 022","E09000010","Enfield","E12000007","London",1583,1580,3,17.6,538,2.9,"00AK","Enfield",NA,24325,25826,26523,28502,24419,26071,24169,27499,94,245,-2354,-1003
"1500","Enfield 022E","E01001569","E02000298","Enfield 022","E09000010","Enfield","E12000007","London",1744,1722,22,59.2,778,2.2,"00AK","Enfield",NA,17202,13010,17596,26944,21234,17020,20275,28196,4032,4010,2679,1252
"1521","Enfield 026E","E01001570","E02000302","Enfield 026","E09000010","Enfield","E12000007","London",1855,1820,35,45.6,751,2.4,"00AK","Enfield",NA,15966,12434,17311,24092,16723,13090,18613,20354,757,656,1302,-3738
"1616","Greenwich 008A","E01001571","E02000320","Greenwich 008","E09000011","Greenwich","E12000007","London",1639,1639,0,110.7,615,2.7,"00AL","Greenwich",NA,9965,9472,16621,7931,16825,15682,17014,16379,6860,6210,393,8448
"1617","Greenwich 008B","E01001572","E02000320","Greenwich 008","E09000011","Greenwich","E12000007","London",1711,1711,0,101.6,628,2.7,"00AL","Greenwich",NA,10785,12414,14512,12720,17325,14320,18732,16783,6540,1906,4220,4063
"1618","Greenwich 008C","E01001573","E02000320","Greenwich 008","E09000011","Greenwich","E12000007","London",1505,1505,0,108.9,513,2.9,"00AL","Greenwich",NA,12020,15272,17892,12362,16991,12335,16625,19590,4971,-2937,-1267,7228
"1619","Greenwich 008D","E01001574","E02000320","Greenwich 008","E09000011","Greenwich","E12000007","London",1769,1748,21,17.6,768,2.3,"00AL","Greenwich",NA,1985,1992,1290,6272,3236,3028,2182,9132,1251,1036,892,2860
"1587","Greenwich 003A","E01001575","E02000315","Greenwich 003","E09000011","Greenwich","E12000007","London",1707,1707,0,78,599,2.8,"00AL","Greenwich",NA,2208,1564,3232,4643,3688,2305,2845,10707,1480,741,-387,6064
"1588","Greenwich 003B","E01001576","E02000315","Greenwich 003","E09000011","Greenwich","E12000007","London",1739,1700,39,72.9,658,2.6,"00AL","Greenwich",NA,2404,1578,2953,4802,3855,2272,3866,10485,1451,694,913,5683
"1589","Greenwich 003C","E01001577","E02000315","Greenwich 003","E09000011","Greenwich","E12000007","London",1857,1857,0,88,737,2.5,"00AL","Greenwich",NA,2753,3557,2459,4978,5507,4270,5883,11513,2754,713,3424,6535
"1590","Greenwich 003D","E01001578","E02000315","Greenwich 003","E09000011","Greenwich","E12000007","London",2131,2129,2,78.4,809,2.6,"00AL","Greenwich",NA,6844,6040,8886,6411,9409,7002,10601,15717,2565,962,1715,9306
"1591","Greenwich 003E","E01001579","E02000315","Greenwich 003","E09000011","Greenwich","E12000007","London",1646,1646,0,65.2,637,2.6,"00AL","Greenwich",NA,5755,5459,5907,6323,4919,3639,5582,7381,-836,-1820,-325,1058
"1659","Greenwich 021A","E01001580","E02000333","Greenwich 021","E09000011","Greenwich","E12000007","London",1642,1642,0,55.2,833,2,"00AL","Greenwich",NA,13424,22963,22633,25280,22698,25447,28525,30963,9274,2484,5892,5683
"1642","Greenwich 016A","E01001581","E02000328","Greenwich 016","E09000011","Greenwich","E12000007","London",1693,1675,18,81.1,838,2,"00AL","Greenwich",NA,8941,10058,13529,26132,13497,11500,14112,30852,4556,1442,583,4720
"1660","Greenwich 021B","E01001582","E02000333","Greenwich 021","E09000011","Greenwich","E12000007","London",1475,1442,33,43.1,641,2.2,"00AL","Greenwich",NA,9182,10842,9344,25229,10951,8925,11550,26186,1769,-1917,2206,957
"1661","Greenwich 021C","E01001583","E02000333","Greenwich 021","E09000011","Greenwich","E12000007","London",1603,1603,0,54.7,818,2,"00AL","Greenwich",NA,12593,19846,25013,28792,21170,25442,27272,30235,8577,5596,2259,1443
"1662","Greenwich 021D","E01001584","E02000333","Greenwich 021","E09000011","Greenwich","E12000007","London",1549,1465,84,47.2,713,2.1,"00AL","Greenwich",NA,19674,24260,27043,26468,27362,27351,28814,32085,7688,3091,1771,5617
"1643","Greenwich 016B","E01001585","E02000328","Greenwich 016","E09000011","Greenwich","E12000007","London",1532,1525,7,85.5,628,2.4,"00AL","Greenwich",NA,13887,17582,15976,29676,24243,21605,20354,32207,10356,4023,4378,2531
"1644","Greenwich 016C","E01001586","E02000328","Greenwich 016","E09000011","Greenwich","E12000007","London",1491,1422,69,69.7,683,2.1,"00AL","Greenwich",NA,7939,11251,10736,20608,11254,11295,10993,18280,3315,44,257,-2328
"1645","Greenwich 016D","E01001587","E02000328","Greenwich 016","E09000011","Greenwich","E12000007","London",1890,1890,0,69,921,2.1,"00AL","Greenwich",NA,11792,13304,14170,29386,21207,20002,22376,31223,9415,6698,8206,1837
"1630","Greenwich 012A","E01001588","E02000324","Greenwich 012","E09000011","Greenwich","E12000007","London",1692,1615,77,32.5,659,2.5,"00AL","Greenwich",NA,3926,4907,5309,12116,5639,7591,7900,18190,1713,2684,2591,6074
"1631","Greenwich 012B","E01001589","E02000324","Greenwich 012","E09000011","Greenwich","E12000007","London",1604,1598,6,76.1,616,2.6,"00AL","Greenwich",NA,5909,5545,5491,10415,8254,7906,8199,14152,2345,2361,2708,3737
"1634","Greenwich 014A","E01001590","E02000326","Greenwich 014","E09000011","Greenwich","E12000007","London",1777,1777,0,114.3,701,2.5,"00AL","Greenwich",NA,7823,8635,9812,22722,17137,13324,17592,28066,9314,4689,7780,5344
"1632","Greenwich 012C","E01001591","E02000324","Greenwich 012","E09000011","Greenwich","E12000007","London",2040,2034,6,101.1,839,2.4,"00AL","Greenwich",NA,3603,2627,4520,9821,6017,5237,6382,14616,2414,2610,1862,4795
"1635","Greenwich 014B","E01001592","E02000326","Greenwich 014","E09000011","Greenwich","E12000007","London",1718,1718,0,71.8,740,2.3,"00AL","Greenwich",NA,11398,13805,14063,20808,19189,19202,19156,27571,7791,5397,5093,6763
"1636","Greenwich 014C","E01001593","E02000326","Greenwich 014","E09000011","Greenwich","E12000007","London",1638,1631,7,88.3,728,2.2,"00AL","Greenwich",NA,14320,17703,18368,26118,21376,21754,20810,28356,7056,4051,2442,2238
"1637","Greenwich 014D","E01001594","E02000326","Greenwich 014","E09000011","Greenwich","E12000007","London",1937,1937,0,129.2,763,2.5,"00AL","Greenwich",NA,1381,514,2675,10084,6311,3008,5525,12365,4930,2494,2850,2281
"1633","Greenwich 012D","E01001595","E02000324","Greenwich 012","E09000011","Greenwich","E12000007","London",1979,1934,45,53.5,693,2.8,"00AL","Greenwich",NA,4297,3071,5679,12297,10072,8894,9784,17634,5775,5823,4105,5337
"1696","Greenwich 032A","E01001596","E02000344","Greenwich 032","E09000011","Greenwich","E12000007","London",1564,1558,6,53.4,597,2.6,"00AL","Greenwich",NA,19834,21800,22176,20760,25099,22204,23680,19603,5265,404,1504,-1157
"1692","Greenwich 031A","E01001597","E02000343","Greenwich 031","E09000011","Greenwich","E12000007","London",1560,1543,17,48.1,607,2.5,"00AL","Greenwich",NA,12127,17432,19936,20105,17451,18180,18769,22019,5324,748,-1167,1914
"1693","Greenwich 031B","E01001598","E02000343","Greenwich 031","E09000011","Greenwich","E12000007","London",1587,1587,0,34.1,606,2.6,"00AL","Greenwich",NA,15366,21113,19228,19834,18661,16734,18981,16733,3295,-4379,-247,-3101
"1697","Greenwich 032B","E01001599","E02000344","Greenwich 032","E09000011","Greenwich","E12000007","London",1701,1701,0,37.5,615,2.8,"00AL","Greenwich",NA,10986,12046,14128,12097,16731,15035,15428,11734,5745,2989,1300,-363
"1698","Greenwich 032C","E01001600","E02000344","Greenwich 032","E09000011","Greenwich","E12000007","London",1561,1557,4,51.5,663,2.3,"00AL","Greenwich",NA,12772,17139,17616,16859,19889,16213,17895,23082,7117,-926,279,6223
"1699","Greenwich 032D","E01001601","E02000344","Greenwich 032","E09000011","Greenwich","E12000007","London",1561,1461,100,64.6,601,2.4,"00AL","Greenwich",NA,16227,19892,24007,19333,20174,18311,22666,21984,3947,-1581,-1341,2651
"1694","Greenwich 031C","E01001602","E02000343","Greenwich 031","E09000011","Greenwich","E12000007","London",1873,1873,0,72.9,718,2.6,"00AL","Greenwich",NA,6087,5165,6594,5080,7405,6412,5147,7398,1318,1247,-1447,2318
"1695","Greenwich 031D","E01001603","E02000343","Greenwich 031","E09000011","Greenwich","E12000007","London",1655,1655,0,78.7,768,2.2,"00AL","Greenwich",NA,3836,4338,2407,5439,4600,3952,3159,4725,764,-386,752,-714
"1676","Greenwich 027A","E01001604","E02000339","Greenwich 027","E09000011","Greenwich","E12000007","London",1440,1440,0,60.7,568,2.5,"00AL","Greenwich",NA,18145,16866,21835,27097,23533,20604,22981,28090,5388,3738,1146,993
"1667","Greenwich 023A","E01001605","E02000335","Greenwich 023","E09000011","Greenwich","E12000007","London",1584,1584,0,24,571,2.8,"00AL","Greenwich",NA,20077,20857,21900,19199,27391,25817,26033,23409,7314,4960,4133,4210
"1668","Greenwich 023B","E01001606","E02000335","Greenwich 023","E09000011","Greenwich","E12000007","London",1637,1637,0,77.6,618,2.6,"00AL","Greenwich",NA,20497,21448,23936,19158,29389,26944,27849,24642,8892,5496,3913,5484
"1677","Greenwich 027B","E01001607","E02000339","Greenwich 027","E09000011","Greenwich","E12000007","London",1474,1474,0,69.7,604,2.4,"00AL","Greenwich",NA,15974,15543,19595,22882,18598,14430,16870,22352,2624,-1113,-2725,-530
"1678","Greenwich 027C","E01001608","E02000339","Greenwich 027","E09000011","Greenwich","E12000007","London",1454,1447,7,30.8,592,2.4,"00AL","Greenwich",NA,19358,19888,20733,31178,21661,24192,22337,30092,2303,4304,1604,-1086
"1679","Greenwich 027D","E01001609","E02000339","Greenwich 027","E09000011","Greenwich","E12000007","London",1602,1602,0,47.7,738,2.2,"00AL","Greenwich",NA,8747,14797,8080,26731,12246,12992,9997,26794,3499,-1805,1917,63
"1669","Greenwich 023C","E01001610","E02000335","Greenwich 023","E09000011","Greenwich","E12000007","London",1669,1669,0,75.6,707,2.4,"00AL","Greenwich",NA,16475,15995,20475,15803,22687,16919,20075,20026,6212,924,-400,4223
"1670","Greenwich 023D","E01001611","E02000335","Greenwich 023","E09000011","Greenwich","E12000007","London",1659,1659,0,82.5,741,2.2,"00AL","Greenwich",NA,11518,12989,11840,16440,15698,14582,13616,15408,4180,1593,1776,-1032
"1680","Greenwich 028A","E01001613","E02000340","Greenwich 028","E09000011","Greenwich","E12000007","London",1586,1586,0,21.7,775,2,"00AL","Greenwich",NA,9485,12696,13424,17806,13095,11094,11998,22547,3610,-1602,-1426,4741
"1681","Greenwich 028B","E01001614","E02000340","Greenwich 028","E09000011","Greenwich","E12000007","London",1409,1409,0,15.9,530,2.7,"00AL","Greenwich",NA,19272,27027,28877,21811,25202,25081,27247,22655,5930,-1946,-1630,844
"1682","Greenwich 028C","E01001615","E02000340","Greenwich 028","E09000011","Greenwich","E12000007","London",1519,1517,2,15.9,756,2,"00AL","Greenwich",NA,7372,14391,11290,18426,12504,15830,14649,20754,5132,1439,3359,2328
"1683","Greenwich 028D","E01001617","E02000340","Greenwich 028","E09000011","Greenwich","E12000007","London",1574,1574,0,22.7,738,2.1,"00AL","Greenwich",NA,12236,24117,20486,20768,23537,23545,22608,22895,11301,-572,2122,2127
"1689","Greenwich 030C","E01001618","E02000342","Greenwich 030","E09000011","Greenwich","E12000007","London",1604,1604,0,46.1,648,2.5,"00AL","Greenwich",NA,7845,7596,9883,10970,11213,8473,10768,11262,3368,877,885,292
"1690","Greenwich 030D","E01001619","E02000342","Greenwich 030","E09000011","Greenwich","E12000007","London",1880,1880,0,58.3,818,2.3,"00AL","Greenwich",NA,15412,16824,24224,17779,18434,15174,22138,16738,3022,-1650,-2086,-1041
"1671","Greenwich 025A","E01001620","E02000337","Greenwich 025","E09000011","Greenwich","E12000007","London",1591,1591,0,61,505,3.2,"00AL","Greenwich",NA,4240,4064,6419,4760,6546,5120,6311,4851,2306,1056,-108,91
"1672","Greenwich 025B","E01001621","E02000337","Greenwich 025","E09000011","Greenwich","E12000007","London",1491,1491,0,40.7,611,2.4,"00AL","Greenwich",NA,4602,6229,7149,8577,5369,6299,6453,8562,767,70,-696,-15
"1673","Greenwich 025C","E01001623","E02000337","Greenwich 025","E09000011","Greenwich","E12000007","London",1696,1696,0,61.3,664,2.6,"00AL","Greenwich",NA,6755,6455,9579,6502,10443,10638,10410,11280,3688,4183,831,4778
"1674","Greenwich 025D","E01001624","E02000337","Greenwich 025","E09000011","Greenwich","E12000007","London",1551,1551,0,69.1,631,2.5,"00AL","Greenwich",NA,8521,9854,10473,9909,10599,10901,7400,8885,2078,1047,-3073,-1024
"1675","Greenwich 025E","E01001625","E02000337","Greenwich 025","E09000011","Greenwich","E12000007","London",1577,1577,0,58.5,587,2.7,"00AL","Greenwich",NA,2972,5341,5788,971,4373,4503,5420,6144,1401,-838,-368,5173
"1620","Greenwich 009A","E01001629","E02000321","Greenwich 009","E09000011","Greenwich","E12000007","London",2176,2176,0,105.9,852,2.6,"00AL","Greenwich",NA,2160,1725,2689,3635,6590,4139,7856,12146,4430,2414,5167,8511
"1610","Greenwich 007B","E01001631","E02000319","Greenwich 007","E09000011","Greenwich","E12000007","London",2072,2072,0,105.2,793,2.6,"00AL","Greenwich",NA,1061,1090,996,7683,5315,3746,5399,13174,4254,2656,4403,5491
"1611","Greenwich 007C","E01001632","E02000319","Greenwich 007","E09000011","Greenwich","E12000007","London",2319,2290,29,192.4,635,3.6,"00AL","Greenwich",NA,8612,7468,10418,14217,15400,13035,19434,16212,6788,5567,9016,1995
"1621","Greenwich 009B","E01001633","E02000321","Greenwich 009","E09000011","Greenwich","E12000007","London",1607,1607,0,139.5,652,2.5,"00AL","Greenwich",NA,4838,4641,3906,8563,5422,3096,4335,14236,584,-1545,429,5673
"1622","Greenwich 009C","E01001634","E02000321","Greenwich 009","E09000011","Greenwich","E12000007","London",1714,1661,53,147.6,667,2.5,"00AL","Greenwich",NA,1279,924,1157,6882,3250,2294,2662,5269,1971,1370,1505,-1613
"1612","Greenwich 007D","E01001635","E02000319","Greenwich 007","E09000011","Greenwich","E12000007","London",1661,1661,0,78.8,618,2.7,"00AL","Greenwich",NA,8410,8283,11893,15488,12570,10953,15034,16924,4160,2670,3141,1436
"1613","Greenwich 007E","E01001636","E02000319","Greenwich 007","E09000011","Greenwich","E12000007","London",1722,1722,0,137.9,593,2.9,"00AL","Greenwich",NA,7244,8188,9900,11001,11325,8713,10902,15107,4081,525,1002,4106
"1623","Greenwich 009D","E01001637","E02000321","Greenwich 009","E09000011","Greenwich","E12000007","London",1703,1703,0,91.8,706,2.4,"00AL","Greenwich",NA,5954,5616,6926,12247,9558,9083,10720,12494,3604,3467,3794,247
"1722","Greenwich 038A","E01001638","E02006931","Greenwich 038","E09000011","Greenwich","E12000007","London",1974,1894,80,182.1,806,2.3,"00AL","Greenwich",NA,3462,2217,3519,10109,8030,4864,9501,18664,4568,2647,5982,8555
"1709","Greenwich 035A","E01001640","E02006928","Greenwich 035","E09000011","Greenwich","E12000007","London",2334,2109,225,169.6,881,2.4,"00AL","Greenwich",NA,2335,2456,3829,9657,7159,6014,10606,16352,4824,3558,6777,6695
"1723","Greenwich 038B","E01001641","E02006931","Greenwich 038","E09000011","Greenwich","E12000007","London",1755,1663,92,47.2,779,2.1,"00AL","Greenwich",NA,9495,11569,15995,14608,16176,18785,22758,30427,6681,7216,6763,15819
"1724","Greenwich 038C","E01001642","E02006931","Greenwich 038","E09000011","Greenwich","E12000007","London",1781,1768,13,14.9,791,2.2,"00AL","Greenwich",NA,13464,23867,27238,31432,22287,25800,30523,32195,8823,1933,3285,763
"1725","Greenwich 038D","E01001644","E02006931","Greenwich 038","E09000011","Greenwich","E12000007","London",2212,2212,0,116.1,1022,2.2,"00AL","Greenwich",NA,8562,11328,12028,19144,16321,18557,21411,25028,7759,7229,9383,5884
"1663","Greenwich 022A","E01001645","E02000334","Greenwich 022","E09000011","Greenwich","E12000007","London",1697,1697,0,58.5,714,2.4,"00AL","Greenwich",NA,6510,5990,4996,13025,10319,7810,7545,12908,3809,1820,2549,-117
"1650","Greenwich 019A","E01001646","E02000331","Greenwich 019","E09000011","Greenwich","E12000007","London",2829,2828,1,134.1,1179,2.4,"00AL","Greenwich",NA,7332,5488,12082,11075,13364,9616,13944,16527,6032,4128,1862,5452
"1664","Greenwich 022B","E01001647","E02000334","Greenwich 022","E09000011","Greenwich","E12000007","London",1491,1491,0,43,573,2.6,"00AL","Greenwich",NA,11097,11769,13742,14035,14885,15605,16294,19214,3788,3836,2552,5179
"1665","Greenwich 022C","E01001648","E02000334","Greenwich 022","E09000011","Greenwich","E12000007","London",1751,1751,0,42,729,2.4,"00AL","Greenwich",NA,10784,12930,15444,16564,17015,15920,17338,21953,6231,2990,1894,5389
"1666","Greenwich 022D","E01001649","E02000334","Greenwich 022","E09000011","Greenwich","E12000007","London",1530,1524,6,46,569,2.7,"00AL","Greenwich",NA,5134,5524,6440,5824,7497,6478,6271,8447,2363,954,-169,2623
"1651","Greenwich 019B","E01001650","E02000331","Greenwich 019","E09000011","Greenwich","E12000007","London",1733,1733,0,83.1,615,2.8,"00AL","Greenwich",NA,5028,4849,6219,3803,8224,6748,7262,11505,3196,1899,1043,7702
"1652","Greenwich 019C","E01001651","E02000331","Greenwich 019","E09000011","Greenwich","E12000007","London",1714,1714,0,55.9,761,2.3,"00AL","Greenwich",NA,2758,5093,2351,7250,5464,6062,5335,9866,2706,969,2984,2616
"1653","Greenwich 019D","E01001652","E02000331","Greenwich 019","E09000011","Greenwich","E12000007","London",1555,1530,25,58.4,681,2.2,"00AL","Greenwich",NA,12271,13523,15299,20507,14613,15446,19853,27840,2342,1923,4554,7333
"1684","Greenwich 029A","E01001653","E02000341","Greenwich 029","E09000011","Greenwich","E12000007","London",1547,1547,0,58.1,610,2.5,"00AL","Greenwich",NA,3405,3774,5562,892,3732,3006,4020,4264,327,-768,-1542,3372
"1685","Greenwich 029B","E01001654","E02000341","Greenwich 029","E09000011","Greenwich","E12000007","London",1546,1546,0,51.3,603,2.6,"00AL","Greenwich",NA,3388,3251,3384,4458,4430,3227,4231,7718,1042,-24,847,3260
"1686","Greenwich 029C","E01001655","E02000341","Greenwich 029","E09000011","Greenwich","E12000007","London",1465,1465,0,33.7,637,2.3,"00AL","Greenwich",NA,1764,2499,2009,3161,2327,2234,1843,6221,563,-265,-166,3060
"1704","Greenwich 034A","E01001656","E02006927","Greenwich 034","E09000011","Greenwich","E12000007","London",1272,1272,0,46.1,582,2.2,"00AL","Greenwich",NA,11242,11576,14282,25171,16627,12066,13901,22759,5385,490,-381,-2412
"1705","Greenwich 034B","E01001657","E02006927","Greenwich 034","E09000011","Greenwich","E12000007","London",1547,1527,20,38.3,686,2.2,"00AL","Greenwich",NA,13113,18422,19097,28884,22015,21004,18715,27065,8902,2582,-382,-1819
"1706","Greenwich 034C","E01001658","E02006927","Greenwich 034","E09000011","Greenwich","E12000007","London",1549,1549,0,35.6,723,2.1,"00AL","Greenwich",NA,10967,12649,15583,24560,13684,11298,15349,21897,2717,-1351,-234,-2663
"1707","Greenwich 034D","E01001659","E02006927","Greenwich 034","E09000011","Greenwich","E12000007","London",1454,1454,0,38.5,529,2.7,"00AL","Greenwich",NA,10543,13186,17630,18003,13567,14717,14896,22137,3024,1531,-2734,4134
"1687","Greenwich 029D","E01001660","E02000341","Greenwich 029","E09000011","Greenwich","E12000007","London",1600,1600,0,47.8,586,2.7,"00AL","Greenwich",NA,4593,4387,6679,4700,5591,5588,6170,9179,998,1201,-509,4479
"1688","Greenwich 029E","E01001661","E02000341","Greenwich 029","E09000011","Greenwich","E12000007","London",1525,1525,0,33.5,588,2.6,"00AL","Greenwich",NA,4701,6566,7883,4845,6789,6629,6973,9050,2088,63,-910,4205
"1718","Greenwich 037A","E01001662","E02006930","Greenwich 037","E09000011","Greenwich","E12000007","London",1608,1608,0,68.1,715,2.2,"00AL","Greenwich",NA,10559,13552,18597,19575,17187,16821,23216,27846,6628,3269,4619,8271
"1719","Greenwich 037B","E01001664","E02006930","Greenwich 037","E09000011","Greenwich","E12000007","London",1870,1870,0,120,854,2.2,"00AL","Greenwich",NA,6929,9412,9243,19418,13580,16268,16420,29619,6651,6856,7177,10201
"1720","Greenwich 037C","E01001665","E02006930","Greenwich 037","E09000011","Greenwich","E12000007","London",1867,1863,4,100.2,788,2.4,"00AL","Greenwich",NA,9187,12449,13598,18253,16687,16874,20731,25097,7500,4425,7133,6844
"1713","Greenwich 036A","E01001666","E02006929","Greenwich 036","E09000011","Greenwich","E12000007","London",1470,1469,1,34.1,557,2.6,"00AL","Greenwich",NA,8405,10304,12061,15251,11924,10578,15512,19655,3519,274,3451,4404
"1714","Greenwich 036B","E01001667","E02006929","Greenwich 036","E09000011","Greenwich","E12000007","London",1564,1564,0,11.5,707,2.2,"00AL","Greenwich",NA,1920,1896,2078,3823,3670,3901,4524,13757,1750,2005,2446,9934
"1715","Greenwich 036C","E01001668","E02006929","Greenwich 036","E09000011","Greenwich","E12000007","London",2269,2269,0,97.9,1049,2.2,"00AL","Greenwich",NA,6863,7121,9185,12921,9205,6091,9373,21963,2342,-1030,188,9042
"1700","Greenwich 033A","E01001669","E02006786","Greenwich 033","E09000011","Greenwich","E12000007","London",1874,1874,0,37.2,689,2.7,"00AL","Greenwich",NA,5625,4836,7373,8854,8869,6652,7115,13162,3244,1816,-258,4308
"1701","Greenwich 033B","E01001671","E02006786","Greenwich 033","E09000011","Greenwich","E12000007","London",1578,1578,0,80.6,675,2.3,"00AL","Greenwich",NA,9846,11938,9869,11106,11541,9520,9486,9343,1695,-2418,-383,-1763
"1605","Greenwich 006A","E01001672","E02000318","Greenwich 006","E09000011","Greenwich","E12000007","London",2049,2049,0,56.9,630,3.3,"00AL","Greenwich",NA,6635,8775,11070,8274,10873,8317,14840,11879,4238,-458,3770,3605
"1606","Greenwich 006B","E01001673","E02000318","Greenwich 006","E09000011","Greenwich","E12000007","London",1892,1892,0,108.4,685,2.8,"00AL","Greenwich",NA,3122,3976,6334,7713,6881,6193,10342,13807,3759,2217,4008,6094
"1607","Greenwich 006C","E01001674","E02000318","Greenwich 006","E09000011","Greenwich","E12000007","London",1973,1973,0,92.1,671,2.9,"00AL","Greenwich",NA,6745,6614,8659,8833,10741,8490,12443,16855,3996,1876,3784,8022
"1608","Greenwich 006D","E01001675","E02000318","Greenwich 006","E09000011","Greenwich","E12000007","London",1980,1980,0,127.6,629,3.1,"00AL","Greenwich",NA,5409,4435,6645,9987,10299,7438,13506,12104,4890,3003,6861,2117
"1702","Greenwich 033C","E01001676","E02006786","Greenwich 033","E09000011","Greenwich","E12000007","London",1791,1791,0,136.3,646,2.8,"00AL","Greenwich",NA,5084,4362,6824,7544,9190,7093,7976,14506,4106,2731,1152,6962
"1609","Greenwich 006E","E01001677","E02000318","Greenwich 006","E09000011","Greenwich","E12000007","London",1948,1948,0,97.1,668,2.9,"00AL","Greenwich",NA,6668,5461,10039,11137,14181,10012,14682,14957,7513,4551,4643,3820
"1646","Greenwich 017A","E01001678","E02000329","Greenwich 017","E09000011","Greenwich","E12000007","London",1667,1667,0,63.7,628,2.7,"00AL","Greenwich",NA,14280,15135,20188,12911,19009,16738,18074,18110,4729,1603,-2114,5199
"1654","Greenwich 020A","E01001679","E02000332","Greenwich 020","E09000011","Greenwich","E12000007","London",1346,1346,0,63.2,520,2.6,"00AL","Greenwich",NA,13017,16992,18266,17080,19487,17688,18698,23651,6470,696,432,6571
"1655","Greenwich 020B","E01001680","E02000332","Greenwich 020","E09000011","Greenwich","E12000007","London",1573,1572,1,25.9,618,2.5,"00AL","Greenwich",NA,20384,23780,24039,27077,26006,24695,25200,27513,5622,915,1161,436
"1656","Greenwich 020C","E01001681","E02000332","Greenwich 020","E09000011","Greenwich","E12000007","London",1224,1224,0,78.5,488,2.5,"00AL","Greenwich",NA,9888,11614,11021,17833,15992,13590,11826,20949,6104,1976,805,3116
"1657","Greenwich 020D","E01001682","E02000332","Greenwich 020","E09000011","Greenwich","E12000007","London",1333,1327,6,15.3,565,2.3,"00AL","Greenwich",NA,12060,15358,12522,18563,15923,14905,14808,23872,3863,-453,2286,5309
"1647","Greenwich 017B","E01001683","E02000329","Greenwich 017","E09000011","Greenwich","E12000007","London",1519,1508,11,114,565,2.7,"00AL","Greenwich",NA,8004,8473,8398,13324,12058,8498,9442,17017,4054,25,1044,3693
"1648","Greenwich 017C","E01001684","E02000329","Greenwich 017","E09000011","Greenwich","E12000007","London",1472,1472,0,12.4,561,2.6,"00AL","Greenwich",NA,6789,7662,8048,5006,11664,9282,8960,11312,4875,1620,912,6306
"1649","Greenwich 017D","E01001685","E02000329","Greenwich 017","E09000011","Greenwich","E12000007","London",1522,1522,0,83.9,610,2.5,"00AL","Greenwich",NA,10483,11382,12484,11706,15892,12536,17371,17007,5409,1154,4887,5301
"1658","Greenwich 020E","E01001686","E02000332","Greenwich 020","E09000011","Greenwich","E12000007","London",1777,1770,7,104.6,767,2.3,"00AL","Greenwich",NA,5927,5391,5803,18504,11712,8784,11556,23322,5785,3393,5753,4818
"1580","Greenwich 002A","E01001687","E02000314","Greenwich 002","E09000011","Greenwich","E12000007","London",1206,1206,0,29,511,2.4,"00AL","Greenwich",NA,4846,6977,8851,7990,5218,6559,5994,14526,372,-418,-2857,6536
"1581","Greenwich 002B","E01001688","E02000314","Greenwich 002","E09000011","Greenwich","E12000007","London",2623,2500,123,73.9,937,2.7,"00AL","Greenwich",NA,11548,9349,19776,15676,8321,7737,12786,22396,-3227,-1612,-6990,6720
"1576","Greenwich 001A","E01001690","E02000313","Greenwich 001","E09000011","Greenwich","E12000007","London",1932,1931,1,141.6,845,2.3,"00AL","Greenwich",NA,2311,3450,3246,4119,8059,5923,6360,12251,5748,2473,3114,8132
"1577","Greenwich 001B","E01001692","E02000313","Greenwich 001","E09000011","Greenwich","E12000007","London",1391,1391,0,187.2,522,2.7,"00AL","Greenwich",NA,4691,3645,6895,7105,5447,3643,5386,10739,756,-2,-1509,3634
"1578","Greenwich 001C","E01001693","E02000313","Greenwich 001","E09000011","Greenwich","E12000007","London",1558,1558,0,114.3,610,2.6,"00AL","Greenwich",NA,2244,1984,4214,6234,4032,2472,4726,8347,1788,488,512,2113
"1579","Greenwich 001D","E01001694","E02000313","Greenwich 001","E09000011","Greenwich","E12000007","London",1685,1683,2,43.9,598,2.8,"00AL","Greenwich",NA,6043,8609,8223,9627,10470,8515,11190,18586,4427,-94,2967,8959
"1624","Greenwich 011A","E01001695","E02000323","Greenwich 011","E09000011","Greenwich","E12000007","London",1626,1626,0,162.4,654,2.5,"00AL","Greenwich",NA,2609,2746,2708,9234,4597,3921,5717,11391,1988,1175,3009,2157
"1625","Greenwich 011B","E01001696","E02000323","Greenwich 011","E09000011","Greenwich","E12000007","London",1350,1350,0,95.7,506,2.7,"00AL","Greenwich",NA,1615,1585,2954,6171,4135,4110,6425,7560,2520,2525,3471,1389
"1626","Greenwich 011C","E01001697","E02000323","Greenwich 011","E09000011","Greenwich","E12000007","London",2094,2094,0,137.7,770,2.7,"00AL","Greenwich",NA,3547,3548,4767,10173,7183,6189,7868,10595,3636,2641,3101,422
"1638","Greenwich 015A","E01001698","E02000327","Greenwich 015","E09000011","Greenwich","E12000007","London",1777,1774,3,138.1,682,2.6,"00AL","Greenwich",NA,2941,1356,3903,9614,5681,3058,5489,13381,2740,1702,1586,3767
"1639","Greenwich 015B","E01001699","E02000327","Greenwich 015","E09000011","Greenwich","E12000007","London",1848,1466,382,26.9,602,2.4,"00AL","Greenwich",NA,5992,5200,10152,11668,10939,11372,15340,10833,4947,6172,5188,-835
"1627","Greenwich 011D","E01001700","E02000323","Greenwich 011","E09000011","Greenwich","E12000007","London",2019,2009,10,140.8,703,2.9,"00AL","Greenwich",NA,3380,2415,5389,10034,6482,5858,9499,12505,3102,3443,4110,2471
"1640","Greenwich 015C","E01001701","E02000327","Greenwich 015","E09000011","Greenwich","E12000007","London",1524,1520,4,15.9,598,2.5,"00AL","Greenwich",NA,7007,9962,9518,9407,9299,8867,11017,18068,2292,-1095,1499,8661
"1641","Greenwich 015D","E01001702","E02000327","Greenwich 015","E09000011","Greenwich","E12000007","London",1676,1676,0,197.6,475,3.5,"00AL","Greenwich",NA,1600,468,3445,3786,4791,2093,5267,9030,3191,1625,1822,5244
"1628","Greenwich 011E","E01001703","E02000323","Greenwich 011","E09000011","Greenwich","E12000007","London",1934,1934,0,227.5,753,2.6,"00AL","Greenwich",NA,999,682,1463,7559,5181,2637,5911,17226,4182,1955,4448,9667
"1629","Greenwich 011F","E01001704","E02000323","Greenwich 011","E09000011","Greenwich","E12000007","London",1651,1618,33,118.1,615,2.6,"00AL","Greenwich",NA,7898,7438,6837,17257,11660,9138,10044,18438,3762,1700,3207,1181
"1600","Greenwich 005A","E01001705","E02000317","Greenwich 005","E09000011","Greenwich","E12000007","London",1993,1993,0,113.2,760,2.6,"00AL","Greenwich",NA,2668,1497,3618,4985,5873,4133,5349,11183,3205,2636,1731,6198
"1601","Greenwich 005B","E01001706","E02000317","Greenwich 005","E09000011","Greenwich","E12000007","London",1340,1321,19,119.5,479,2.8,"00AL","Greenwich",NA,1863,1240,2603,8972,3379,2649,3781,9359,1516,1409,1178,387
"1602","Greenwich 005C","E01001708","E02000317","Greenwich 005","E09000011","Greenwich","E12000007","London",1595,1595,0,90,640,2.5,"00AL","Greenwich",NA,8593,9872,9280,18375,13996,12341,12548,22721,5403,2469,3268,4346
"1592","Greenwich 004B","E01001709","E02000316","Greenwich 004","E09000011","Greenwich","E12000007","London",1170,1170,0,15.1,494,2.4,"00AL","Greenwich",NA,3551,3283,3507,7116,3463,2675,4894,8945,-88,-608,1387,1829
"1603","Greenwich 005D","E01001710","E02000317","Greenwich 005","E09000011","Greenwich","E12000007","London",1694,1694,0,197,685,2.5,"00AL","Greenwich",NA,1638,836,2667,7838,4643,2490,4081,10232,3005,1654,1414,2394
"1593","Greenwich 004C","E01001711","E02000316","Greenwich 004","E09000011","Greenwich","E12000007","London",1413,1413,0,81.2,612,2.3,"00AL","Greenwich",NA,9863,11426,17844,13885,10144,10323,16288,20378,281,-1103,-1556,6493
"1594","Greenwich 004D","E01001712","E02000316","Greenwich 004","E09000011","Greenwich","E12000007","London",2137,2085,52,128,935,2.2,"00AL","Greenwich",NA,757,2053,1258,5340,5763,4922,6323,15635,5006,2869,5065,10295
"1604","Greenwich 005E","E01001713","E02000317","Greenwich 005","E09000011","Greenwich","E12000007","London",1748,1690,58,172.2,636,2.7,"00AL","Greenwich",NA,1237,1116,2053,7735,4356,2677,4448,12103,3119,1561,2395,4368
"1732","Hackney 002A","E01001714","E02000346","Hackney 002","E09000012","Hackney","E12000007","London",1490,1468,22,99.1,632,2.3,"00AM","Hackney",NA,1769,1946,2872,14313,1725,1874,2112,10896,-44,-72,-760,-3417
"1751","Hackney 007A","E01001715","E02000351","Hackney 007","E09000012","Hackney","E12000007","London",1321,1316,5,172.7,673,2,"00AM","Hackney",NA,5973,8599,7588,18863,8233,13459,13743,26125,2260,4860,6155,7262
"1752","Hackney 007B","E01001716","E02000351","Hackney 007","E09000012","Hackney","E12000007","London",1318,1260,58,164.1,633,2,"00AM","Hackney",NA,741,1192,1519,13956,5126,5119,7370,25071,4385,3927,5851,11115
"1753","Hackney 007C","E01001717","E02000351","Hackney 007","E09000012","Hackney","E12000007","London",1222,1222,0,125.1,427,2.9,"00AM","Hackney",NA,7558,5088,11665,19892,9826,8966,11140,20703,2268,3878,-525,811
"1754","Hackney 007D","E01001718","E02000351","Hackney 007","E09000012","Hackney","E12000007","London",1787,1787,0,172,824,2.2,"00AM","Hackney",NA,7224,10281,12072,26611,14432,22476,27363,24489,7208,12195,15291,-2122
"1755","Hackney 007E","E01001719","E02000351","Hackney 007","E09000012","Hackney","E12000007","London",1139,1136,3,179.1,484,2.3,"00AM","Hackney",NA,3952,3881,7131,9277,6112,4020,7458,21332,2160,139,327,12055
"1756","Hackney 007F","E01001720","E02000351","Hackney 007","E09000012","Hackney","E12000007","London",1736,1720,16,172.4,785,2.2,"00AM","Hackney",NA,9124,11672,12211,24069,13892,15539,22734,24807,4768,3867,10523,738
"1867","Hackney 029A","E01001722","E02006921","Hackney 029","E09000012","Hackney","E12000007","London",2028,2028,0,191.7,860,2.4,"00AM","Hackney",NA,2784,1928,4020,12221,5874,4911,6390,15485,3090,2983,2370,3264
"1746","Hackney 006A","E01001723","E02000350","Hackney 006","E09000012","Hackney","E12000007","London",1944,1944,0,164.5,671,2.9,"00AM","Hackney",NA,6916,4466,12523,22522,11255,12600,18569,19179,4339,8134,6046,-3343
"1747","Hackney 006B","E01001724","E02000350","Hackney 006","E09000012","Hackney","E12000007","London",2219,2219,0,190.5,980,2.3,"00AM","Hackney",NA,4815,4873,12181,22266,10510,11793,16981,21160,5695,6920,4800,-1106
"1741","Hackney 004A","E01001725","E02000348","Hackney 004","E09000012","Hackney","E12000007","London",1909,1909,0,202,573,3.3,"00AM","Hackney",NA,3429,420,7915,15169,8603,9836,11765,9794,5174,9416,3850,-5375
"1742","Hackney 004B","E01001726","E02000348","Hackney 004","E09000012","Hackney","E12000007","London",1357,1357,0,267.7,464,2.9,"00AM","Hackney",NA,2920,1395,6840,12430,5839,4392,8272,8019,2919,2997,1432,-4411
"1748","Hackney 006C","E01001727","E02000350","Hackney 006","E09000012","Hackney","E12000007","London",1920,1911,9,179.9,573,3.3,"00AM","Hackney",NA,6182,1726,13996,20497,12331,13013,15216,13027,6149,11287,1220,-7470
"1868","Hackney 029B","E01001728","E02006921","Hackney 029","E09000012","Hackney","E12000007","London",2015,2015,0,220.5,627,3.2,"00AM","Hackney",NA,3233,698,12357,10589,7367,6469,12536,4720,4134,5771,179,-5869
"1809","Hackney 019A","E01001729","E02000363","Hackney 019","E09000012","Hackney","E12000007","London",2021,2021,0,158.4,863,2.3,"00AM","Hackney",NA,622,513,318,8339,2673,1858,3837,11796,2051,1345,3519,3457
"1810","Hackney 019B","E01001730","E02000363","Hackney 019","E09000012","Hackney","E12000007","London",1921,1921,0,147,801,2.4,"00AM","Hackney",NA,936,407,2042,12277,1507,865,2299,8362,571,458,257,-3915
"1801","Hackney 017A","E01001731","E02000361","Hackney 017","E09000012","Hackney","E12000007","London",2300,2299,1,132.6,1033,2.2,"00AM","Hackney",NA,2769,4117,5619,14759,5973,6105,9717,19428,3204,1988,4098,4669
"1811","Hackney 019C","E01001732","E02000363","Hackney 019","E09000012","Hackney","E12000007","London",1715,1715,0,265.1,696,2.5,"00AM","Hackney",NA,2206,1091,3918,10728,2694,1471,4009,9501,488,380,91,-1227
"1791","Hackney 015A","E01001733","E02000359","Hackney 015","E09000012","Hackney","E12000007","London",1822,1815,7,125.4,701,2.6,"00AM","Hackney",NA,5743,4890,8980,19673,6632,9074,11543,23948,889,4184,2563,4275
"1802","Hackney 017B","E01001734","E02000361","Hackney 017","E09000012","Hackney","E12000007","London",1821,1814,7,135.6,849,2.1,"00AM","Hackney",NA,1486,2365,3420,16044,4796,5831,10013,21472,3310,3466,6593,5428
"1812","Hackney 019D","E01001735","E02000363","Hackney 019","E09000012","Hackney","E12000007","London",1632,1632,0,122.3,661,2.5,"00AM","Hackney",NA,3601,3026,5230,17141,5091,5366,8857,16070,1490,2340,3627,-1071
"1777","Hackney 012A","E01001736","E02000356","Hackney 012","E09000012","Hackney","E12000007","London",1656,1656,0,184.6,707,2.3,"00AM","Hackney",NA,7818,7350,10322,22836,12239,13274,14133,28353,4421,5924,3811,5517
"1778","Hackney 012B","E01001737","E02000356","Hackney 012","E09000012","Hackney","E12000007","London",1842,1838,4,183.8,754,2.4,"00AM","Hackney",NA,9105,10124,13591,19293,13187,13086,16638,29351,4082,2962,3047,10058
"1779","Hackney 012C","E01001738","E02000356","Hackney 012","E09000012","Hackney","E12000007","London",1758,1755,3,193,785,2.2,"00AM","Hackney",NA,5159,7218,7334,24948,12920,13390,13756,26170,7761,6172,6422,1222
"1780","Hackney 012D","E01001739","E02000356","Hackney 012","E09000012","Hackney","E12000007","London",2090,2039,51,171.3,898,2.3,"00AM","Hackney",NA,5838,7990,6710,26226,11548,12963,12656,29375,5710,4973,5946,3149
"1785","Hackney 014A","E01001740","E02000358","Hackney 014","E09000012","Hackney","E12000007","London",1566,1566,0,181,624,2.5,"00AM","Hackney",NA,2288,1670,4122,9172,2377,1742,3831,8765,89,72,-291,-407
"1761","Hackney 009A","E01001741","E02000353","Hackney 009","E09000012","Hackney","E12000007","London",1490,1490,0,171.5,599,2.5,"00AM","Hackney",NA,8484,12258,16055,20970,17716,17330,21668,30333,9232,5072,5613,9363
"1757","Hackney 008A","E01001742","E02000352","Hackney 008","E09000012","Hackney","E12000007","London",1810,1810,0,144.7,789,2.3,"00AM","Hackney",NA,4064,4469,6885,17144,7900,6950,9437,18208,3836,2481,2552,1064
"1820","Hackney 021B","E01001744","E02000365","Hackney 021","E09000012","Hackney","E12000007","London",1879,1879,0,139,786,2.4,"00AM","Hackney",NA,2888,2906,5186,20319,6079,6262,9300,23571,3191,3356,4114,3252
"1795","Hackney 016A","E01001745","E02000360","Hackney 016","E09000012","Hackney","E12000007","London",2249,2249,0,200.4,958,2.3,"00AM","Hackney",NA,1103,510,2440,11581,4610,3003,6775,16256,3507,2493,4335,4675
"1796","Hackney 016B","E01001746","E02000360","Hackney 016","E09000012","Hackney","E12000007","London",1656,1656,0,337.3,632,2.6,"00AM","Hackney",NA,3424,1160,6916,13370,5094,2780,7194,9379,1670,1620,278,-3991
"1786","Hackney 014B","E01001747","E02000358","Hackney 014","E09000012","Hackney","E12000007","London",2137,2137,0,150.2,943,2.3,"00AM","Hackney",NA,4246,3781,6484,16754,6712,8803,13166,21640,2466,5022,6682,4886
"1815","Hackney 020A","E01001748","E02000364","Hackney 020","E09000012","Hackney","E12000007","London",2306,2287,19,130.4,1090,2.1,"00AM","Hackney",NA,1625,2622,1705,20658,6531,8034,9592,23712,4906,5412,7887,3054
"1816","Hackney 020B","E01001749","E02000364","Hackney 020","E09000012","Hackney","E12000007","London",1717,1717,0,161.2,743,2.3,"00AM","Hackney",NA,5842,4801,9411,24082,8811,11152,11629,28879,2969,6351,2218,4797
"1821","Hackney 021C","E01001750","E02000365","Hackney 021","E09000012","Hackney","E12000007","London",1838,1838,0,126.1,782,2.4,"00AM","Hackney",NA,2457,2487,4887,15021,5442,6187,10674,19832,2985,3700,5787,4811
"1822","Hackney 021D","E01001751","E02000365","Hackney 021","E09000012","Hackney","E12000007","London",1547,1547,0,100.7,676,2.3,"00AM","Hackney",NA,12183,19097,20330,27228,17052,22995,27021,31164,4869,3898,6691,3936
"1845","Hackney 025A","E01001752","E02000369","Hackney 025","E09000012","Hackney","E12000007","London",2307,2307,0,180.5,1060,2.2,"00AM","Hackney",NA,2246,1797,5608,12036,9288,9173,16187,23225,7042,7376,10579,11189
"1846","Hackney 025B","E01001753","E02000369","Hackney 025","E09000012","Hackney","E12000007","London",1629,1629,0,218.1,687,2.4,"00AM","Hackney",NA,2178,2005,3575,10656,3815,3536,6361,12342,1637,1531,2786,1686
"1847","Hackney 025C","E01001754","E02000369","Hackney 025","E09000012","Hackney","E12000007","London",2379,2379,0,194.5,1135,2.1,"00AM","Hackney",NA,2618,2890,5125,16202,5907,6119,12004,21387,3289,3229,6879,5185
"1848","Hackney 025D","E01001755","E02000369","Hackney 025","E09000012","Hackney","E12000007","London",1788,1754,34,175.6,724,2.4,"00AM","Hackney",NA,2464,2555,5348,13337,4366,3453,5617,14734,1902,898,269,1397
"1823","Hackney 021E","E01001756","E02000365","Hackney 021","E09000012","Hackney","E12000007","London",2155,2155,0,132.9,987,2.2,"00AM","Hackney",NA,5060,8449,11388,21835,11425,17196,18922,24701,6365,8747,7534,2866
"1797","Hackney 016C","E01001757","E02000360","Hackney 016","E09000012","Hackney","E12000007","London",1717,1717,0,344.8,654,2.6,"00AM","Hackney",NA,2778,1841,5367,10078,5925,3611,8762,15638,3147,1770,3395,5560
"1798","Hackney 016D","E01001758","E02000360","Hackney 016","E09000012","Hackney","E12000007","London",2087,2087,0,167.1,884,2.4,"00AM","Hackney",NA,1842,983,3560,12170,4734,3632,8568,13745,2892,2649,5008,1575
"1799","Hackney 016E","E01001759","E02000360","Hackney 016","E09000012","Hackney","E12000007","London",1804,1804,0,175,750,2.4,"00AM","Hackney",NA,3975,3297,5223,12020,8185,6583,10915,20305,4210,3286,5692,8285
"1803","Hackney 017C","E01001760","E02000361","Hackney 017","E09000012","Hackney","E12000007","London",1754,1754,0,121.6,765,2.3,"00AM","Hackney",NA,2014,2342,3757,12902,3770,5397,7623,16313,1756,3055,3866,3411
"1800","Hackney 016F","E01001761","E02000360","Hackney 016","E09000012","Hackney","E12000007","London",1779,1779,0,166,869,2,"00AM","Hackney",NA,1044,1188,895,14871,3293,2600,4079,22978,2249,1412,3184,8107
"1804","Hackney 017D","E01001762","E02000361","Hackney 017","E09000012","Hackney","E12000007","London",1765,1765,0,124,820,2.2,"00AM","Hackney",NA,4432,3983,6107,19092,8883,10128,12358,20941,4451,6145,6251,1849
"1817","Hackney 020C","E01001763","E02000364","Hackney 020","E09000012","Hackney","E12000007","London",1642,1642,0,151.2,742,2.2,"00AM","Hackney",NA,5668,6003,6220,15007,9095,9447,12134,22008,3427,3444,5914,7001
"1766","Hackney 010A","E01001764","E02000354","Hackney 010","E09000012","Hackney","E12000007","London",1688,1688,0,160.6,696,2.4,"00AM","Hackney",NA,2944,2517,5260,11034,8708,6994,10152,17463,5764,4477,4892,6429
"1767","Hackney 010B","E01001765","E02000354","Hackney 010","E09000012","Hackney","E12000007","London",1717,1717,0,136.6,722,2.4,"00AM","Hackney",NA,895,624,955,11809,2058,941,3545,6821,1163,317,2590,-4988
"1768","Hackney 010D","E01001767","E02000354","Hackney 010","E09000012","Hackney","E12000007","London",1603,1593,10,151.4,628,2.5,"00AM","Hackney",NA,4265,3662,4927,20452,5998,6397,8598,19312,1733,2735,3671,-1140
"1749","Hackney 006D","E01001768","E02000350","Hackney 006","E09000012","Hackney","E12000007","London",1825,1819,6,179.4,719,2.5,"00AM","Hackney",NA,6733,6495,9014,16264,9800,9850,11996,27627,3067,3355,2982,11363
"1750","Hackney 006E","E01001769","E02000350","Hackney 006","E09000012","Hackney","E12000007","London",1594,1581,13,129.1,662,2.4,"00AM","Hackney",NA,5347,4946,8588,19711,9375,10528,12633,24622,4028,5582,4045,4911
"1769","Hackney 010E","E01001770","E02000354","Hackney 010","E09000012","Hackney","E12000007","London",1738,1732,6,134.2,784,2.2,"00AM","Hackney",NA,1081,990,1823,12679,4777,4439,7516,12401,3696,3449,5693,-278
"1839","Hackney 024A","E01001772","E02000368","Hackney 024","E09000012","Hackney","E12000007","London",1046,1046,0,159.5,459,2.3,"00AM","Hackney",NA,2333,1239,5455,15853,2108,1163,3662,11296,-225,-76,-1793,-4557
"1849","Hackney 025E","E01001773","E02000369","Hackney 025","E09000012","Hackney","E12000007","London",2052,2052,0,168.1,860,2.4,"00AM","Hackney",NA,1689,1335,4466,10144,4820,4211,6678,19336,3131,2876,2212,9192
"1840","Hackney 024B","E01001774","E02000368","Hackney 024","E09000012","Hackney","E12000007","London",2095,2082,13,116.6,875,2.4,"00AM","Hackney",NA,3949,2675,8643,13273,7615,5792,12778,24397,3666,3117,4135,11124
"1841","Hackney 024C","E01001775","E02000368","Hackney 024","E09000012","Hackney","E12000007","London",1776,1776,0,140.1,759,2.3,"00AM","Hackney",NA,1140,565,2043,9095,3983,3351,5449,16294,2843,2786,3406,7199
"1850","Hackney 025F","E01001776","E02000369","Hackney 025","E09000012","Hackney","E12000007","London",1439,1439,0,141.6,634,2.3,"00AM","Hackney",NA,836,1570,886,7916,3667,3674,3797,14409,2831,2104,2911,6493
"1855","Hackney 027B","E01001777","E02000371","Hackney 027","E09000012","Hackney","E12000007","London",2358,2358,0,152.7,1043,2.3,"00AM","Hackney",NA,2319,2777,3630,12980,6474,7898,10455,20778,4155,5121,6825,7798
"1851","Hackney 026A","E01001779","E02000370","Hackney 026","E09000012","Hackney","E12000007","London",2437,2428,9,175.8,1121,2.2,"00AM","Hackney",NA,2945,2039,5450,13861,8460,6470,10717,20696,5515,4431,5267,6835
"1856","Hackney 027D","E01001780","E02000371","Hackney 027","E09000012","Hackney","E12000007","London",1825,1825,0,166.4,916,2,"00AM","Hackney",NA,1344,2028,3161,16287,4076,5396,6895,15504,2732,3368,3734,-783
"1852","Hackney 026B","E01001781","E02000370","Hackney 026","E09000012","Hackney","E12000007","London",1667,1667,0,110.2,731,2.3,"00AM","Hackney",NA,1126,895,3071,9519,1712,2020,3676,7478,586,1125,605,-2041
"1853","Hackney 026C","E01001782","E02000370","Hackney 026","E09000012","Hackney","E12000007","London",2300,2300,0,168.3,1053,2.2,"00AM","Hackney",NA,7066,5137,11165,17388,13420,10885,17033,23284,6354,5748,5868,5896
"1854","Hackney 026D","E01001783","E02000370","Hackney 026","E09000012","Hackney","E12000007","London",1897,1897,0,309,863,2.2,"00AM","Hackney",NA,451,804,976,9948,3593,3951,5209,12944,3142,3147,4233,2996
"1857","Hackney 027E","E01001784","E02000371","Hackney 027","E09000012","Hackney","E12000007","London",2273,1869,404,299.1,797,2.3,"00AM","Hackney",NA,2060,2270,3751,15997,8419,8483,15634,18367,6359,6213,11883,2370
"1792","Hackney 015B","E01001785","E02000359","Hackney 015","E09000012","Hackney","E12000007","London",1486,1486,0,164,569,2.6,"00AM","Hackney",NA,3912,3412,5800,12129,6217,6144,9955,21567,2305,2732,4155,9438
"1781","Hackney 013A","E01001786","E02000357","Hackney 013","E09000012","Hackney","E12000007","London",1825,1825,0,16.1,717,2.5,"00AM","Hackney",NA,4772,3696,7269,13534,1991,788,2590,10604,-2781,-2908,-4679,-2930
"1782","Hackney 013B","E01001787","E02000357","Hackney 013","E09000012","Hackney","E12000007","London",1589,1589,0,71.5,628,2.5,"00AM","Hackney",NA,2056,688,2181,9192,1863,769,3160,8483,-193,81,979,-709
"1783","Hackney 013C","E01001788","E02000357","Hackney 013","E09000012","Hackney","E12000007","London",1582,1582,0,138.2,670,2.4,"00AM","Hackney",NA,1665,1159,2058,9581,2309,1306,2487,9827,644,147,429,246
"1793","Hackney 015C","E01001789","E02000359","Hackney 015","E09000012","Hackney","E12000007","London",1739,1739,0,179.8,646,2.7,"00AM","Hackney",NA,3980,1808,5732,19991,7658,5424,7616,22187,3678,3616,1884,2196
"1784","Hackney 013D","E01001790","E02000357","Hackney 013","E09000012","Hackney","E12000007","London",1343,1343,0,243.7,492,2.7,"00AM","Hackney",NA,2723,1452,3372,10571,2961,1532,3129,14171,238,80,-243,3600
"1794","Hackney 015D","E01001791","E02000359","Hackney 015","E09000012","Hackney","E12000007","London",1534,1529,5,147.4,500,3.1,"00AM","Hackney",NA,3149,1828,6490,12313,5580,4227,8204,16591,2431,2399,1714,4278
"1772","Hackney 011A","E01001792","E02000355","Hackney 011","E09000012","Hackney","E12000007","London",1780,1735,45,101.5,620,2.8,"00AM","Hackney",NA,3370,2827,3875,23856,5996,5624,8571,19219,2626,2797,4696,-4637
"1773","Hackney 011B","E01001793","E02000355","Hackney 011","E09000012","Hackney","E12000007","London",1685,1685,0,105.2,656,2.6,"00AM","Hackney",NA,5063,5997,7560,18950,9360,8731,9757,23765,4297,2734,2197,4815
"1774","Hackney 011C","E01001794","E02000355","Hackney 011","E09000012","Hackney","E12000007","London",1909,1794,115,149.7,656,2.7,"00AM","Hackney",NA,4648,4909,6310,22846,7610,9177,12230,24968,2962,4268,5920,2122
"1775","Hackney 011D","E01001795","E02000355","Hackney 011","E09000012","Hackney","E12000007","London",1464,1464,0,144.2,571,2.6,"00AM","Hackney",NA,5588,5760,10781,16647,6387,9258,9574,25678,799,3498,-1207,9031
"1776","Hackney 011E","E01001796","E02000355","Hackney 011","E09000012","Hackney","E12000007","London",1647,1647,0,179.4,737,2.2,"00AM","Hackney",NA,5044,6587,6177,22613,6325,10049,10537,16933,1281,3462,4360,-5680
"1862","Hackney 028A","E01001798","E02006918","Hackney 028","E09000012","Hackney","E12000007","London",1785,1785,0,169.8,694,2.6,"00AM","Hackney",NA,2429,1711,3546,11768,2835,2038,4261,14428,406,327,715,2660
"1736","Hackney 003A","E01001799","E02000347","Hackney 003","E09000012","Hackney","E12000007","London",1582,1582,0,149.2,485,3.3,"00AM","Hackney",NA,5528,1252,16199,9490,9746,12192,16230,6131,4218,10940,31,-3359
"1743","Hackney 004C","E01001800","E02000348","Hackney 004","E09000012","Hackney","E12000007","London",1597,1596,1,188.3,643,2.5,"00AM","Hackney",NA,1457,444,3248,12046,4158,4604,5118,5571,2701,4160,1870,-6475
"1758","Hackney 008B","E01001801","E02000352","Hackney 008","E09000012","Hackney","E12000007","London",1664,1614,50,112.6,588,2.7,"00AM","Hackney",NA,3592,917,11406,22623,6865,6924,11575,15076,3273,6007,169,-7547
"1737","Hackney 003B","E01001802","E02000347","Hackney 003","E09000012","Hackney","E12000007","London",1294,1240,54,123.5,471,2.6,"00AM","Hackney",NA,3200,826,8799,17085,5525,5760,7480,12879,2325,4934,-1319,-4206
"1759","Hackney 008C","E01001803","E02000352","Hackney 008","E09000012","Hackney","E12000007","London",1863,1863,0,113.6,719,2.6,"00AM","Hackney",NA,8551,9480,13600,28846,15793,16061,19307,27494,7242,6581,5707,-1352
"1738","Hackney 003C","E01001804","E02000347","Hackney 003","E09000012","Hackney","E12000007","London",1528,1512,16,137.9,464,3.3,"00AM","Hackney",NA,2590,250,9300,9409,8217,10430,11278,7779,5627,10180,1978,-1630
"1762","Hackney 009B","E01001805","E02000353","Hackney 009","E09000012","Hackney","E12000007","London",1206,1206,0,81.8,510,2.4,"00AM","Hackney",NA,5516,8575,12595,23224,9001,11240,14814,30404,3485,2665,2219,7180
"1760","Hackney 008D","E01001806","E02000352","Hackney 008","E09000012","Hackney","E12000007","London",1546,1546,0,47.5,714,2.2,"00AM","Hackney",NA,2530,2333,4508,18344,6918,6726,7832,23440,4388,4393,3324,5096
"1739","Hackney 003D","E01001807","E02000347","Hackney 003","E09000012","Hackney","E12000007","London",1806,1804,2,154.1,693,2.6,"00AM","Hackney",NA,3537,1281,4919,21204,7878,8030,11707,15995,4341,6749,6788,-5209
"1727","Hackney 001A","E01001808","E02000345","Hackney 001","E09000012","Hackney","E12000007","London",1838,1838,0,144.7,558,3.3,"00AM","Hackney",NA,3283,825,17755,6787,7908,15116,23133,4018,4625,14291,5378,-2769
"1728","Hackney 001B","E01001809","E02000345","Hackney 001","E09000012","Hackney","E12000007","London",1977,1969,8,173.3,610,3.2,"00AM","Hackney",NA,3137,919,10985,14358,8780,13986,19005,6074,5643,13067,8020,-8284
"1733","Hackney 002D","E01001811","E02000346","Hackney 002","E09000012","Hackney","E12000007","London",1503,1494,9,177.2,646,2.3,"00AM","Hackney",NA,1184,674,2774,7432,2380,1429,4570,5219,1196,755,1796,-2213
"1740","Hackney 003E","E01001812","E02000347","Hackney 003","E09000012","Hackney","E12000007","London",1746,1746,0,70.7,614,2.8,"00AM","Hackney",NA,1840,244,3818,17560,5972,6989,8643,7913,4132,6745,4825,-9647
"1734","Hackney 002E","E01001813","E02000346","Hackney 002","E09000012","Hackney","E12000007","London",1250,1241,9,127.8,525,2.4,"00AM","Hackney",NA,1026,1176,2270,9240,1916,2085,3612,7384,890,909,1342,-1856
"1729","Hackney 001C","E01001814","E02000345","Hackney 001","E09000012","Hackney","E12000007","London",1660,1658,2,145.6,559,3,"00AM","Hackney",NA,3848,2581,10798,9763,9486,11938,13309,15034,5638,9357,2511,5271
"1842","Hackney 024D","E01001815","E02000368","Hackney 024","E09000012","Hackney","E12000007","London",1774,1774,0,162.8,692,2.6,"00AM","Hackney",NA,1535,821,1426,13065,4251,3611,4747,14065,2716,2790,3321,1000
"1818","Hackney 020D","E01001816","E02000364","Hackney 020","E09000012","Hackney","E12000007","London",1625,1625,0,119.2,640,2.5,"00AM","Hackney",NA,4267,5011,7426,18960,9287,8562,11999,23223,5020,3551,4573,4263
"1819","Hackney 020E","E01001819","E02000364","Hackney 020","E09000012","Hackney","E12000007","London",1577,1577,0,116,684,2.3,"00AM","Hackney",NA,4543,3673,4688,23196,8495,8613,8457,28812,3952,4940,3769,5616
"1843","Hackney 024E","E01001820","E02000368","Hackney 024","E09000012","Hackney","E12000007","London",1463,1463,0,172.5,599,2.4,"00AM","Hackney",NA,1825,1453,2198,9218,4954,4022,4431,11903,3129,2569,2233,2685
"1844","Hackney 024F","E01001821","E02000368","Hackney 024","E09000012","Hackney","E12000007","London",1460,1460,0,212.5,644,2.3,"00AM","Hackney",NA,1564,1294,2384,11339,2981,2123,3499,11301,1417,829,1115,-38
"1869","Hackney 029C","E01001822","E02006921","Hackney 029","E09000012","Hackney","E12000007","London",1785,1780,5,212.5,706,2.5,"00AM","Hackney",NA,2074,812,3099,10584,2471,1549,3178,5325,397,737,79,-5259
"1730","Hackney 001D","E01001823","E02000345","Hackney 001","E09000012","Hackney","E12000007","London",1765,1765,0,117,538,3.3,"00AM","Hackney",NA,6210,2226,12235,13310,8023,6794,10318,6293,1813,4568,-1917,-7017
"1744","Hackney 004D","E01001824","E02000348","Hackney 004","E09000012","Hackney","E12000007","London",1517,1517,0,70.3,539,2.8,"00AM","Hackney",NA,2614,1243,5026,7682,5393,5481,8900,6348,2779,4238,3874,-1334
"1731","Hackney 001E","E01001825","E02000345","Hackney 001","E09000012","Hackney","E12000007","London",1598,1598,0,150.5,428,3.7,"00AM","Hackney",NA,5666,1350,19890,6829,9305,15841,17097,1238,3639,14491,-2793,-5591
"1745","Hackney 004E","E01001826","E02000348","Hackney 004","E09000012","Hackney","E12000007","London",1740,1728,12,154.3,585,3,"00AM","Hackney",NA,1654,523,3621,10768,6103,6983,7989,5122,4449,6460,4368,-5646
"1870","Hackney 029D","E01001827","E02006921","Hackney 029","E09000012","Hackney","E12000007","London",1916,1916,0,111.7,716,2.7,"00AM","Hackney",NA,1889,626,3294,9290,3795,3879,4602,3444,1906,3253,1308,-5846
"1863","Hackney 028B","E01001828","E02006918","Hackney 028","E09000012","Hackney","E12000007","London",2057,2057,0,185,831,2.5,"00AM","Hackney",NA,3662,2259,4243,18040,3991,2408,4982,14465,329,149,739,-3575
"1763","Hackney 009C","E01001829","E02000353","Hackney 009","E09000012","Hackney","E12000007","London",1794,1794,0,160.8,696,2.6,"00AM","Hackney",NA,10167,13622,15637,30730,15629,17611,22541,30168,5462,3989,6904,-562
"1787","Hackney 014C","E01001830","E02000358","Hackney 014","E09000012","Hackney","E12000007","London",1904,1904,0,184.5,932,2,"00AM","Hackney",NA,2907,3156,3026,18175,5199,5539,6967,14242,2292,2383,3941,-3933
"1764","Hackney 009D","E01001831","E02000353","Hackney 009","E09000012","Hackney","E12000007","London",1677,1677,0,151.5,745,2.3,"00AM","Hackney",NA,4376,4882,9566,15616,7498,10096,13404,28864,3122,5214,3838,13248
"1765","Hackney 009E","E01001832","E02000353","Hackney 009","E09000012","Hackney","E12000007","London",1619,1607,12,158.7,642,2.5,"00AM","Hackney",NA,4126,4253,5320,19022,9593,11161,14025,24709,5467,6908,8705,5687
"1788","Hackney 014D","E01001833","E02000358","Hackney 014","E09000012","Hackney","E12000007","London",2143,2132,11,184.6,931,2.3,"00AM","Hackney",NA,3187,2845,3625,18718,6448,5742,8451,18236,3261,2897,4826,-482
"1789","Hackney 014E","E01001834","E02000358","Hackney 014","E09000012","Hackney","E12000007","London",2059,2059,0,216.5,862,2.4,"00AM","Hackney",NA,3939,3635,4564,17615,7450,7145,12014,24760,3511,3510,7450,7145
"1790","Hackney 014F","E01001835","E02000358","Hackney 014","E09000012","Hackney","E12000007","London",1249,1249,0,170.6,483,2.6,"00AM","Hackney",NA,9438,10278,11152,23297,12536,14031,17455,30664,3098,3753,6303,7367
"1828","Hackney 022A","E01001836","E02000366","Hackney 022","E09000012","Hackney","E12000007","London",1866,1866,0,141.6,857,2.2,"00AM","Hackney",NA,3181,3451,4104,16251,8024,7609,9872,19896,4843,4158,5768,3645
"1833","Hackney 023B","E01001837","E02000367","Hackney 023","E09000012","Hackney","E12000007","London",1488,1478,10,133.6,665,2.2,"00AM","Hackney",NA,9781,12261,17104,28507,15321,18709,26222,29282,5540,6448,9118,775
"1813","Hackney 019E","E01001838","E02000363","Hackney 019","E09000012","Hackney","E12000007","London",1746,1746,0,253.4,705,2.5,"00AM","Hackney",NA,1326,473,2318,7944,2089,1100,2906,9072,763,627,588,1128
"1834","Hackney 023C","E01001839","E02000367","Hackney 023","E09000012","Hackney","E12000007","London",2211,2102,109,205.5,941,2.2,"00AM","Hackney",NA,1828,2426,2370,20298,3274,5064,6154,19014,1446,2638,3784,-1284
"1829","Hackney 022B","E01001840","E02000366","Hackney 022","E09000012","Hackney","E12000007","London",1676,1676,0,154.3,715,2.3,"00AM","Hackney",NA,901,639,1733,12753,3193,3117,5393,12030,2292,2478,3660,-723
"1830","Hackney 022C","E01001841","E02000366","Hackney 022","E09000012","Hackney","E12000007","London",1411,1411,0,103,626,2.3,"00AM","Hackney",NA,2872,4521,5971,19821,6823,7431,6147,18881,3951,2910,176,-940
"1835","Hackney 023D","E01001842","E02000367","Hackney 023","E09000012","Hackney","E12000007","London",1589,1589,0,246,631,2.5,"00AM","Hackney",NA,1864,1388,2608,11885,3754,3694,6206,14654,1890,2306,3598,2769
"1836","Hackney 023E","E01001843","E02000367","Hackney 023","E09000012","Hackney","E12000007","London",1244,1244,0,167.9,502,2.5,"00AM","Hackney",NA,3842,2921,4778,18076,5743,6761,6754,20446,1901,3840,1976,2370
"1831","Hackney 022D","E01001844","E02000366","Hackney 022","E09000012","Hackney","E12000007","London",2006,1888,118,128.9,812,2.3,"00AM","Hackney",NA,5315,6152,6460,20964,8445,10573,13325,20886,3130,4421,6865,-78
"1832","Hackney 022E","E01001845","E02000366","Hackney 022","E09000012","Hackney","E12000007","London",1555,1555,0,140.7,680,2.3,"00AM","Hackney",NA,1930,1553,1815,10828,926,1304,1359,7166,-1004,-249,-456,-3662
"1805","Hackney 018A","E01001846","E02000362","Hackney 018","E09000012","Hackney","E12000007","London",1216,1216,0,22.4,535,2.3,"00AM","Hackney",NA,1038,1422,1792,4673,1862,1694,3383,12654,824,272,1591,7981
"1806","Hackney 018B","E01001847","E02000362","Hackney 018","E09000012","Hackney","E12000007","London",1129,1110,19,106.9,467,2.4,"00AM","Hackney",NA,1076,1810,1704,7029,586,1093,530,13023,-490,-717,-1174,5994
"1807","Hackney 018C","E01001848","E02000362","Hackney 018","E09000012","Hackney","E12000007","London",1654,1605,49,109.1,655,2.5,"00AM","Hackney",NA,2043,1597,4506,12487,3366,4021,7161,11073,1323,2424,2655,-1414
"1808","Hackney 018D","E01001849","E02000362","Hackney 018","E09000012","Hackney","E12000007","London",2364,2335,29,47.7,977,2.4,"00AM","Hackney",NA,1736,1396,5077,11060,5692,4408,8016,13925,3956,3012,2939,2865
"1814","Hackney 019F","E01001850","E02000363","Hackney 019","E09000012","Hackney","E12000007","London",1810,1810,0,254.6,676,2.7,"00AM","Hackney",NA,1383,884,3034,6849,2488,1604,4067,8339,1105,720,1033,1490
"1909","Hammersmith and Fulham 010A","E01001851","E02000381","Hammersmith and Fulham 010","E09000013","Hammersmith and Fulham","E12000007","London",1632,1618,14,164.7,696,2.3,"00AN","Hammersmith and Fulham",NA,17804,20103,18925,26763,21600,21675,23866,31253,3796,1572,4941,4490
"1897","Hammersmith and Fulham 007A","E01001852","E02000378","Hammersmith and Fulham 007","E09000013","Hammersmith and Fulham","E12000007","London",1792,1792,0,237.7,956,1.9,"00AN","Hammersmith and Fulham",NA,13670,16113,16655,24465,16219,19649,23963,30609,2549,3536,7308,6144
"1898","Hammersmith and Fulham 007B","E01001853","E02000378","Hammersmith and Fulham 007","E09000013","Hammersmith and Fulham","E12000007","London",1533,1533,0,186.5,695,2.2,"00AN","Hammersmith and Fulham",NA,13309,15267,16645,25570,16527,17276,18098,26918,3218,2009,1453,1348
"1899","Hammersmith and Fulham 007C","E01001854","E02000378","Hammersmith and Fulham 007","E09000013","Hammersmith and Fulham","E12000007","London",1732,1716,16,262,887,1.9,"00AN","Hammersmith and Fulham",NA,10066,11080,12795,26224,12070,13463,15044,26366,2004,2383,2249,142
"1910","Hammersmith and Fulham 010B","E01001855","E02000381","Hammersmith and Fulham 010","E09000013","Hammersmith and Fulham","E12000007","London",1677,1654,23,218.4,894,1.9,"00AN","Hammersmith and Fulham",NA,12847,14436,15608,25517,12754,16406,19032,26131,-93,1970,3424,614
"1911","Hammersmith and Fulham 010C","E01001856","E02000381","Hammersmith and Fulham 010","E09000013","Hammersmith and Fulham","E12000007","London",1675,1659,16,202.5,730,2.3,"00AN","Hammersmith and Fulham",NA,6166,5543,6658,18553,7431,7784,7967,22697,1265,2241,1309,4144
"1900","Hammersmith and Fulham 007D","E01001857","E02000378","Hammersmith and Fulham 007","E09000013","Hammersmith and Fulham","E12000007","London",1477,1473,4,209.5,733,2,"00AN","Hammersmith and Fulham",NA,2391,4302,2141,14078,2763,2410,4046,12291,372,-1892,1905,-1787
"1892","Hammersmith and Fulham 006A","E01001858","E02000377","Hammersmith and Fulham 006","E09000013","Hammersmith and Fulham","E12000007","London",1793,1603,190,143.7,732,2.2,"00AN","Hammersmith and Fulham",NA,5900,6542,9370,20861,8487,7782,11002,21865,2587,1240,1632,1004
"1901","Hammersmith and Fulham 008A","E01001859","E02000379","Hammersmith and Fulham 008","E09000013","Hammersmith and Fulham","E12000007","London",2541,2541,0,236.8,1140,2.2,"00AN","Hammersmith and Fulham",NA,9349,6574,12409,14780,13431,7610,14367,27185,4082,1036,1958,12405
"1893","Hammersmith and Fulham 006B","E01001860","E02000377","Hammersmith and Fulham 006","E09000013","Hammersmith and Fulham","E12000007","London",1769,1749,20,204.7,795,2.2,"00AN","Hammersmith and Fulham",NA,3470,2929,3868,17347,5510,5674,6978,17786,2040,2745,3110,439
"1894","Hammersmith and Fulham 006C","E01001861","E02000377","Hammersmith and Fulham 006","E09000013","Hammersmith and Fulham","E12000007","London",1498,1486,12,199.5,654,2.3,"00AN","Hammersmith and Fulham",NA,5151,4714,5569,13151,6263,5691,6433,21218,1112,977,864,8067
"1888","Hammersmith and Fulham 005A","E01001862","E02000376","Hammersmith and Fulham 005","E09000013","Hammersmith and Fulham","E12000007","London",1768,1763,5,193.4,830,2.1,"00AN","Hammersmith and Fulham",NA,5239,4581,4456,14267,5137,5198,5045,14110,-102,617,589,-157
"1895","Hammersmith and Fulham 006D","E01001863","E02000377","Hammersmith and Fulham 006","E09000013","Hammersmith and Fulham","E12000007","London",1531,1517,14,184.5,671,2.3,"00AN","Hammersmith and Fulham",NA,10179,10951,14552,23522,13538,13070,14912,31202,3359,2119,360,7680
"1896","Hammersmith and Fulham 006E","E01001864","E02000377","Hammersmith and Fulham 006","E09000013","Hammersmith and Fulham","E12000007","London",1578,1578,0,212.4,761,2.1,"00AN","Hammersmith and Fulham",NA,7477,9443,7298,18220,7831,9153,8518,27279,354,-290,1220,9059
"1902","Hammersmith and Fulham 008B","E01001865","E02000379","Hammersmith and Fulham 008","E09000013","Hammersmith and Fulham","E12000007","London",1682,1648,34,143.9,651,2.5,"00AN","Hammersmith and Fulham",NA,11038,10093,11092,27008,17070,17234,20552,29958,6032,7141,9460,2950
"1918","Hammersmith and Fulham 012A","E01001866","E02000383","Hammersmith and Fulham 012","E09000013","Hammersmith and Fulham","E12000007","London",1579,1575,4,105.3,704,2.2,"00AN","Hammersmith and Fulham",NA,12758,17495,19379,26454,15864,17327,24156,31660,3106,-168,4777,5206
"1919","Hammersmith and Fulham 012B","E01001867","E02000383","Hammersmith and Fulham 012","E09000013","Hammersmith and Fulham","E12000007","London",1362,1285,77,154.9,612,2.1,"00AN","Hammersmith and Fulham",NA,15070,11040,19354,28020,18593,14656,26124,30015,3523,3616,6770,1995
"1920","Hammersmith and Fulham 012C","E01001868","E02000383","Hammersmith and Fulham 012","E09000013","Hammersmith and Fulham","E12000007","London",1341,1341,0,224.2,603,2.2,"00AN","Hammersmith and Fulham",NA,3263,2322,5150,15634,4315,4352,5210,11125,1052,2030,60,-4509
"1912","Hammersmith and Fulham 010D","E01001869","E02000381","Hammersmith and Fulham 010","E09000013","Hammersmith and Fulham","E12000007","London",1334,1301,33,57.4,574,2.3,"00AN","Hammersmith and Fulham",NA,18111,20015,21276,29086,17515,21011,24922,28465,-596,996,3646,-621
"1921","Hammersmith and Fulham 012D","E01001870","E02000383","Hammersmith and Fulham 012","E09000013","Hammersmith and Fulham","E12000007","London",1932,1923,9,190.9,1009,1.9,"00AN","Hammersmith and Fulham",NA,11405,13746,13848,27363,16446,18262,21896,24227,5041,4516,8048,-3136
"1922","Hammersmith and Fulham 012E","E01001871","E02000383","Hammersmith and Fulham 012","E09000013","Hammersmith and Fulham","E12000007","London",1604,1591,13,122.4,769,2.1,"00AN","Hammersmith and Fulham",NA,18130,18740,20755,25044,19943,17647,24931,29671,1813,-1093,4176,4627
"1923","Hammersmith and Fulham 012F","E01001872","E02000383","Hammersmith and Fulham 012","E09000013","Hammersmith and Fulham","E12000007","London",1614,1585,29,228.3,759,2.1,"00AN","Hammersmith and Fulham",NA,13056,16833,18791,22701,17239,20100,22771,31292,4183,3267,3980,8591
"1913","Hammersmith and Fulham 010E","E01001873","E02000381","Hammersmith and Fulham 010","E09000013","Hammersmith and Fulham","E12000007","London",1450,1450,0,235,689,2.1,"00AN","Hammersmith and Fulham",NA,8437,6682,9102,19093,9939,8634,10994,23643,1502,1952,1892,4550
"1871","Hammersmith and Fulham 001A","E01001874","E02000372","Hammersmith and Fulham 001","E09000013","Hammersmith and Fulham","E12000007","London",2055,2052,3,21.1,966,2.1,"00AN","Hammersmith and Fulham",NA,5075,5032,7316,10120,8400,7254,11437,21297,3325,2222,4121,11177
"1872","Hammersmith and Fulham 001B","E01001875","E02000372","Hammersmith and Fulham 001","E09000013","Hammersmith and Fulham","E12000007","London",1854,1854,0,109.8,666,2.8,"00AN","Hammersmith and Fulham",NA,3817,1927,6212,7741,4018,2841,5885,9690,201,914,-327,1949
"1873","Hammersmith and Fulham 001C","E01001876","E02000372","Hammersmith and Fulham 001","E09000013","Hammersmith and Fulham","E12000007","London",2232,1898,334,24.9,834,2.3,"00AN","Hammersmith and Fulham",NA,3517,4657,4775,10524,2864,2875,5339,15460,-653,-1782,564,4936
"1874","Hammersmith and Fulham 001D","E01001877","E02000372","Hammersmith and Fulham 001","E09000013","Hammersmith and Fulham","E12000007","London",1345,1338,7,10.7,603,2.2,"00AN","Hammersmith and Fulham",NA,3860,3043,1393,11645,6375,6493,7476,20584,2515,3450,6083,8939
"1875","Hammersmith and Fulham 001E","E01001878","E02000372","Hammersmith and Fulham 001","E09000013","Hammersmith and Fulham","E12000007","London",1689,1689,0,120.5,605,2.8,"00AN","Hammersmith and Fulham",NA,5602,1848,7705,8548,4528,2170,6194,9005,-1074,322,-1511,457
"1952","Hammersmith and Fulham 019A","E01001879","E02000390","Hammersmith and Fulham 019","E09000013","Hammersmith and Fulham","E12000007","London",1475,1473,2,183.5,633,2.3,"00AN","Hammersmith and Fulham",NA,6924,7073,7077,16268,9937,8828,10355,19916,3013,1755,3278,3648
"1942","Hammersmith and Fulham 017A","E01001880","E02000388","Hammersmith and Fulham 017","E09000013","Hammersmith and Fulham","E12000007","London",1497,1491,6,118.1,757,2,"00AN","Hammersmith and Fulham",NA,8944,10750,13802,15172,13639,12834,16240,17860,4695,2084,2438,2688
"1943","Hammersmith and Fulham 017B","E01001881","E02000388","Hammersmith and Fulham 017","E09000013","Hammersmith and Fulham","E12000007","London",1615,1588,27,142.8,681,2.3,"00AN","Hammersmith and Fulham",NA,9529,18486,19072,25328,16279,20367,26746,27755,6750,1881,7674,2427
"1944","Hammersmith and Fulham 017C","E01001882","E02000388","Hammersmith and Fulham 017","E09000013","Hammersmith and Fulham","E12000007","London",1762,1752,10,223.3,702,2.5,"00AN","Hammersmith and Fulham",NA,14784,19139,21583,19011,20014,24227,26052,27250,5230,5088,4469,8239
"1945","Hammersmith and Fulham 017D","E01001883","E02000388","Hammersmith and Fulham 017","E09000013","Hammersmith and Fulham","E12000007","London",1485,1477,8,112.3,734,2,"00AN","Hammersmith and Fulham",NA,6877,9507,10447,15946,11239,9924,13832,21495,4362,417,3385,5549
"1946","Hammersmith and Fulham 017E","E01001884","E02000388","Hammersmith and Fulham 017","E09000013","Hammersmith and Fulham","E12000007","London",1843,1843,0,228.4,931,2,"00AN","Hammersmith and Fulham",NA,5937,6733,9001,19600,8812,8995,13298,26664,2875,2262,4297,7064
"1933","Hammersmith and Fulham 015A","E01001885","E02000386","Hammersmith and Fulham 015","E09000013","Hammersmith and Fulham","E12000007","London",1319,1319,0,238.5,538,2.5,"00AN","Hammersmith and Fulham",NA,2977,1319,2520,15521,1936,1137,2149,13895,-1041,-182,-371,-1626
"1938","Hammersmith and Fulham 016A","E01001886","E02000387","Hammersmith and Fulham 016","E09000013","Hammersmith and Fulham","E12000007","London",1572,1572,0,160.9,628,2.5,"00AN","Hammersmith and Fulham",NA,7722,5597,9307,14537,8945,7447,10446,18556,1223,1850,1139,4019
"1939","Hammersmith and Fulham 016B","E01001887","E02000387","Hammersmith and Fulham 016","E09000013","Hammersmith and Fulham","E12000007","London",1519,1519,0,139.7,658,2.3,"00AN","Hammersmith and Fulham",NA,7656,7294,7945,14609,8877,8272,10267,23111,1221,978,2322,8502
"1947","Hammersmith and Fulham 018A","E01001888","E02000389","Hammersmith and Fulham 018","E09000013","Hammersmith and Fulham","E12000007","London",1614,1614,0,165.2,644,2.5,"00AN","Hammersmith and Fulham",NA,20391,23601,21854,26352,21908,24479,26501,26872,1517,878,4647,520
"1929","Hammersmith and Fulham 014A","E01001889","E02000385","Hammersmith and Fulham 014","E09000013","Hammersmith and Fulham","E12000007","London",1390,1390,0,96.7,593,2.3,"00AN","Hammersmith and Fulham",NA,11754,16460,19305,23910,15342,19031,21289,28973,3588,2571,1984,5063
"1940","Hammersmith and Fulham 016C","E01001890","E02000387","Hammersmith and Fulham 016","E09000013","Hammersmith and Fulham","E12000007","London",1815,1783,32,139.1,950,1.9,"00AN","Hammersmith and Fulham",NA,13438,15551,17862,11304,20325,22638,27793,29020,6887,7087,9931,17716
"1948","Hammersmith and Fulham 018B","E01001891","E02000389","Hammersmith and Fulham 018","E09000013","Hammersmith and Fulham","E12000007","London",2030,2023,7,116.7,863,2.3,"00AN","Hammersmith and Fulham",NA,18072,23554,29738,22586,23651,28272,31860,29122,5579,4718,2122,6536
"1941","Hammersmith and Fulham 016D","E01001892","E02000387","Hammersmith and Fulham 016","E09000013","Hammersmith and Fulham","E12000007","London",1366,1366,0,192.4,605,2.3,"00AN","Hammersmith and Fulham",NA,6799,5527,7587,17727,8206,6513,8023,22075,1407,986,436,4348
"1924","Hammersmith and Fulham 013A","E01001893","E02000384","Hammersmith and Fulham 013","E09000013","Hammersmith and Fulham","E12000007","London",1244,1244,0,158.7,504,2.5,"00AN","Hammersmith and Fulham",NA,8680,6464,12826,16771,6037,4501,8325,13340,-2643,-1963,-4501,-3431
"1925","Hammersmith and Fulham 013B","E01001894","E02000384","Hammersmith and Fulham 013","E09000013","Hammersmith and Fulham","E12000007","London",1320,1244,76,84.5,602,2.1,"00AN","Hammersmith and Fulham",NA,6925,6174,9320,16938,5504,4942,8929,15979,-1421,-1232,-391,-959
"1905","Hammersmith and Fulham 009A","E01001895","E02000380","Hammersmith and Fulham 009","E09000013","Hammersmith and Fulham","E12000007","London",1594,1587,7,183.4,674,2.4,"00AN","Hammersmith and Fulham",NA,10064,10309,13300,23264,14298,14003,14888,18878,4234,3694,1588,-4386
"1906","Hammersmith and Fulham 009B","E01001896","E02000380","Hammersmith and Fulham 009","E09000013","Hammersmith and Fulham","E12000007","London",1548,1503,45,184.3,669,2.2,"00AN","Hammersmith and Fulham",NA,10191,8902,11242,25851,11387,11046,15452,25030,1196,2144,4210,-821
"1907","Hammersmith and Fulham 009C","E01001897","E02000380","Hammersmith and Fulham 009","E09000013","Hammersmith and Fulham","E12000007","London",1461,1461,0,152,619,2.4,"00AN","Hammersmith and Fulham",NA,11099,17492,14909,29967,18913,18993,20109,30999,7814,1501,5200,1032
"1926","Hammersmith and Fulham 013C","E01001898","E02000384","Hammersmith and Fulham 013","E09000013","Hammersmith and Fulham","E12000007","London",1591,1554,37,55.6,736,2.1,"00AN","Hammersmith and Fulham",NA,6016,9543,9321,19936,10817,14596,12511,20563,4801,5053,3190,627
"1927","Hammersmith and Fulham 013D","E01001899","E02000384","Hammersmith and Fulham 013","E09000013","Hammersmith and Fulham","E12000007","London",1380,1380,0,110.6,691,2,"00AN","Hammersmith and Fulham",NA,4248,3925,5644,15562,3205,3661,3770,11894,-1043,-264,-1874,-3668
"1928","Hammersmith and Fulham 013E","E01001900","E02000384","Hammersmith and Fulham 013","E09000013","Hammersmith and Fulham","E12000007","London",1785,1698,87,131.1,723,2.3,"00AN","Hammersmith and Fulham",NA,8110,7436,8767,12736,7894,9511,9059,20369,-216,2075,292,7633
"1953","Hammersmith and Fulham 019B","E01001901","E02000390","Hammersmith and Fulham 019","E09000013","Hammersmith and Fulham","E12000007","London",1625,1621,4,192.3,695,2.3,"00AN","Hammersmith and Fulham",NA,18830,22307,25347,26157,22481,22651,24462,31966,3651,344,-885,5809
"1954","Hammersmith and Fulham 019C","E01001902","E02000390","Hammersmith and Fulham 019","E09000013","Hammersmith and Fulham","E12000007","London",1699,1699,0,234,814,2.1,"00AN","Hammersmith and Fulham",NA,11124,12116,16286,24886,14714,15158,19980,13674,3590,3042,3694,-11212
"1955","Hammersmith and Fulham 019D","E01001903","E02000390","Hammersmith and Fulham 019","E09000013","Hammersmith and Fulham","E12000007","London",1649,1649,0,149.5,681,2.4,"00AN","Hammersmith and Fulham",NA,8774,6600,12351,22423,10236,8628,10762,20969,1462,2028,-1589,-1454
"1967","Hammersmith and Fulham 022A","E01001904","E02000393","Hammersmith and Fulham 022","E09000013","Hammersmith and Fulham","E12000007","London",1587,1587,0,112.5,681,2.3,"00AN","Hammersmith and Fulham",NA,14711,20038,22240,22377,22241,24685,29300,25321,7530,4647,7060,2944
"1968","Hammersmith and Fulham 022B","E01001905","E02000393","Hammersmith and Fulham 022","E09000013","Hammersmith and Fulham","E12000007","London",1702,1702,0,198.6,750,2.3,"00AN","Hammersmith and Fulham",NA,18743,18415,24237,27251,26633,27548,31744,30345,7890,9133,7507,3094
"1969","Hammersmith and Fulham 022C","E01001906","E02000393","Hammersmith and Fulham 022","E09000013","Hammersmith and Fulham","E12000007","London",1439,1439,0,230.2,656,2.2,"00AN","Hammersmith and Fulham",NA,17409,17892,27299,18060,23015,24964,26917,23797,5606,7072,-382,5737
"1970","Hammersmith and Fulham 022D","E01001907","E02000393","Hammersmith and Fulham 022","E09000013","Hammersmith and Fulham","E12000007","London",1303,1297,6,195.1,563,2.3,"00AN","Hammersmith and Fulham",NA,15819,18027,21006,26055,23308,25296,27700,31272,7489,7269,6694,5217
"1934","Hammersmith and Fulham 015B","E01001908","E02000386","Hammersmith and Fulham 015","E09000013","Hammersmith and Fulham","E12000007","London",1636,1625,11,378.7,875,1.9,"00AN","Hammersmith and Fulham",NA,13539,17317,21174,17316,14328,19321,21206,26678,789,2004,32,9362
"1935","Hammersmith and Fulham 015C","E01001909","E02000386","Hammersmith and Fulham 015","E09000013","Hammersmith and Fulham","E12000007","London",1822,1814,8,207.3,821,2.2,"00AN","Hammersmith and Fulham",NA,9403,9658,13016,21531,12317,11608,15828,24518,2914,1950,2812,2987
"1930","Hammersmith and Fulham 014B","E01001910","E02000385","Hammersmith and Fulham 014","E09000013","Hammersmith and Fulham","E12000007","London",1512,1504,8,188.5,840,1.8,"00AN","Hammersmith and Fulham",NA,9677,12634,10225,20099,13566,17483,18360,30138,3889,4849,8135,10039
"1936","Hammersmith and Fulham 015D","E01001911","E02000386","Hammersmith and Fulham 015","E09000013","Hammersmith and Fulham","E12000007","London",1761,1761,0,112.7,751,2.3,"00AN","Hammersmith and Fulham",NA,3284,1106,4149,12995,4493,2091,4364,16095,1209,985,215,3100
"1937","Hammersmith and Fulham 015E","E01001912","E02000386","Hammersmith and Fulham 015","E09000013","Hammersmith and Fulham","E12000007","London",1598,1598,0,168.4,600,2.7,"00AN","Hammersmith and Fulham",NA,5366,3077,6120,21606,5132,3790,5908,11467,-234,713,-212,-10139
"1931","Hammersmith and Fulham 014C","E01001913","E02000385","Hammersmith and Fulham 014","E09000013","Hammersmith and Fulham","E12000007","London",1545,1545,0,141.9,774,2,"00AN","Hammersmith and Fulham",NA,15298,24617,28050,16687,20296,30159,32118,30261,4998,5542,4068,13574
"1932","Hammersmith and Fulham 014D","E01001914","E02000385","Hammersmith and Fulham 014","E09000013","Hammersmith and Fulham","E12000007","London",1715,1703,12,256.4,887,1.9,"00AN","Hammersmith and Fulham",NA,9282,13519,11164,18518,14307,14445,17758,29293,5025,926,6594,10775
"1976","Hammersmith and Fulham 024A","E01001915","E02000395","Hammersmith and Fulham 024","E09000013","Hammersmith and Fulham","E12000007","London",1482,1482,0,35,608,2.4,"00AN","Hammersmith and Fulham",NA,17053,24588,30107,27761,20875,26965,31424,25999,3822,2377,1317,-1762
"1977","Hammersmith and Fulham 024B","E01001916","E02000395","Hammersmith and Fulham 024","E09000013","Hammersmith and Fulham","E12000007","London",1390,1390,0,38.8,689,2,"00AN","Hammersmith and Fulham",NA,21551,31025,31517,27865,28275,32311,32465,32818,6724,1286,948,4953
"1949","Hammersmith and Fulham 018C","E01001917","E02000389","Hammersmith and Fulham 018","E09000013","Hammersmith and Fulham","E12000007","London",1462,1462,0,134.1,684,2.1,"00AN","Hammersmith and Fulham",NA,13454,13890,16439,25061,16587,16432,19840,25697,3133,2542,3401,636
"1950","Hammersmith and Fulham 018D","E01001918","E02000389","Hammersmith and Fulham 018","E09000013","Hammersmith and Fulham","E12000007","London",1519,1519,0,145.4,622,2.4,"00AN","Hammersmith and Fulham",NA,15536,15031,19438,23708,22400,19569,25011,30737,6864,4538,5573,7029
"1951","Hammersmith and Fulham 018E","E01001919","E02000389","Hammersmith and Fulham 018","E09000013","Hammersmith and Fulham","E12000007","London",1630,1630,0,113.9,639,2.6,"00AN","Hammersmith and Fulham",NA,17746,18540,24139,24721,25392,25880,26549,31501,7646,7340,2410,6780
"1956","Hammersmith and Fulham 020A","E01001920","E02000391","Hammersmith and Fulham 020","E09000013","Hammersmith and Fulham","E12000007","London",1513,1509,4,91.8,828,1.8,"00AN","Hammersmith and Fulham",NA,5762,7257,3885,21584,6851,6700,6965,24039,1089,-557,3080,2455
"1957","Hammersmith and Fulham 020B","E01001921","E02000391","Hammersmith and Fulham 020","E09000013","Hammersmith and Fulham","E12000007","London",1536,1523,13,156.4,663,2.3,"00AN","Hammersmith and Fulham",NA,8928,12682,12855,9643,14429,17047,18886,25823,5501,4365,6031,16180
"1958","Hammersmith and Fulham 020C","E01001922","E02000391","Hammersmith and Fulham 020","E09000013","Hammersmith and Fulham","E12000007","London",1605,1605,0,84.1,671,2.4,"00AN","Hammersmith and Fulham",NA,20936,22220,29779,30921,20595,21995,27341,31815,-341,-225,-2438,894
"1959","Hammersmith and Fulham 020D","E01001923","E02000391","Hammersmith and Fulham 020","E09000013","Hammersmith and Fulham","E12000007","London",1479,1479,0,130.8,653,2.3,"00AN","Hammersmith and Fulham",NA,11105,12133,17564,19045,17077,14390,21165,28458,5972,2257,3601,9413
"1960","Hammersmith and Fulham 020E","E01001924","E02000391","Hammersmith and Fulham 020","E09000013","Hammersmith and Fulham","E12000007","London",1596,1596,0,162.4,604,2.6,"00AN","Hammersmith and Fulham",NA,19335,29944,30197,32154,25019,29858,32696,30165,5684,-86,2499,-1989
"1980","Hammersmith and Fulham 025A","E01001925","E02000396","Hammersmith and Fulham 025","E09000013","Hammersmith and Fulham","E12000007","London",1628,1628,0,114.7,624,2.6,"00AN","Hammersmith and Fulham",NA,18720,27084,25668,25207,23061,26988,29102,31714,4341,-96,3434,6507
"1978","Hammersmith and Fulham 024C","E01001926","E02000395","Hammersmith and Fulham 024","E09000013","Hammersmith and Fulham","E12000007","London",1456,1456,0,160.7,613,2.4,"00AN","Hammersmith and Fulham",NA,21202,24480,29332,32116,27048,29737,31795,31108,5846,5257,2463,-1008
"1903","Hammersmith and Fulham 008C","E01001927","E02000379","Hammersmith and Fulham 008","E09000013","Hammersmith and Fulham","E12000007","London",1504,1503,1,75,557,2.7,"00AN","Hammersmith and Fulham",NA,20776,26697,23004,30871,23115,29148,26534,32456,2339,2451,3530,1585
"1914","Hammersmith and Fulham 011A","E01001928","E02000382","Hammersmith and Fulham 011","E09000013","Hammersmith and Fulham","E12000007","London",1724,1712,12,92,722,2.4,"00AN","Hammersmith and Fulham",NA,6473,6595,3787,28176,11734,11058,14084,30995,5261,4463,10297,2819
"1908","Hammersmith and Fulham 009D","E01001929","E02000380","Hammersmith and Fulham 009","E09000013","Hammersmith and Fulham","E12000007","London",1260,1260,0,147.7,597,2.1,"00AN","Hammersmith and Fulham",NA,16212,20718,24392,18272,20833,21803,26626,23498,4621,1085,2234,5226
"1904","Hammersmith and Fulham 008D","E01001930","E02000379","Hammersmith and Fulham 008","E09000013","Hammersmith and Fulham","E12000007","London",1854,1719,135,72.9,842,2,"00AN","Hammersmith and Fulham",NA,7941,6343,10843,27912,7582,9059,9780,23653,-359,2716,-1063,-4259
"1915","Hammersmith and Fulham 011B","E01001931","E02000382","Hammersmith and Fulham 011","E09000013","Hammersmith and Fulham","E12000007","London",1498,1498,0,220,709,2.1,"00AN","Hammersmith and Fulham",NA,8639,4653,12850,22414,6384,6039,13529,24937,-2255,1386,679,2523
"1916","Hammersmith and Fulham 011C","E01001932","E02000382","Hammersmith and Fulham 011","E09000013","Hammersmith and Fulham","E12000007","London",1621,1612,9,90.5,757,2.1,"00AN","Hammersmith and Fulham",NA,8698,11477,10421,23927,8593,12260,13312,30497,-105,783,2891,6570
"1917","Hammersmith and Fulham 011D","E01001933","E02000382","Hammersmith and Fulham 011","E09000013","Hammersmith and Fulham","E12000007","London",1324,1324,0,72.8,635,2.1,"00AN","Hammersmith and Fulham",NA,9766,12656,16458,21583,13674,15098,15778,29787,3908,2442,-680,8204
"1981","Hammersmith and Fulham 025B","E01001934","E02000396","Hammersmith and Fulham 025","E09000013","Hammersmith and Fulham","E12000007","London",1622,1622,0,89.1,699,2.3,"00AN","Hammersmith and Fulham",NA,8083,4179,10315,13226,10630,6291,8579,20718,2547,2112,-1736,7492
"1971","Hammersmith and Fulham 023A","E01001935","E02000394","Hammersmith and Fulham 023","E09000013","Hammersmith and Fulham","E12000007","London",2059,2059,0,190.8,927,2.2,"00AN","Hammersmith and Fulham",NA,9814,8883,10006,20218,14900,14330,15087,24679,5086,5447,5081,4461
"1982","Hammersmith and Fulham 025C","E01001937","E02000396","Hammersmith and Fulham 025","E09000013","Hammersmith and Fulham","E12000007","London",1823,1823,0,93.9,760,2.4,"00AN","Hammersmith and Fulham",NA,16885,18893,24449,24395,18892,23732,25483,25232,2007,4839,1034,837
"1983","Hammersmith and Fulham 025D","E01001938","E02000396","Hammersmith and Fulham 025","E09000013","Hammersmith and Fulham","E12000007","London",1560,1560,0,145.9,616,2.5,"00AN","Hammersmith and Fulham",NA,9504,8322,13166,13962,9794,6005,12564,21443,290,-2317,-602,7481
"1972","Hammersmith and Fulham 023C","E01001939","E02000394","Hammersmith and Fulham 023","E09000013","Hammersmith and Fulham","E12000007","London",2321,2021,300,71.4,985,2.1,"00AN","Hammersmith and Fulham",NA,10226,4773,11346,21496,11377,8653,12203,14555,1151,3880,857,-6941
"1889","Hammersmith and Fulham 005B","E01001940","E02000376","Hammersmith and Fulham 005","E09000013","Hammersmith and Fulham","E12000007","London",1601,1590,11,197.7,740,2.1,"00AN","Hammersmith and Fulham",NA,7667,6072,11418,19303,6071,6048,8015,21253,-1596,-24,-3403,1950
"1890","Hammersmith and Fulham 005C","E01001941","E02000376","Hammersmith and Fulham 005","E09000013","Hammersmith and Fulham","E12000007","London",1677,1671,6,116,717,2.3,"00AN","Hammersmith and Fulham",NA,3211,6447,3207,21910,7436,10266,9227,28355,4225,3819,6020,6445
"1891","Hammersmith and Fulham 005D","E01001942","E02000376","Hammersmith and Fulham 005","E09000013","Hammersmith and Fulham","E12000007","London",1869,1866,3,201.2,865,2.2,"00AN","Hammersmith and Fulham",NA,5855,9241,7285,22020,8907,9994,10468,29153,3052,753,3183,7133
"1884","Hammersmith and Fulham 004A","E01001943","E02000375","Hammersmith and Fulham 004","E09000013","Hammersmith and Fulham","E12000007","London",1954,1926,28,43.9,905,2.1,"00AN","Hammersmith and Fulham",NA,5896,10846,12565,15497,5543,8140,9933,25856,-353,-2706,-2632,10359
"1885","Hammersmith and Fulham 004B","E01001944","E02000375","Hammersmith and Fulham 004","E09000013","Hammersmith and Fulham","E12000007","London",1689,1689,0,260.6,869,1.9,"00AN","Hammersmith and Fulham",NA,2553,1561,1172,15697,2671,1585,2172,18545,118,24,1000,2848
"1886","Hammersmith and Fulham 004C","E01001945","E02000375","Hammersmith and Fulham 004","E09000013","Hammersmith and Fulham","E12000007","London",1752,1750,2,152.1,754,2.3,"00AN","Hammersmith and Fulham",NA,8367,7185,11095,23918,11045,10698,13129,29367,2678,3513,2034,5449
"1887","Hammersmith and Fulham 004D","E01001946","E02000375","Hammersmith and Fulham 004","E09000013","Hammersmith and Fulham","E12000007","London",1633,1633,0,132.2,702,2.3,"00AN","Hammersmith and Fulham",NA,11781,7563,12660,21608,14314,11013,12092,22236,2533,3450,-568,628
"1961","Hammersmith and Fulham 021A","E01001947","E02000392","Hammersmith and Fulham 021","E09000013","Hammersmith and Fulham","E12000007","London",1448,1448,0,262.8,591,2.5,"00AN","Hammersmith and Fulham",NA,4687,2238,5255,9135,3793,2109,3826,9443,-894,-129,-1429,308
"1962","Hammersmith and Fulham 021B","E01001948","E02000392","Hammersmith and Fulham 021","E09000013","Hammersmith and Fulham","E12000007","London",2012,1986,26,175,922,2.2,"00AN","Hammersmith and Fulham",NA,19579,28104,27046,29079,18255,16656,20556,31070,-1324,-11448,-6490,1991
"1963","Hammersmith and Fulham 021C","E01001949","E02000392","Hammersmith and Fulham 021","E09000013","Hammersmith and Fulham","E12000007","London",1547,1547,0,192.4,658,2.4,"00AN","Hammersmith and Fulham",NA,17603,20437,28324,23211,26000,29647,32016,26989,8397,9210,3692,3778
"1964","Hammersmith and Fulham 021D","E01001950","E02000392","Hammersmith and Fulham 021","E09000013","Hammersmith and Fulham","E12000007","London",1596,1596,0,148.1,636,2.5,"00AN","Hammersmith and Fulham",NA,18238,22843,28850,23337,22724,28388,30905,27398,4486,5545,2055,4061
"1965","Hammersmith and Fulham 021E","E01001951","E02000392","Hammersmith and Fulham 021","E09000013","Hammersmith and Fulham","E12000007","London",1609,1609,0,156.7,705,2.3,"00AN","Hammersmith and Fulham",NA,10771,16144,18185,21248,16573,16655,21043,27225,5802,511,2858,5977
"1979","Hammersmith and Fulham 024D","E01001952","E02000395","Hammersmith and Fulham 024","E09000013","Hammersmith and Fulham","E12000007","London",1623,1623,0,167.5,809,2,"00AN","Hammersmith and Fulham",NA,12251,14916,17559,27051,18581,19927,25092,21335,6330,5011,7533,-5716
"1966","Hammersmith and Fulham 021F","E01001953","E02000392","Hammersmith and Fulham 021","E09000013","Hammersmith and Fulham","E12000007","London",1366,1351,15,148,610,2.2,"00AN","Hammersmith and Fulham",NA,9002,9495,15221,18842,11123,9829,14419,25465,2121,334,-802,6623
"1880","Hammersmith and Fulham 003A","E01001954","E02000374","Hammersmith and Fulham 003","E09000013","Hammersmith and Fulham","E12000007","London",1525,1525,0,173.9,649,2.3,"00AN","Hammersmith and Fulham",NA,8421,7068,10522,19573,8357,6002,10681,17792,-64,-1066,159,-1781
"1876","Hammersmith and Fulham 002A","E01001955","E02000373","Hammersmith and Fulham 002","E09000013","Hammersmith and Fulham","E12000007","London",1807,1807,0,82.6,674,2.7,"00AN","Hammersmith and Fulham",NA,1906,1507,2816,11585,2705,1912,3513,13111,799,405,697,1526
"1881","Hammersmith and Fulham 003B","E01001956","E02000374","Hammersmith and Fulham 003","E09000013","Hammersmith and Fulham","E12000007","London",1593,1585,8,118.6,603,2.6,"00AN","Hammersmith and Fulham",NA,9364,6617,9150,23247,10248,8377,8788,23543,884,1760,-362,296
"1877","Hammersmith and Fulham 002B","E01001957","E02000373","Hammersmith and Fulham 002","E09000013","Hammersmith and Fulham","E12000007","London",1616,1616,0,222.3,605,2.7,"00AN","Hammersmith and Fulham",NA,3568,1219,3245,11866,2867,972,3989,6637,-701,-247,744,-5229
"1878","Hammersmith and Fulham 002C","E01001958","E02000373","Hammersmith and Fulham 002","E09000013","Hammersmith and Fulham","E12000007","London",1671,1671,0,368.1,614,2.7,"00AN","Hammersmith and Fulham",NA,2033,496,2907,11552,3005,713,3834,11914,972,217,927,362
"1882","Hammersmith and Fulham 003C","E01001959","E02000374","Hammersmith and Fulham 003","E09000013","Hammersmith and Fulham","E12000007","London",1728,1727,1,89.2,588,2.9,"00AN","Hammersmith and Fulham",NA,6455,3452,8329,13134,3677,3394,4115,14532,-2778,-58,-4214,1398
"1883","Hammersmith and Fulham 003D","E01001960","E02000374","Hammersmith and Fulham 003","E09000013","Hammersmith and Fulham","E12000007","London",1885,1875,10,233,750,2.5,"00AN","Hammersmith and Fulham",NA,12988,11606,19040,26211,15752,13608,18652,28373,2764,2002,-388,2162
"1879","Hammersmith and Fulham 002D","E01001961","E02000373","Hammersmith and Fulham 002","E09000013","Hammersmith and Fulham","E12000007","London",1564,1564,0,221.2,540,2.9,"00AN","Hammersmith and Fulham",NA,2835,1118,6004,10414,3649,1067,4528,10207,814,-51,-1476,-207
"1992","Haringey 004A","E01001962","E02000400","Haringey 004","E09000014","Haringey","E12000007","London",1758,1758,0,34.2,641,2.7,"00AP","Haringey",NA,10908,8011,14460,25896,14638,12429,17047,26475,3730,4418,2587,579
"2012","Haringey 009A","E01001963","E02000405","Haringey 009","E09000014","Haringey","E12000007","London",1820,1820,0,35.6,691,2.6,"00AP","Haringey",NA,21037,22183,22526,32139,24450,26799,27717,32648,3413,4616,5191,509
"2013","Haringey 009B","E01001964","E02000405","Haringey 009","E09000014","Haringey","E12000007","London",1588,1588,0,25.1,667,2.4,"00AP","Haringey",NA,11066,15154,13729,27170,17014,19402,19533,30776,5948,4248,5804,3606
"2014","Haringey 009C","E01001965","E02000405","Haringey 009","E09000014","Haringey","E12000007","London",1627,1627,0,131.7,657,2.5,"00AP","Haringey",NA,15824,17257,18738,28114,21823,19429,22606,31402,5999,2172,3868,3288
"2015","Haringey 009D","E01001966","E02000405","Haringey 009","E09000014","Haringey","E12000007","London",1513,1506,7,29.3,535,2.8,"00AP","Haringey",NA,19715,23963,24280,32239,19131,25552,28356,32622,-584,1589,4076,383
"2032","Haringey 014A","E01001967","E02000410","Haringey 014","E09000014","Haringey","E12000007","London",1655,1607,48,94.2,633,2.5,"00AP","Haringey",NA,20655,22826,23458,32324,25243,24126,28122,32445,4588,1300,4664,121
"2033","Haringey 014B","E01001968","E02000410","Haringey 014","E09000014","Haringey","E12000007","London",1834,1834,0,129.9,778,2.4,"00AP","Haringey",NA,14142,15117,18569,31897,21816,22238,25052,32373,7674,7121,6483,476
"1984","Haringey 001A","E01001969","E02000397","Haringey 001","E09000014","Haringey","E12000007","London",1888,1888,0,131.1,857,2.2,"00AP","Haringey",NA,7470,6506,10148,24151,7550,8135,12945,16967,80,1629,2797,-7184
"1993","Haringey 004B","E01001970","E02000400","Haringey 004","E09000014","Haringey","E12000007","London",1981,1972,9,93.7,728,2.7,"00AP","Haringey",NA,3071,1136,4754,12093,6842,5632,10188,16299,3771,4496,5434,4206
"1985","Haringey 001B","E01001971","E02000397","Haringey 001","E09000014","Haringey","E12000007","London",2012,2002,10,158.6,784,2.6,"00AP","Haringey",NA,2954,1170,4009,8467,3908,3426,4537,12665,954,2256,528,4198
"1994","Haringey 004C","E01001972","E02000400","Haringey 004","E09000014","Haringey","E12000007","London",1672,1672,0,80.3,749,2.2,"00AP","Haringey",NA,4299,4277,7690,18585,8558,6872,8687,20693,4259,2595,997,2108
"1995","Haringey 004D","E01001973","E02000400","Haringey 004","E09000014","Haringey","E12000007","London",2257,2246,11,56.3,943,2.4,"00AP","Haringey",NA,12480,9744,13945,25520,13518,11931,16664,25981,1038,2187,2719,461
"1986","Haringey 001C","E01001974","E02000397","Haringey 001","E09000014","Haringey","E12000007","London",2198,2198,0,124.8,959,2.3,"00AP","Haringey",NA,8469,7962,9210,20059,12423,15567,16693,16516,3954,7605,7483,-3543
"1987","Haringey 001D","E01001975","E02000397","Haringey 001","E09000014","Haringey","E12000007","London",1717,1710,7,146.9,776,2.2,"00AP","Haringey",NA,7543,5721,11626,14535,11782,13870,13247,19497,4239,8149,1621,4962
"2020","Haringey 011A","E01001976","E02000407","Haringey 011","E09000014","Haringey","E12000007","London",1628,1614,14,157.4,635,2.5,"00AP","Haringey",NA,3962,2648,5530,11017,3633,4909,4360,8640,-329,2261,-1170,-2377
"2021","Haringey 011B","E01001977","E02000407","Haringey 011","E09000014","Haringey","E12000007","London",1580,1576,4,174.4,605,2.6,"00AP","Haringey",NA,2629,1320,2990,11764,3540,2777,4785,10029,911,1457,1795,-1735
"2022","Haringey 011C","E01001978","E02000407","Haringey 011","E09000014","Haringey","E12000007","London",1905,1862,43,144.1,819,2.3,"00AP","Haringey",NA,941,765,1504,9397,2483,3074,3961,6031,1542,2309,2457,-3366
"2023","Haringey 011D","E01001979","E02000407","Haringey 011","E09000014","Haringey","E12000007","London",2199,2187,12,112.3,846,2.6,"00AP","Haringey",NA,1060,323,2814,9296,2431,2926,5229,8440,1371,2603,2415,-856
"2048","Haringey 018A","E01001980","E02000414","Haringey 018","E09000014","Haringey","E12000007","London",1986,1983,3,179.2,673,2.9,"00AP","Haringey",NA,4638,2213,5159,13049,6036,4838,9265,9341,1398,2625,4106,-3708
"2049","Haringey 018B","E01001981","E02000414","Haringey 018","E09000014","Haringey","E12000007","London",1761,1758,3,181,601,2.9,"00AP","Haringey",NA,6296,3331,8144,8783,7198,6418,10170,10907,902,3087,2026,2124
"2050","Haringey 018C","E01001982","E02000414","Haringey 018","E09000014","Haringey","E12000007","London",1772,1763,9,174.6,676,2.6,"00AP","Haringey",NA,6532,4250,5494,15688,5516,5427,5944,11315,-1016,1177,450,-4373
"2051","Haringey 018D","E01001983","E02000414","Haringey 018","E09000014","Haringey","E12000007","London",1652,1652,0,165.5,612,2.7,"00AP","Haringey",NA,5664,5293,8306,17368,8255,7690,9086,11461,2591,2397,780,-5907
"2109","Haringey 033A","E01001984","E02000429","Haringey 033","E09000014","Haringey","E12000007","London",1590,1590,0,79.8,867,1.8,"00AP","Haringey",NA,11626,14353,13658,24500,16643,16735,18967,27809,5017,2382,5309,3309
"2110","Haringey 033B","E01001985","E02000429","Haringey 033","E09000014","Haringey","E12000007","London",1690,1667,23,89.8,769,2.2,"00AP","Haringey",NA,18277,19661,20867,30521,23200,28188,27908,32069,4923,8527,7041,1548
"2113","Haringey 034A","E01001986","E02000430","Haringey 034","E09000014","Haringey","E12000007","London",1635,1635,0,121.2,744,2.2,"00AP","Haringey",NA,15201,13192,17202,30537,21283,19510,20975,30055,6082,6318,3773,-482
"2111","Haringey 033C","E01001987","E02000429","Haringey 033","E09000014","Haringey","E12000007","London",1847,1821,26,60.5,805,2.3,"00AP","Haringey",NA,21343,27837,29925,29212,24502,30469,31912,32184,3159,2632,1987,2972
"2114","Haringey 034B","E01001988","E02000430","Haringey 034","E09000014","Haringey","E12000007","London",1771,1762,9,102.2,881,2,"00AP","Haringey",NA,11155,13295,14755,28067,16334,19491,21355,26054,5179,6196,6600,-2013
"2112","Haringey 033D","E01001989","E02000429","Haringey 033","E09000014","Haringey","E12000007","London",1725,1725,0,60.1,766,2.3,"00AP","Haringey",NA,14157,15409,19405,29839,19706,18071,23111,31226,5549,2662,3706,1387
"2115","Haringey 034C","E01001990","E02000430","Haringey 034","E09000014","Haringey","E12000007","London",2137,2137,0,140.6,982,2.2,"00AP","Haringey",NA,9992,13651,13492,21623,17602,22694,28142,28688,7610,9043,14650,7065
"2044","Haringey 017A","E01001991","E02000413","Haringey 017","E09000014","Haringey","E12000007","London",1693,1609,84,135.1,766,2.1,"00AP","Haringey",NA,10736,13493,21749,31765,18318,22836,28148,32555,7582,9343,6399,790
"2045","Haringey 017B","E01001992","E02000413","Haringey 017","E09000014","Haringey","E12000007","London",1709,1701,8,42.7,672,2.5,"00AP","Haringey",NA,23801,25498,25387,32380,27098,29104,30037,32679,3297,3606,4650,299
"2046","Haringey 017C","E01001993","E02000413","Haringey 017","E09000014","Haringey","E12000007","London",1686,1686,0,61.2,609,2.8,"00AP","Haringey",NA,22639,24246,31571,32428,27314,30540,31296,32829,4675,6294,-275,401
"2097","Haringey 030A","E01001994","E02000426","Haringey 030","E09000014","Haringey","E12000007","London",1784,1779,5,52.5,760,2.3,"00AP","Haringey",NA,20157,18080,25698,31853,25145,21702,28551,31953,4988,3622,2853,100
"2047","Haringey 017D","E01001995","E02000413","Haringey 017","E09000014","Haringey","E12000007","London",2412,2412,0,57.7,898,2.7,"00AP","Haringey",NA,7573,4422,6429,17194,10064,7441,8548,20495,2491,3019,2119,3301
"2034","Haringey 014C","E01001996","E02000410","Haringey 014","E09000014","Haringey","E12000007","London",1625,1625,0,66.5,698,2.3,"00AP","Haringey",NA,16725,15746,20451,30984,19883,19137,23879,32484,3158,3391,3428,1500
"2035","Haringey 014D","E01001997","E02000410","Haringey 014","E09000014","Haringey","E12000007","London",1579,1570,9,82.8,730,2.2,"00AP","Haringey",NA,13862,18335,19387,30760,19488,23192,27491,31706,5626,4857,8104,946
"2069","Haringey 023A","E01001998","E02000419","Haringey 023","E09000014","Haringey","E12000007","London",2058,2058,0,132.5,865,2.4,"00AP","Haringey",NA,10814,10325,12114,20529,13728,12252,19216,24347,2914,1927,7102,3818
"2070","Haringey 023B","E01001999","E02000419","Haringey 023","E09000014","Haringey","E12000007","London",2001,2001,0,136.7,819,2.4,"00AP","Haringey",NA,6430,4761,9857,23742,7008,9475,11129,12697,578,4714,1272,-11045
"2101","Haringey 031A","E01002000","E02000427","Haringey 031","E09000014","Haringey","E12000007","London",1697,1692,5,104.9,690,2.5,"00AP","Haringey",NA,7896,6088,8334,15277,11637,11300,13664,20037,3741,5212,5330,4760
"2102","Haringey 031B","E01002001","E02000427","Haringey 031","E09000014","Haringey","E12000007","London",1661,1661,0,156.3,677,2.5,"00AP","Haringey",NA,10478,7512,13565,21032,11465,12869,16924,23050,987,5357,3359,2018
"2103","Haringey 031C","E01002002","E02000427","Haringey 031","E09000014","Haringey","E12000007","London",1806,1785,21,27.7,781,2.3,"00AP","Haringey",NA,4423,6163,8105,15155,5287,8860,10193,22037,864,2697,2088,6882
"2071","Haringey 023C","E01002003","E02000419","Haringey 023","E09000014","Haringey","E12000007","London",2160,2160,0,97.4,929,2.3,"00AP","Haringey",NA,1291,769,2632,14518,3544,4957,6436,12501,2253,4188,3804,-2017
"2072","Haringey 023D","E01002004","E02000419","Haringey 023","E09000014","Haringey","E12000007","London",1889,1881,8,159.1,710,2.6,"00AP","Haringey",NA,8086,6039,10618,20611,13716,12145,15692,18773,5630,6106,5074,-1838
"2117","Haringey 035A","E01002005","E02000431","Haringey 035","E09000014","Haringey","E12000007","London",1688,1686,2,179.2,818,2.1,"00AP","Haringey",NA,13754,19184,19201,26500,16526,23597,26736,17674,2772,4413,7535,-8826
"2118","Haringey 035B","E01002006","E02000431","Haringey 035","E09000014","Haringey","E12000007","London",1602,1602,0,145.4,808,2,"00AP","Haringey",NA,17112,20131,24291,23182,17554,20717,22953,29042,442,586,-1338,5860
"2119","Haringey 035C","E01002007","E02000431","Haringey 035","E09000014","Haringey","E12000007","London",1676,1676,0,99.5,799,2.1,"00AP","Haringey",NA,17232,26265,23885,31639,21931,26761,29046,30511,4699,496,5161,-1128
"2098","Haringey 030B","E01002008","E02000426","Haringey 030","E09000014","Haringey","E12000007","London",1571,1534,37,24.4,643,2.4,"00AP","Haringey",NA,22746,28384,30915,23611,23501,27532,31407,30376,755,-852,492,6765
"2120","Haringey 035D","E01002009","E02000431","Haringey 035","E09000014","Haringey","E12000007","London",1719,1567,152,72.5,708,2.2,"00AP","Haringey",NA,16183,26941,22433,30203,20457,29239,30700,29765,4274,2298,8267,-438
"2099","Haringey 030C","E01002010","E02000426","Haringey 030","E09000014","Haringey","E12000007","London",1658,1619,39,27.8,718,2.3,"00AP","Haringey",NA,11421,12663,10429,28788,15888,15806,13178,25743,4467,3143,2749,-3045
"2100","Haringey 030D","E01002011","E02000426","Haringey 030","E09000014","Haringey","E12000007","London",1718,1718,0,26.5,761,2.3,"00AP","Haringey",NA,11154,12932,11669,26279,13963,16622,17110,22647,2809,3690,5441,-3632
"2065","Haringey 022A","E01002013","E02000418","Haringey 022","E09000014","Haringey","E12000007","London",1401,1401,0,115.9,595,2.4,"00AP","Haringey",NA,15782,16214,19288,30478,20896,17745,22628,29754,5114,1531,3340,-724
"2056","Haringey 020B","E01002014","E02000416","Haringey 020","E09000014","Haringey","E12000007","London",1719,1711,8,101.3,797,2.1,"00AP","Haringey",NA,8213,7201,9159,21718,12224,10692,15978,26288,4011,3491,6819,4570
"2057","Haringey 020C","E01002015","E02000416","Haringey 020","E09000014","Haringey","E12000007","London",1480,1480,0,122.4,668,2.2,"00AP","Haringey",NA,7806,5070,6960,16080,8751,6207,6738,26450,945,1137,-222,10370
"2089","Haringey 028A","E01002016","E02000424","Haringey 028","E09000014","Haringey","E12000007","London",1959,1959,0,115.9,864,2.3,"00AP","Haringey",NA,7444,5142,6804,24130,12355,9488,11166,25542,4911,4346,4362,1412
"2090","Haringey 028B","E01002017","E02000424","Haringey 028","E09000014","Haringey","E12000007","London",1809,1667,142,132.2,751,2.2,"00AP","Haringey",NA,8744,10221,6717,23616,10857,9925,8530,25904,2113,-296,1813,2288
"2058","Haringey 020D","E01002018","E02000416","Haringey 020","E09000014","Haringey","E12000007","London",1420,1420,0,116.9,602,2.4,"00AP","Haringey",NA,8068,6026,9153,18290,11928,9364,11222,23026,3860,3338,2069,4736
"2066","Haringey 022B","E01002019","E02000418","Haringey 022","E09000014","Haringey","E12000007","London",1309,1309,0,52,503,2.6,"00AP","Haringey",NA,19504,23637,23741,31794,25410,28984,30175,32388,5906,5347,6434,594
"2061","Haringey 021A","E01002020","E02000417","Haringey 021","E09000014","Haringey","E12000007","London",1564,1564,0,53.4,706,2.2,"00AP","Haringey",NA,9395,9090,11571,23030,12998,15313,14421,28043,3603,6223,2850,5013
"2067","Haringey 022C","E01002021","E02000418","Haringey 022","E09000014","Haringey","E12000007","London",1479,1479,0,79.8,603,2.5,"00AP","Haringey",NA,19678,19881,24069,31990,24863,24357,27250,32407,5185,4476,3181,417
"2062","Haringey 021B","E01002022","E02000417","Haringey 021","E09000014","Haringey","E12000007","London",1921,1829,92,94.1,867,2.1,"00AP","Haringey",NA,11241,18191,13523,31721,18008,23199,28368,29614,6767,5008,14845,-2107
"2063","Haringey 021C","E01002023","E02000417","Haringey 021","E09000014","Haringey","E12000007","London",1474,1474,0,90.3,609,2.4,"00AP","Haringey",NA,22065,23229,25562,32471,19019,22910,26417,32531,-3046,-319,855,60
"2068","Haringey 022D","E01002024","E02000418","Haringey 022","E09000014","Haringey","E12000007","London",1320,1320,0,85.2,534,2.5,"00AP","Haringey",NA,10073,11464,12640,27083,16708,14805,18216,31674,6635,3341,5576,4591
"2064","Haringey 021D","E01002025","E02000417","Haringey 021","E09000014","Haringey","E12000007","London",1717,1717,0,43,670,2.6,"00AP","Haringey",NA,23735,25407,29917,32465,27905,29237,31346,32448,4170,3830,1429,-17
"2040","Haringey 016A","E01002026","E02000412","Haringey 016","E09000014","Haringey","E12000007","London",1619,1619,0,137.7,711,2.3,"00AP","Haringey",NA,1683,1030,1763,8649,1119,1286,1893,5107,-564,256,130,-3542
"2016","Haringey 010A","E01002027","E02000406","Haringey 010","E09000014","Haringey","E12000007","London",1537,1537,0,139.3,552,2.8,"00AP","Haringey",NA,5489,3065,7974,14443,6663,5244,8113,13118,1174,2179,139,-1325
"2017","Haringey 010B","E01002028","E02000406","Haringey 010","E09000014","Haringey","E12000007","London",1767,1767,0,147.4,645,2.7,"00AP","Haringey",NA,5384,3424,7142,11155,8106,7166,11267,9949,2722,3742,4125,-1206
"2041","Haringey 016B","E01002029","E02000412","Haringey 016","E09000014","Haringey","E12000007","London",1725,1590,135,73.3,740,2.1,"00AP","Haringey",NA,1619,1964,1841,11036,4189,6327,7882,12725,2570,4363,6041,1689
"2042","Haringey 016C","E01002030","E02000412","Haringey 016","E09000014","Haringey","E12000007","London",1640,1640,0,58.9,658,2.5,"00AP","Haringey",NA,6666,5178,7688,19023,9297,10660,13589,17679,2631,5482,5901,-1344
"2043","Haringey 016D","E01002031","E02000412","Haringey 016","E09000014","Haringey","E12000007","London",1930,1911,19,137.6,764,2.5,"00AP","Haringey",NA,3403,2753,6374,19538,5678,9167,13601,16046,2275,6414,7227,-3492
"2018","Haringey 010C","E01002032","E02000406","Haringey 010","E09000014","Haringey","E12000007","London",1813,1813,0,172.2,759,2.4,"00AP","Haringey",NA,2850,1798,4055,10323,4592,4327,6241,10406,1742,2529,2186,83
"2019","Haringey 010D","E01002033","E02000406","Haringey 010","E09000014","Haringey","E12000007","London",1908,1908,0,155.6,709,2.7,"00AP","Haringey",NA,3506,1449,5515,11599,4742,4333,5841,10382,1236,2884,326,-1217
"2125","Haringey 037A","E01002034","E02006794","Haringey 037","E09000014","Haringey","E12000007","London",1859,1858,1,65.8,811,2.3,"00AP","Haringey",NA,547,516,1085,6792,1443,1747,2632,5879,896,1231,1547,-913
"1988","Haringey 002A","E01002036","E02000398","Haringey 002","E09000014","Haringey","E12000007","London",1619,1618,1,94.4,637,2.5,"00AP","Haringey",NA,2947,1502,2874,9386,1371,1739,1146,4327,-1576,237,-1728,-5059
"1989","Haringey 002B","E01002037","E02000398","Haringey 002","E09000014","Haringey","E12000007","London",1832,1728,104,23,697,2.5,"00AP","Haringey",NA,561,223,132,5636,931,1077,1126,5479,370,854,994,-157
"2126","Haringey 037B","E01002038","E02006794","Haringey 037","E09000014","Haringey","E12000007","London",1653,1653,0,119.1,692,2.4,"00AP","Haringey",NA,1338,1144,2671,4919,1684,2479,3964,2723,346,1335,1293,-2196
"1990","Haringey 002C","E01002039","E02000398","Haringey 002","E09000014","Haringey","E12000007","London",1610,1610,0,213.2,639,2.5,"00AP","Haringey",NA,2041,445,1945,8414,1190,493,1630,3584,-851,48,-315,-4830
"1991","Haringey 002D","E01002040","E02000398","Haringey 002","E09000014","Haringey","E12000007","London",2062,2043,19,139.2,740,2.8,"00AP","Haringey",NA,3222,1257,2664,8998,3194,3066,3207,8270,-28,1809,543,-728
"2127","Haringey 037C","E01002041","E02006794","Haringey 037","E09000014","Haringey","E12000007","London",1886,1877,9,148.3,736,2.6,"00AP","Haringey",NA,2431,1021,2060,8622,2974,1840,3556,7481,543,819,1496,-1141
"2085","Haringey 027A","E01002042","E02000423","Haringey 027","E09000014","Haringey","E12000007","London",1459,1416,43,60.4,541,2.6,"00AP","Haringey",NA,8061,6230,6738,13782,9909,10239,12854,16595,1848,4009,6116,2813
"2081","Haringey 026A","E01002043","E02000422","Haringey 026","E09000014","Haringey","E12000007","London",2020,2017,3,185.5,742,2.7,"00AP","Haringey",NA,4769,2612,6587,10665,6650,7256,12870,10372,1881,4644,6283,-293
"2086","Haringey 027B","E01002044","E02000423","Haringey 027","E09000014","Haringey","E12000007","London",1729,1722,7,193.2,693,2.5,"00AP","Haringey",NA,7595,5082,7493,16764,9526,13098,15337,24715,1931,8016,7844,7951
"2082","Haringey 026B","E01002045","E02000422","Haringey 026","E09000014","Haringey","E12000007","London",2199,2199,0,157.9,803,2.7,"00AP","Haringey",NA,2192,386,2937,12148,6210,6015,9139,16032,4018,5629,6202,3884
"2083","Haringey 026C","E01002046","E02000422","Haringey 026","E09000014","Haringey","E12000007","London",1725,1686,39,101.8,676,2.5,"00AP","Haringey",NA,2995,1441,3390,8271,4240,4515,5573,13512,1245,3074,2183,5241
"2087","Haringey 027C","E01002047","E02000423","Haringey 027","E09000014","Haringey","E12000007","London",1670,1651,19,164.4,592,2.8,"00AP","Haringey",NA,7466,5364,9076,23222,8995,12226,17636,16385,1529,6862,8560,-6837
"2088","Haringey 027D","E01002048","E02000423","Haringey 027","E09000014","Haringey","E12000007","London",1955,1920,35,159.9,690,2.8,"00AP","Haringey",NA,5227,2669,5949,16513,8298,7510,11603,14856,3071,4841,5654,-1657
"2084","Haringey 026D","E01002049","E02000422","Haringey 026","E09000014","Haringey","E12000007","London",1881,1881,0,150.6,705,2.7,"00AP","Haringey",NA,3507,2141,3299,9155,5468,4483,6867,8638,1961,2342,3568,-517
"2093","Haringey 029A","E01002050","E02000425","Haringey 029","E09000014","Haringey","E12000007","London",1895,1895,0,174,467,4.1,"00AP","Haringey",NA,10029,4625,13019,16941,12742,15730,19196,5497,2713,11105,6177,-11444
"2094","Haringey 029B","E01002051","E02000425","Haringey 029","E09000014","Haringey","E12000007","London",1683,1678,5,137.4,667,2.5,"00AP","Haringey",NA,3175,2583,5900,11708,5176,6122,8302,9490,2001,3539,2402,-2218
"2095","Haringey 029C","E01002052","E02000425","Haringey 029","E09000014","Haringey","E12000007","London",2020,2020,0,94.4,526,3.8,"00AP","Haringey",NA,5720,1558,8872,8013,8852,10082,8702,6294,3132,8524,-170,-1719
"2105","Haringey 032A","E01002053","E02000428","Haringey 032","E09000014","Haringey","E12000007","London",1745,1737,8,121.9,663,2.6,"00AP","Haringey",NA,3584,1660,3940,15070,4186,3409,5577,9418,602,1749,1637,-5652
"2106","Haringey 032B","E01002054","E02000428","Haringey 032","E09000014","Haringey","E12000007","London",1732,1732,0,208.9,697,2.5,"00AP","Haringey",NA,1786,377,2678,7529,4072,3098,3960,8935,2286,2721,1282,1406
"2096","Haringey 029D","E01002055","E02000425","Haringey 029","E09000014","Haringey","E12000007","London",1658,1658,0,173.4,456,3.6,"00AP","Haringey",NA,5142,5257,9349,10438,10357,14513,17367,7797,5215,9256,8018,-2641
"2107","Haringey 032C","E01002056","E02000428","Haringey 032","E09000014","Haringey","E12000007","London",1964,1964,0,92.6,841,2.3,"00AP","Haringey",NA,3240,2387,3823,10093,5461,4357,7779,15521,2221,1970,3956,5428
"2108","Haringey 032D","E01002057","E02000428","Haringey 032","E09000014","Haringey","E12000007","London",1581,1581,0,99.7,557,2.8,"00AP","Haringey",NA,4968,1216,6962,11887,8562,4816,12408,16788,3594,3600,5446,4901
"2104","Haringey 031D","E01002058","E02000427","Haringey 031","E09000014","Haringey","E12000007","London",1690,1690,0,109.4,681,2.5,"00AP","Haringey",NA,8942,6442,11614,17868,7673,7367,10616,18383,-1269,925,-998,515
"2091","Haringey 028C","E01002059","E02000424","Haringey 028","E09000014","Haringey","E12000007","London",1671,1671,0,71.2,710,2.4,"00AP","Haringey",NA,10063,7041,9143,25813,12861,9857,10424,29448,2798,2816,1281,3635
"2092","Haringey 028D","E01002060","E02000424","Haringey 028","E09000014","Haringey","E12000007","London",1759,1759,0,140.2,763,2.3,"00AP","Haringey",NA,14238,12230,13264,30403,21331,18606,19241,29633,7093,6376,5977,-770
"2121","Haringey 036A","E01002061","E02000432","Haringey 036","E09000014","Haringey","E12000007","London",1687,1687,0,100.8,703,2.4,"00AP","Haringey",NA,10598,11959,11108,30810,16193,16932,18928,31553,5595,4973,7820,743
"2116","Haringey 034D","E01002062","E02000430","Haringey 034","E09000014","Haringey","E12000007","London",1874,1874,0,94.4,855,2.2,"00AP","Haringey",NA,9644,9364,10185,23879,16958,16610,20255,30828,7314,7246,10070,6949
"2122","Haringey 036B","E01002063","E02000432","Haringey 036","E09000014","Haringey","E12000007","London",1587,1587,0,112.5,713,2.2,"00AP","Haringey",NA,8983,7760,7761,26628,11556,10177,13180,23902,2573,2417,5419,-2726
"2123","Haringey 036C","E01002064","E02000432","Haringey 036","E09000014","Haringey","E12000007","London",1514,1514,0,162.3,648,2.3,"00AP","Haringey",NA,5881,3610,5733,18839,7641,5767,9252,17914,1760,2157,3519,-925
"2124","Haringey 036D","E01002065","E02000432","Haringey 036","E09000014","Haringey","E12000007","London",1666,1633,33,124.2,815,2,"00AP","Haringey",NA,7468,9831,7655,21699,10629,11188,13588,27827,3161,1357,5933,6128
"2077","Haringey 025A","E01002066","E02000421","Haringey 025","E09000014","Haringey","E12000007","London",1843,1843,0,93.6,781,2.4,"00AP","Haringey",NA,1139,430,3093,10038,2354,1997,3227,8884,1215,1567,134,-1154
"2073","Haringey 024A","E01002067","E02000420","Haringey 024","E09000014","Haringey","E12000007","London",1694,1694,0,117.2,700,2.4,"00AP","Haringey",NA,1724,1182,3085,10731,2829,2447,3721,9603,1105,1265,636,-1128
"2078","Haringey 025B","E01002068","E02000421","Haringey 025","E09000014","Haringey","E12000007","London",1822,1822,0,61.3,739,2.5,"00AP","Haringey",NA,5010,2986,6379,10472,5496,6578,7598,9861,486,3592,1219,-611
"2074","Haringey 024B","E01002069","E02000420","Haringey 024","E09000014","Haringey","E12000007","London",1937,1937,0,121.3,880,2.2,"00AP","Haringey",NA,2389,1743,4339,10757,2910,4216,5869,8839,521,2473,1530,-1918
"2075","Haringey 024C","E01002070","E02000420","Haringey 024","E09000014","Haringey","E12000007","London",2038,2032,6,126,789,2.6,"00AP","Haringey",NA,7236,3664,8263,19953,7538,7820,12415,17622,302,4156,4152,-2331
"2079","Haringey 025C","E01002071","E02000421","Haringey 025","E09000014","Haringey","E12000007","London",1615,1615,0,149.8,675,2.4,"00AP","Haringey",NA,2196,993,2980,8922,1279,1088,3291,10034,-917,95,311,1112
"2080","Haringey 025D","E01002072","E02000421","Haringey 025","E09000014","Haringey","E12000007","London",1868,1678,190,102.8,680,2.5,"00AP","Haringey",NA,2846,2291,2999,13203,4746,5335,8613,13540,1900,3044,5614,337
"2076","Haringey 024D","E01002073","E02000420","Haringey 024","E09000014","Haringey","E12000007","London",1763,1762,1,158.8,681,2.6,"00AP","Haringey",NA,4750,2488,5666,9723,3145,4505,8965,6327,-1605,2017,3299,-3396
"2024","Haringey 012A","E01002074","E02000408","Haringey 012","E09000014","Haringey","E12000007","London",2122,2099,23,160,849,2.5,"00AP","Haringey",NA,2166,1209,2237,10274,2181,1851,2772,6452,15,642,535,-3822
"2036","Haringey 015A","E01002075","E02000411","Haringey 015","E09000014","Haringey","E12000007","London",1777,1775,2,47.6,595,3,"00AP","Haringey",NA,4706,1960,5023,11165,5691,4328,8296,6930,985,2368,3273,-4235
"2037","Haringey 015B","E01002076","E02000411","Haringey 015","E09000014","Haringey","E12000007","London",1888,1888,0,173.8,639,3,"00AP","Haringey",NA,4823,1782,5699,7599,4801,4287,6337,8538,-22,2505,638,939
"2025","Haringey 012B","E01002077","E02000408","Haringey 012","E09000014","Haringey","E12000007","London",2079,2079,0,147.2,686,3,"00AP","Haringey",NA,1194,500,2964,5442,3962,3687,8072,6690,2768,3187,5108,1248
"2038","Haringey 015C","E01002078","E02000411","Haringey 015","E09000014","Haringey","E12000007","London",2194,2194,0,77.7,951,2.3,"00AP","Haringey",NA,3492,2507,4960,13460,4184,4002,7036,10566,692,1495,2076,-2894
"2026","Haringey 012C","E01002079","E02000408","Haringey 012","E09000014","Haringey","E12000007","London",1642,1630,12,156.4,539,3,"00AP","Haringey",NA,7116,3135,8791,9820,7357,4198,10613,11867,241,1063,1822,2047
"2039","Haringey 015D","E01002080","E02000411","Haringey 015","E09000014","Haringey","E12000007","London",1593,1593,0,25.3,510,3.1,"00AP","Haringey",NA,5767,3634,5034,11598,5324,3471,6291,15715,-443,-163,1257,4117
"2027","Haringey 012D","E01002081","E02000408","Haringey 012","E09000014","Haringey","E12000007","London",1769,1769,0,127.2,615,2.9,"00AP","Haringey",NA,1542,262,1592,6878,1804,1696,4188,5147,262,1434,2596,-1731
"2028","Haringey 013A","E01002082","E02000409","Haringey 013","E09000014","Haringey","E12000007","London",1508,1508,0,78.4,568,2.7,"00AP","Haringey",NA,3712,1338,5634,7021,1801,1287,1345,5306,-1911,-51,-4289,-1715
"2052","Haringey 019A","E01002083","E02000415","Haringey 019","E09000014","Haringey","E12000007","London",1440,1440,0,93.6,543,2.7,"00AP","Haringey",NA,11023,7599,12750,22214,14021,11630,17032,23381,2998,4031,4282,1167
"2053","Haringey 019B","E01002084","E02000415","Haringey 019","E09000014","Haringey","E12000007","London",1623,1617,6,53.1,619,2.6,"00AP","Haringey",NA,5688,5069,7817,17019,7783,8457,9815,12273,2095,3388,1998,-4746
"2054","Haringey 019C","E01002085","E02000415","Haringey 019","E09000014","Haringey","E12000007","London",2168,2168,0,166.1,821,2.6,"00AP","Haringey",NA,4647,2749,7164,15382,7208,5764,10652,16443,2561,3015,3488,1061
"2029","Haringey 013B","E01002086","E02000409","Haringey 013","E09000014","Haringey","E12000007","London",1646,1589,57,67.2,605,2.6,"00AP","Haringey",NA,3959,1858,4284,12853,5022,4068,6002,11823,1063,2210,1718,-1030
"2055","Haringey 019D","E01002087","E02000415","Haringey 019","E09000014","Haringey","E12000007","London",1614,1586,28,141.1,714,2.2,"00AP","Haringey",NA,4121,2737,4099,19220,4909,5115,5864,16817,788,2378,1765,-2403
"2030","Haringey 013C","E01002088","E02000409","Haringey 013","E09000014","Haringey","E12000007","London",1853,1853,0,88,688,2.7,"00AP","Haringey",NA,7840,4001,10294,18405,9863,10293,14786,9162,2023,6292,4492,-9243
"2031","Haringey 013D","E01002089","E02000409","Haringey 013","E09000014","Haringey","E12000007","London",1520,1520,0,327.6,644,2.4,"00AP","Haringey",NA,1626,78,1503,9224,1271,488,669,4693,-355,410,-834,-4531
"1996","Haringey 005A","E01002090","E02000401","Haringey 005","E09000014","Haringey","E12000007","London",1601,1601,0,70.9,531,3,"00AP","Haringey",NA,3778,1343,4200,8029,4958,3647,5855,8250,1180,2304,1655,221
"2000","Haringey 006A","E01002091","E02000402","Haringey 006","E09000014","Haringey","E12000007","London",1802,1802,0,86.6,635,2.8,"00AP","Haringey",NA,2113,370,2696,7106,2176,1307,3184,5781,63,937,488,-1325
"2001","Haringey 006B","E01002092","E02000402","Haringey 006","E09000014","Haringey","E12000007","London",1697,1697,0,82.2,689,2.5,"00AP","Haringey",NA,3519,1804,5549,4586,3160,2579,5529,10702,-359,775,-20,6116
"1997","Haringey 005B","E01002093","E02000401","Haringey 005","E09000014","Haringey","E12000007","London",1795,1795,0,78.7,645,2.8,"00AP","Haringey",NA,1967,737,2648,6741,2399,1592,3517,5355,432,855,869,-1386
"2002","Haringey 006C","E01002094","E02000402","Haringey 006","E09000014","Haringey","E12000007","London",1554,1554,0,61.5,541,2.9,"00AP","Haringey",NA,2048,1006,3754,4566,2680,1842,4280,5074,632,836,526,508
"2003","Haringey 006D","E01002095","E02000402","Haringey 006","E09000014","Haringey","E12000007","London",1644,1644,0,58,604,2.7,"00AP","Haringey",NA,2233,1069,3176,7515,2217,1190,3398,6885,-16,121,222,-630
"1998","Haringey 005C","E01002096","E02000401","Haringey 005","E09000014","Haringey","E12000007","London",1645,1645,0,89.3,583,2.8,"00AP","Haringey",NA,2774,725,4365,9549,3888,3519,5110,10125,1114,2794,745,576
"1999","Haringey 005D","E01002097","E02000401","Haringey 005","E09000014","Haringey","E12000007","London",1693,1693,0,156,592,2.9,"00AP","Haringey",NA,1816,546,3921,11479,3408,1939,5555,7846,1592,1393,1634,-3633
"2004","Haringey 007A","E01002098","E02000403","Haringey 007","E09000014","Haringey","E12000007","London",1349,1349,0,68.9,604,2.2,"00AP","Haringey",NA,10701,9258,14199,22408,11934,10554,15433,19851,1233,1296,1234,-2557
"2008","Haringey 008A","E01002099","E02000404","Haringey 008","E09000014","Haringey","E12000007","London",2108,2108,0,133.2,813,2.6,"00AP","Haringey",NA,2458,497,3022,11087,2808,1963,4426,7556,350,1466,1404,-3531
"2009","Haringey 008B","E01002100","E02000404","Haringey 008","E09000014","Haringey","E12000007","London",1909,1909,0,135,680,2.8,"00AP","Haringey",NA,3333,1844,4634,9163,7023,6250,9280,10823,3690,4406,4646,1660
"2005","Haringey 007B","E01002101","E02000403","Haringey 007","E09000014","Haringey","E12000007","London",1916,1916,0,93.1,698,2.7,"00AP","Haringey",NA,7242,3179,7333,18300,11321,12053,17020,15806,4079,8874,9687,-2494
"2006","Haringey 007C","E01002102","E02000403","Haringey 007","E09000014","Haringey","E12000007","London",1882,1877,5,59.1,752,2.5,"00AP","Haringey",NA,4149,2912,5673,13725,8182,8239,11894,18525,4033,5327,6221,4800
"2010","Haringey 008C","E01002103","E02000404","Haringey 008","E09000014","Haringey","E12000007","London",1862,1856,6,108.4,646,2.9,"00AP","Haringey",NA,5535,5202,8507,14576,10488,8835,14712,15912,4953,3633,6205,1336
"2011","Haringey 008D","E01002104","E02000404","Haringey 008","E09000014","Haringey","E12000007","London",1436,1431,5,84.6,501,2.9,"00AP","Haringey",NA,6107,3358,8017,11493,9618,7902,9463,14241,3511,4544,1446,2748
"2007","Haringey 007D","E01002105","E02000403","Haringey 007","E09000014","Haringey","E12000007","London",2052,2052,0,156.5,861,2.4,"00AP","Haringey",NA,5396,4911,7023,13284,7965,9697,14655,15792,2569,4786,7632,2508
"2161","Harrow 008A","E01002106","E02000440","Harrow 008","E09000015","Harrow","E12000007","London",2027,1983,44,75.6,651,3,"00AQ","Harrow",NA,20854,14218,19431,29067,23159,18168,22378,23858,2305,3950,2947,-5209
"2180","Harrow 012A","E01002107","E02000444","Harrow 012","E09000015","Harrow","E12000007","London",1774,1774,0,62.6,575,3.1,"00AQ","Harrow",NA,25230,17451,20688,30149,28030,24119,28249,29112,2800,6668,7561,-1037
"2162","Harrow 008B","E01002108","E02000440","Harrow 008","E09000015","Harrow","E12000007","London",1819,1819,0,90.1,559,3.3,"00AQ","Harrow",NA,26285,18171,26015,29788,27073,19369,26308,28240,788,1198,293,-1548
"2163","Harrow 008C","E01002109","E02000440","Harrow 008","E09000015","Harrow","E12000007","London",1789,1785,4,35.1,654,2.7,"00AQ","Harrow",NA,26058,18188,25105,31706,25960,21329,28086,27466,-98,3141,2981,-4240
"2164","Harrow 008D","E01002110","E02000440","Harrow 008","E09000015","Harrow","E12000007","London",1762,1762,0,72.4,542,3.3,"00AQ","Harrow",NA,24838,22439,23996,30631,27886,22593,26878,29244,3048,154,2882,-1387
"2165","Harrow 008E","E01002111","E02000440","Harrow 008","E09000015","Harrow","E12000007","London",2172,2169,3,79.7,681,3.2,"00AQ","Harrow",NA,19944,15256,16218,27527,20446,14956,19004,24174,502,-300,2786,-3353
"2129","Harrow 001A","E01002112","E02000433","Harrow 001","E09000015","Harrow","E12000007","London",1890,1890,0,24.1,697,2.7,"00AQ","Harrow",NA,29413,26645,27260,31642,28389,23662,30606,30192,-1024,-2983,3346,-1450
"2133","Harrow 002A","E01002113","E02000434","Harrow 002","E09000015","Harrow","E12000007","London",1547,1547,0,25.1,599,2.6,"00AQ","Harrow",NA,18865,15597,12678,31319,17859,14742,13854,28590,-1006,-855,1176,-2729
"2130","Harrow 001B","E01002114","E02000433","Harrow 001","E09000015","Harrow","E12000007","London",1993,1990,3,6.9,986,2,"00AQ","Harrow",NA,18561,13757,14981,28571,14343,11130,17866,19311,-4218,-2627,2885,-9260
"2134","Harrow 002B","E01002115","E02000434","Harrow 002","E09000015","Harrow","E12000007","London",1509,1509,0,43.8,509,3,"00AQ","Harrow",NA,21879,16777,21381,30350,20056,16151,21888,25857,-1823,-626,507,-4493
"2135","Harrow 002C","E01002116","E02000434","Harrow 002","E09000015","Harrow","E12000007","London",1668,1668,0,54.7,680,2.5,"00AQ","Harrow",NA,24876,17255,27010,31760,28175,24287,30004,30646,3299,7032,2994,-1114
"2136","Harrow 002D","E01002117","E02000434","Harrow 002","E09000015","Harrow","E12000007","London",2105,2105,0,49.5,675,3.1,"00AQ","Harrow",NA,23612,18935,22513,31125,17263,11291,14006,26791,-6349,-7644,-8507,-4334
"2137","Harrow 002E","E01002118","E02000434","Harrow 002","E09000015","Harrow","E12000007","London",1759,1696,63,64.5,675,2.5,"00AQ","Harrow",NA,16655,12425,19225,29634,16266,12393,20645,22582,-389,-32,1420,-7052
"2156","Harrow 007A","E01002119","E02000439","Harrow 007","E09000015","Harrow","E12000007","London",1708,1708,0,73.1,568,3,"00AQ","Harrow",NA,12968,7394,13926,26768,15353,13254,18616,20445,2385,5860,4690,-6323
"2157","Harrow 007B","E01002120","E02000439","Harrow 007","E09000015","Harrow","E12000007","London",1296,1296,0,75.7,488,2.7,"00AQ","Harrow",NA,8287,3728,5069,16574,8019,5384,7618,14340,-268,1656,2549,-2234
"2158","Harrow 007C","E01002121","E02000439","Harrow 007","E09000015","Harrow","E12000007","London",1761,1761,0,62.3,546,3.2,"00AQ","Harrow",NA,15968,9635,13818,24523,21494,18899,23848,22431,5526,9264,10030,-2092
"2159","Harrow 007D","E01002122","E02000439","Harrow 007","E09000015","Harrow","E12000007","London",1706,1706,0,83.5,582,2.9,"00AQ","Harrow",NA,19707,14389,18236,28353,20731,17345,22000,20674,1024,2956,3764,-7679
"2160","Harrow 007E","E01002123","E02000439","Harrow 007","E09000015","Harrow","E12000007","London",1735,1735,0,101,527,3.3,"00AQ","Harrow",NA,10650,10374,13788,24594,15769,14688,23622,16525,5119,4314,9834,-8069
"2170","Harrow 010A","E01002124","E02000442","Harrow 010","E09000015","Harrow","E12000007","London",1769,1769,0,105.3,492,3.6,"00AQ","Harrow",NA,17870,12300,14714,19873,18975,17961,22230,11319,1105,5661,7516,-8554
"2171","Harrow 010B","E01002125","E02000442","Harrow 010","E09000015","Harrow","E12000007","London",1678,1678,0,99,512,3.3,"00AQ","Harrow",NA,15300,9910,15050,25806,16882,15014,24940,13641,1582,5104,9890,-12165
"2219","Harrow 023A","E01002126","E02000455","Harrow 023","E09000015","Harrow","E12000007","London",2781,2747,34,73.3,1203,2.3,"00AQ","Harrow",NA,17373,14348,16590,31035,19107,17086,24212,30443,1734,2738,7622,-592
"2220","Harrow 023B","E01002127","E02000455","Harrow 023","E09000015","Harrow","E12000007","London",1687,1653,34,60.8,628,2.6,"00AQ","Harrow",NA,20114,16720,17287,30493,20808,18530,20251,30415,694,1810,2964,-78
"2207","Harrow 020A","E01002128","E02000452","Harrow 020","E09000015","Harrow","E12000007","London",2025,1968,57,110.7,784,2.5,"00AQ","Harrow",NA,11134,11508,8351,22697,17293,14903,16367,28134,6159,3395,8016,5437
"2221","Harrow 023C","E01002129","E02000455","Harrow 023","E09000015","Harrow","E12000007","London",2043,2026,17,49.8,889,2.3,"00AQ","Harrow",NA,12957,9931,10142,29995,17495,14018,13993,25622,4538,4087,3851,-4373
"2208","Harrow 020B","E01002130","E02000452","Harrow 020","E09000015","Harrow","E12000007","London",2260,2260,0,68.1,884,2.6,"00AQ","Harrow",NA,8922,6680,9532,24013,9742,8202,12999,21448,820,1522,3467,-2565
"2222","Harrow 023D","E01002131","E02000455","Harrow 023","E09000015","Harrow","E12000007","London",1624,1624,0,98.8,586,2.8,"00AQ","Harrow",NA,10632,5118,9872,19808,10210,7222,9328,20782,-422,2104,-544,974
"2239","Harrow 029A","E01002132","E02000461","Harrow 029","E09000015","Harrow","E12000007","London",2012,1962,50,49.6,828,2.4,"00AQ","Harrow",NA,21664,25013,23481,30172,25968,24381,28851,30996,4304,-632,5370,824
"2231","Harrow 027A","E01002133","E02000459","Harrow 027","E09000015","Harrow","E12000007","London",2031,2031,0,51.4,896,2.3,"00AQ","Harrow",NA,7423,3432,5497,18668,8053,5869,7404,14260,630,2437,1907,-4408
"2240","Harrow 029B","E01002134","E02000461","Harrow 029","E09000015","Harrow","E12000007","London",1462,1419,43,11.8,603,2.4,"00AQ","Harrow",NA,28624,27146,31558,30108,28793,26824,26264,31885,169,-322,-5294,1777
"2241","Harrow 029C","E01002135","E02000461","Harrow 029","E09000015","Harrow","E12000007","London",1765,1700,65,42,657,2.6,"00AQ","Harrow",NA,16324,10177,17219,22466,18696,15873,19537,18600,2372,5696,2318,-3866
"2232","Harrow 027B","E01002136","E02000459","Harrow 027","E09000015","Harrow","E12000007","London",1741,1741,0,46.9,638,2.7,"00AQ","Harrow",NA,17180,14575,18790,28938,22423,15727,22594,30241,5243,1152,3804,1303
"2242","Harrow 029D","E01002137","E02000461","Harrow 029","E09000015","Harrow","E12000007","London",1708,985,723,28.8,468,2.1,"00AQ","Harrow",NA,24279,32344,32258,28703,27772,32305,32617,20602,3493,-39,359,-8101
"2233","Harrow 027C","E01002138","E02000459","Harrow 027","E09000015","Harrow","E12000007","London",1551,1544,7,105.5,509,3,"00AQ","Harrow",NA,15909,8678,14540,28400,17257,10134,18394,23437,1348,1456,3854,-4963
"2151","Harrow 006A","E01002139","E02000438","Harrow 006","E09000015","Harrow","E12000007","London",1428,1426,2,61.5,498,2.9,"00AQ","Harrow",NA,7661,2993,5446,11436,7164,4281,5945,9259,-497,1288,499,-2177
"2146","Harrow 005A","E01002140","E02000437","Harrow 005","E09000015","Harrow","E12000007","London",1706,1702,4,68.2,607,2.8,"00AQ","Harrow",NA,17886,11424,17240,25833,16620,11918,15215,20930,-1266,494,-2025,-4903
"2147","Harrow 005B","E01002141","E02000437","Harrow 005","E09000015","Harrow","E12000007","London",1763,1753,10,61.5,680,2.6,"00AQ","Harrow",NA,20672,14476,19995,27659,18982,14064,17466,26504,-1690,-412,-2529,-1155
"2148","Harrow 005C","E01002142","E02000437","Harrow 005","E09000015","Harrow","E12000007","London",1779,1779,0,48.7,635,2.8,"00AQ","Harrow",NA,21770,21263,25881,28741,22752,17498,25103,28337,982,-3765,-778,-404
"2149","Harrow 005D","E01002143","E02000437","Harrow 005","E09000015","Harrow","E12000007","London",1571,1568,3,86.9,529,3,"00AQ","Harrow",NA,15361,10708,13245,19176,13946,9296,12128,18645,-1415,-1412,-1117,-531
"2142","Harrow 004A","E01002144","E02000436","Harrow 004","E09000015","Harrow","E12000007","London",1571,1570,1,5.3,580,2.7,"00AQ","Harrow",NA,19175,15199,24132,28133,20613,21340,22243,24511,1438,6141,-1889,-3622
"2150","Harrow 005E","E01002145","E02000437","Harrow 005","E09000015","Harrow","E12000007","London",1558,1496,62,49.6,631,2.4,"00AQ","Harrow",NA,13185,15057,11018,28716,15703,12575,14812,27776,2518,-2482,3794,-940
"2143","Harrow 004B","E01002146","E02000436","Harrow 004","E09000015","Harrow","E12000007","London",1481,1481,0,17.6,519,2.9,"00AQ","Harrow",NA,31384,29384,30081,31635,32217,31842,31880,31084,833,2458,1799,-551
"2144","Harrow 004C","E01002147","E02000436","Harrow 004","E09000015","Harrow","E12000007","London",1369,1309,60,21.9,502,2.6,"00AQ","Harrow",NA,27284,25836,30244,32023,27836,27042,31960,31996,552,1206,1716,-27
"2152","Harrow 006B","E01002148","E02000438","Harrow 006","E09000015","Harrow","E12000007","London",1449,1449,0,43.2,491,3,"00AQ","Harrow",NA,26749,20399,24868,28676,25554,20352,23398,26290,-1195,-47,-1470,-2386
"2145","Harrow 004D","E01002149","E02000436","Harrow 004","E09000015","Harrow","E12000007","London",1361,1361,0,46.2,479,2.8,"00AQ","Harrow",NA,30970,31306,31272,32200,31429,28504,32213,32525,459,-2802,941,325
"2153","Harrow 006C","E01002150","E02000438","Harrow 006","E09000015","Harrow","E12000007","London",1883,1843,40,45.4,839,2.2,"00AQ","Harrow",NA,20733,13892,22518,30417,23791,16581,26913,24977,3058,2689,4395,-5440
"2154","Harrow 006D","E01002151","E02000438","Harrow 006","E09000015","Harrow","E12000007","London",1526,1479,47,50.1,524,2.8,"00AQ","Harrow",NA,7587,3069,6015,12895,6680,3890,4424,9986,-907,821,-1591,-2909
"2155","Harrow 006E","E01002152","E02000438","Harrow 006","E09000015","Harrow","E12000007","London",1624,1624,0,35,638,2.5,"00AQ","Harrow",NA,29787,27238,30428,32222,30452,27147,29568,32213,665,-91,-860,-9
"2203","Harrow 019A","E01002153","E02000451","Harrow 019","E09000015","Harrow","E12000007","London",1763,1757,6,60.5,616,2.9,"00AQ","Harrow",NA,29117,26598,27441,31854,29946,24496,25955,31387,829,-2102,-1486,-467
"2190","Harrow 015A","E01002154","E02000447","Harrow 015","E09000015","Harrow","E12000007","London",2021,2021,0,15.4,728,2.8,"00AQ","Harrow",NA,22036,15151,22472,28548,19869,15209,21238,28306,-2167,58,-1234,-242
"2204","Harrow 019B","E01002155","E02000451","Harrow 019","E09000015","Harrow","E12000007","London",1643,1630,13,22,641,2.5,"00AQ","Harrow",NA,27721,25086,26298,31792,29654,26774,28923,32291,1933,1688,2625,499
"2191","Harrow 015B","E01002156","E02000447","Harrow 015","E09000015","Harrow","E12000007","London",1522,1516,6,39.9,501,3,"00AQ","Harrow",NA,28069,26354,25502,31552,29315,26588,25767,30986,1246,234,265,-566
"2205","Harrow 019C","E01002157","E02000451","Harrow 019","E09000015","Harrow","E12000007","London",1687,1687,0,64,593,2.8,"00AQ","Harrow",NA,21287,17288,19394,31291,23810,17967,23215,28285,2523,679,3821,-3006
"2206","Harrow 019D","E01002158","E02000451","Harrow 019","E09000015","Harrow","E12000007","London",1457,1457,0,49,491,3,"00AQ","Harrow",NA,29674,26728,28982,31910,31583,30262,30674,32114,1909,3534,1692,204
"2211","Harrow 021A","E01002159","E02000453","Harrow 021","E09000015","Harrow","E12000007","London",1860,1857,3,79.9,685,2.7,"00AQ","Harrow",NA,18810,12948,14137,29879,24491,16330,21233,30307,5681,3382,7096,428
"2212","Harrow 021B","E01002160","E02000453","Harrow 021","E09000015","Harrow","E12000007","London",1967,1967,0,65,704,2.8,"00AQ","Harrow",NA,19455,13815,21302,25059,23237,15384,25183,29592,3782,1569,3881,4533
"2213","Harrow 021C","E01002161","E02000453","Harrow 021","E09000015","Harrow","E12000007","London",2030,2029,1,86.1,728,2.8,"00AQ","Harrow",NA,17615,9409,14162,29739,20834,12502,19732,28907,3219,3093,5570,-832
"2192","Harrow 015C","E01002162","E02000447","Harrow 015","E09000015","Harrow","E12000007","London",1879,1879,0,102.7,687,2.7,"00AQ","Harrow",NA,16186,10901,11950,29293,18895,12903,16619,27374,2709,2002,4669,-1919
"2193","Harrow 015D","E01002163","E02000447","Harrow 015","E09000015","Harrow","E12000007","London",1636,1636,0,66.7,537,3,"00AQ","Harrow",NA,25801,20632,24050,31103,24471,18392,21776,29564,-1330,-2240,-2274,-1539
"2214","Harrow 021D","E01002164","E02000453","Harrow 021","E09000015","Harrow","E12000007","London",1763,1753,10,67,683,2.6,"00AQ","Harrow",NA,21367,16235,20259,31083,27386,20487,24804,30719,6019,4252,4545,-364
"2198","Harrow 017A","E01002165","E02000449","Harrow 017","E09000015","Harrow","E12000007","London",1734,1734,0,84.2,528,3.3,"00AQ","Harrow",NA,14924,9768,15953,22670,20327,18643,21743,19017,5403,8875,5790,-3653
"2199","Harrow 017B","E01002166","E02000449","Harrow 017","E09000015","Harrow","E12000007","London",1663,1663,0,99,484,3.4,"00AQ","Harrow",NA,19183,11364,19189,22434,19502,13919,21857,19321,319,2555,2668,-3113
"2200","Harrow 017C","E01002167","E02000449","Harrow 017","E09000015","Harrow","E12000007","London",1629,1623,6,99.1,477,3.4,"00AQ","Harrow",NA,15545,8885,16404,19406,15074,13004,21208,12393,-471,4119,4804,-7013
"2201","Harrow 017D","E01002168","E02000449","Harrow 017","E09000015","Harrow","E12000007","London",1492,1492,0,85.5,511,2.9,"00AQ","Harrow",NA,8966,4651,7134,12942,10391,6575,11214,14243,1425,1924,4080,1301
"2202","Harrow 017E","E01002169","E02000449","Harrow 017","E09000015","Harrow","E12000007","London",1619,1619,0,78.9,531,3,"00AQ","Harrow",NA,13105,8054,14342,21106,17485,14045,20602,16745,4380,5991,6260,-4361
"2257","Harrow 033A","E01002170","E02006882","Harrow 033","E09000015","Harrow","E12000007","London",1324,1324,0,75.7,408,3.2,"00AQ","Harrow",NA,15469,10717,15761,23697,18538,14413,17882,17190,3069,3696,2121,-6507
"2258","Harrow 033B","E01002171","E02006882","Harrow 033","E09000015","Harrow","E12000007","London",1677,1677,0,89.2,534,3.1,"00AQ","Harrow",NA,18906,13965,15145,26952,21902,17351,23549,22366,2996,3386,8404,-4586
"2259","Harrow 033C","E01002172","E02006882","Harrow 033","E09000015","Harrow","E12000007","London",1579,1579,0,43.8,493,3.2,"00AQ","Harrow",NA,18984,15024,18551,20341,20120,14797,22591,18326,1136,-227,4040,-2015
"2260","Harrow 033D","E01002173","E02006882","Harrow 033","E09000015","Harrow","E12000007","London",1742,1730,12,86.5,529,3.3,"00AQ","Harrow",NA,19919,14347,18089,27670,21517,16249,21424,25747,1598,1902,3335,-1923
"2261","Harrow 033E","E01002174","E02006882","Harrow 033","E09000015","Harrow","E12000007","London",1582,1582,0,76.1,483,3.3,"00AQ","Harrow",NA,19652,16754,20086,26848,25135,19079,24031,25525,5483,2325,3945,-1323
"2262","Harrow 033F","E01002175","E02006882","Harrow 033","E09000015","Harrow","E12000007","London",1402,1379,23,68,406,3.4,"00AQ","Harrow",NA,14490,12145,14248,28475,22104,18347,24575,26938,7614,6202,10327,-1537
"2263","Harrow 033G","E01002176","E02006882","Harrow 033","E09000015","Harrow","E12000007","London",1746,1710,36,45.8,535,3.2,"00AQ","Harrow",NA,20842,19024,17138,29977,21450,21250,23273,24168,608,2226,6135,-5809
"2264","Harrow 033H","E01002177","E02006882","Harrow 033","E09000015","Harrow","E12000007","London",1443,1443,0,70.6,452,3.2,"00AQ","Harrow",NA,19426,11751,18280,29373,22133,17133,23385,22715,2707,5382,5105,-6658
"2265","Harrow 033I","E01002178","E02006882","Harrow 033","E09000015","Harrow","E12000007","London",1679,1679,0,82.4,502,3.3,"00AQ","Harrow",NA,25980,18620,23377,29945,25579,17515,24377,27106,-401,-1105,1000,-2839
"2185","Harrow 013A","E01002179","E02000445","Harrow 013","E09000015","Harrow","E12000007","London",2250,2247,3,88.5,795,2.8,"00AQ","Harrow",NA,11156,5938,10748,21102,11240,6409,13213,18698,84,471,2465,-2404
"2186","Harrow 013B","E01002180","E02000445","Harrow 013","E09000015","Harrow","E12000007","London",2085,2085,0,53.8,783,2.7,"00AQ","Harrow",NA,6524,2578,6478,19297,10247,7000,9453,15696,3723,4422,2975,-3601
"2209","Harrow 020C","E01002181","E02000452","Harrow 020","E09000015","Harrow","E12000007","London",1884,1853,31,46.1,682,2.7,"00AQ","Harrow",NA,20028,12157,16769,30402,24625,18258,22977,26705,4597,6101,6208,-3697
"2210","Harrow 020D","E01002182","E02000452","Harrow 020","E09000015","Harrow","E12000007","London",2049,2044,5,102.2,689,3,"00AQ","Harrow",NA,16425,10060,17266,28471,20308,16805,18627,28829,3883,6745,1361,358
"2187","Harrow 013C","E01002183","E02000445","Harrow 013","E09000015","Harrow","E12000007","London",2106,2070,36,113.1,682,3,"00AQ","Harrow",NA,11011,5445,9802,21609,16150,12928,17285,18193,5139,7483,7483,-3416
"2188","Harrow 013D","E01002184","E02000445","Harrow 013","E09000015","Harrow","E12000007","London",1885,1885,0,90.5,677,2.8,"00AQ","Harrow",NA,14161,8493,14878,24477,15551,10385,15009,19694,1390,1892,131,-4783
"2166","Harrow 009A","E01002185","E02000441","Harrow 009","E09000015","Harrow","E12000007","London",1543,1543,0,89.7,585,2.6,"00AQ","Harrow",NA,7216,3066,6422,15250,9188,5581,6917,13953,1972,2515,495,-1297
"2167","Harrow 009B","E01002186","E02000441","Harrow 009","E09000015","Harrow","E12000007","London",1656,1644,12,52.4,794,2.1,"00AQ","Harrow",NA,12895,7525,9937,23949,17175,14146,12927,24441,4280,6621,2990,492
"2168","Harrow 009C","E01002187","E02000441","Harrow 009","E09000015","Harrow","E12000007","London",1843,1821,22,38.1,761,2.4,"00AQ","Harrow",NA,20521,15210,19447,28166,22107,18432,20376,27681,1586,3222,929,-485
"2194","Harrow 016A","E01002188","E02000448","Harrow 016","E09000015","Harrow","E12000007","London",1651,1616,35,33.8,638,2.5,"00AQ","Harrow",NA,32150,32223,32034,32326,32444,32578,32439,32687,294,355,405,361
"2195","Harrow 016B","E01002189","E02000448","Harrow 016","E09000015","Harrow","E12000007","London",1661,1661,0,37.4,714,2.3,"00AQ","Harrow",NA,26245,28646,27015,31113,30538,27299,31106,32293,4293,-1347,4091,1180
"2169","Harrow 009D","E01002190","E02000441","Harrow 009","E09000015","Harrow","E12000007","London",1672,1672,0,12.3,625,2.7,"00AQ","Harrow",NA,30352,31796,29994,32063,30714,31474,31959,32034,362,-322,1965,-29
"2215","Harrow 022A","E01002191","E02000454","Harrow 022","E09000015","Harrow","E12000007","London",1964,1964,0,40.1,667,2.9,"00AQ","Harrow",NA,26120,20172,22831,31591,29980,25395,27145,31444,3860,5223,4314,-147
"2196","Harrow 016C","E01002192","E02000448","Harrow 016","E09000015","Harrow","E12000007","London",1532,1532,0,33.8,638,2.4,"00AQ","Harrow",NA,26189,23573,27152,29345,29331,25372,31827,32071,3142,1799,4675,2726
"2197","Harrow 016D","E01002193","E02000448","Harrow 016","E09000015","Harrow","E12000007","London",1797,1797,0,53.8,740,2.4,"00AQ","Harrow",NA,17656,12544,12948,29290,23847,16846,19019,29946,6191,4302,6071,656
"2216","Harrow 022B","E01002194","E02000454","Harrow 022","E09000015","Harrow","E12000007","London",1724,1721,3,40.5,657,2.6,"00AQ","Harrow",NA,28470,26250,24611,32370,31814,29596,29093,32432,3344,3346,4482,62
"2217","Harrow 022C","E01002195","E02000454","Harrow 022","E09000015","Harrow","E12000007","London",1635,1635,0,58.7,610,2.7,"00AQ","Harrow",NA,28388,22138,26532,31093,30768,25257,27091,30966,2380,3119,559,-127
"2218","Harrow 022D","E01002196","E02000454","Harrow 022","E09000015","Harrow","E12000007","London",1759,1759,0,47.1,616,2.9,"00AQ","Harrow",NA,30863,27250,27467,31532,31962,27565,30554,32446,1099,315,3087,914
"2181","Harrow 012B","E01002197","E02000444","Harrow 012","E09000015","Harrow","E12000007","London",1394,1330,64,75.3,420,3.2,"00AQ","Harrow",NA,22538,19183,21645,28216,22647,15899,21347,22551,109,-3284,-298,-5665
"2172","Harrow 010C","E01002198","E02000442","Harrow 010","E09000015","Harrow","E12000007","London",1820,1820,0,104.2,499,3.6,"00AQ","Harrow",NA,16070,10054,17087,22268,19865,17031,22986,18225,3795,6977,5899,-4043
"2182","Harrow 012C","E01002199","E02000444","Harrow 012","E09000015","Harrow","E12000007","London",1533,1533,0,89.8,467,3.3,"00AQ","Harrow",NA,17059,10811,16502,28036,22728,15163,22149,23251,5669,4352,5647,-4785
"2173","Harrow 010D","E01002200","E02000442","Harrow 010","E09000015","Harrow","E12000007","London",1688,1688,0,48.4,505,3.3,"00AQ","Harrow",NA,15131,8374,15739,25351,18624,15502,22619,18818,3493,7128,6880,-6533
"2183","Harrow 012D","E01002201","E02000444","Harrow 012","E09000015","Harrow","E12000007","London",1742,1742,0,65.6,508,3.4,"00AQ","Harrow",NA,22875,17026,22204,28057,26084,20299,27290,27646,3209,3273,5086,-411
"2184","Harrow 012E","E01002202","E02000444","Harrow 012","E09000015","Harrow","E12000007","London",2056,2039,17,108.6,712,2.9,"00AQ","Harrow",NA,9911,4613,9004,22767,15816,11447,19329,16665,5905,6834,10325,-6102
"2174","Harrow 010E","E01002203","E02000442","Harrow 010","E09000015","Harrow","E12000007","London",1751,1751,0,62.8,524,3.3,"00AQ","Harrow",NA,16591,9748,17964,23178,20728,15257,23407,19826,4137,5509,5443,-3352
"2252","Harrow 032A","E01002204","E02006795","Harrow 032","E09000015","Harrow","E12000007","London",1736,1730,6,97.6,634,2.7,"00AQ","Harrow",NA,19037,10171,22842,27099,19641,15778,20389,23357,604,5607,-2453,-3742
"2253","Harrow 032B","E01002206","E02006795","Harrow 032","E09000015","Harrow","E12000007","London",1387,1387,0,79.2,457,3,"00AQ","Harrow",NA,25390,16789,26347,25377,23248,18895,22958,27406,-2142,2106,-3389,2029
"2254","Harrow 032C","E01002207","E02006795","Harrow 032","E09000015","Harrow","E12000007","London",1730,1729,1,95.3,524,3.3,"00AQ","Harrow",NA,24289,15130,24265,28877,24498,18547,21813,25120,209,3417,-2452,-3757
"2227","Harrow 025A","E01002208","E02000457","Harrow 025","E09000015","Harrow","E12000007","London",1357,1357,0,46.4,483,2.8,"00AQ","Harrow",NA,29872,28799,28536,31050,31648,28678,29902,32287,1776,-121,1366,1237
"2228","Harrow 025B","E01002209","E02000457","Harrow 025","E09000015","Harrow","E12000007","London",1643,1638,5,60.4,546,3,"00AQ","Harrow",NA,21494,19564,23211,29734,25831,21582,22086,29675,4337,2018,-1125,-59
"2255","Harrow 032D","E01002210","E02006795","Harrow 032","E09000015","Harrow","E12000007","London",1604,1595,9,78.2,504,3.2,"00AQ","Harrow",NA,23333,15460,22683,29246,23826,18519,23006,26978,493,3059,323,-2268
"2235","Harrow 028A","E01002211","E02000460","Harrow 028","E09000015","Harrow","E12000007","London",1544,1514,30,90.1,477,3.2,"00AQ","Harrow",NA,9952,4579,8683,17997,10114,6889,8056,10607,162,2310,-627,-7390
"2236","Harrow 028B","E01002212","E02000460","Harrow 028","E09000015","Harrow","E12000007","London",1749,1749,0,63.6,647,2.7,"00AQ","Harrow",NA,12557,8950,12900,23184,14196,8851,16207,20233,1639,-99,3307,-2951
"2234","Harrow 027D","E01002213","E02000459","Harrow 027","E09000015","Harrow","E12000007","London",2912,2911,1,101.6,1116,2.6,"00AQ","Harrow",NA,13405,8168,13078,24518,15002,10415,18161,24081,1597,2247,5083,-437
"2247","Harrow 031A","E01002214","E02000463","Harrow 031","E09000015","Harrow","E12000007","London",1863,1856,7,102.9,612,3,"00AQ","Harrow",NA,16600,8340,13966,25846,15798,10898,15508,18877,-802,2558,1542,-6969
"2248","Harrow 031B","E01002215","E02000463","Harrow 031","E09000015","Harrow","E12000007","London",1535,1535,0,89.4,595,2.6,"00AQ","Harrow",NA,10554,5052,9021,18138,9523,4375,8767,11847,-1031,-677,-254,-6291
"2237","Harrow 028C","E01002216","E02000460","Harrow 028","E09000015","Harrow","E12000007","London",1699,1699,0,63.2,513,3.3,"00AQ","Harrow",NA,21473,15824,20719,26698,24066,17862,24691,26309,2593,2038,3972,-389
"2238","Harrow 028D","E01002217","E02000460","Harrow 028","E09000015","Harrow","E12000007","London",1526,1526,0,101,552,2.8,"00AQ","Harrow",NA,3289,530,4158,13000,5370,2483,5077,10284,2081,1953,919,-2716
"2243","Harrow 030A","E01002218","E02000462","Harrow 030","E09000015","Harrow","E12000007","London",1647,1647,0,50.4,606,2.7,"00AQ","Harrow",NA,17210,13121,18840,29272,17453,15646,21116,24428,243,2525,2276,-4844
"2244","Harrow 030B","E01002219","E02000462","Harrow 030","E09000015","Harrow","E12000007","London",1813,1810,3,61.9,605,3,"00AQ","Harrow",NA,16723,9199,17463,26538,13753,12242,18261,12212,-2970,3043,798,-14326
"2249","Harrow 031C","E01002220","E02000463","Harrow 031","E09000015","Harrow","E12000007","London",1628,1628,0,85.8,493,3.3,"00AQ","Harrow",NA,19933,12685,17840,22353,20995,17342,20631,21229,1062,4657,2791,-1124
"2245","Harrow 030C","E01002221","E02000462","Harrow 030","E09000015","Harrow","E12000007","London",1564,1559,5,91.6,511,3.1,"00AQ","Harrow",NA,14204,10242,13906,22883,16247,13405,16256,16736,2043,3163,2350,-6147
"2246","Harrow 030D","E01002222","E02000462","Harrow 030","E09000015","Harrow","E12000007","London",1608,1608,0,76.9,488,3.3,"00AQ","Harrow",NA,21748,15326,25932,25466,20086,16280,25031,23489,-1662,954,-901,-1977
"2250","Harrow 031D","E01002223","E02000463","Harrow 031","E09000015","Harrow","E12000007","London",1873,1873,0,91.9,591,3.2,"00AQ","Harrow",NA,17931,12616,16329,23458,21595,15951,21740,20363,3664,3335,5411,-3095
"2251","Harrow 031E","E01002224","E02000463","Harrow 031","E09000015","Harrow","E12000007","London",1530,1530,0,83.8,497,3.1,"00AQ","Harrow",NA,11173,5697,13794,16106,12537,8563,11176,13146,1364,2866,-2618,-2960
"2131","Harrow 001C","E01002225","E02000433","Harrow 001","E09000015","Harrow","E12000007","London",1575,1450,125,7.7,623,2.3,"00AQ","Harrow",NA,29105,29320,30345,31318,28641,27622,31698,30786,-464,-1698,1353,-532
"2132","Harrow 001D","E01002226","E02000433","Harrow 001","E09000015","Harrow","E12000007","London",2228,2228,0,36.5,1003,2.2,"00AQ","Harrow",NA,16834,13738,18111,25926,21272,14890,22023,28491,4438,1152,3912,2565
"2138","Harrow 003A","E01002227","E02000435","Harrow 003","E09000015","Harrow","E12000007","London",1809,1733,76,55.3,611,2.8,"00AQ","Harrow",NA,6217,2972,4847,15881,5441,3521,4499,12951,-776,549,-348,-2930
"2139","Harrow 003B","E01002228","E02000435","Harrow 003","E09000015","Harrow","E12000007","London",2105,2103,2,50.2,710,3,"00AQ","Harrow",NA,18728,9559,22212,29026,19914,14306,19440,25402,1186,4747,-2772,-3624
"2140","Harrow 003C","E01002229","E02000435","Harrow 003","E09000015","Harrow","E12000007","London",1717,1710,7,27.2,770,2.2,"00AQ","Harrow",NA,15683,12762,11301,28367,14542,13685,14518,21815,-1141,923,3217,-6552
"2141","Harrow 003D","E01002230","E02000435","Harrow 003","E09000015","Harrow","E12000007","London",1795,1776,19,41.7,637,2.8,"00AQ","Harrow",NA,24469,19922,23385,30993,24550,23138,27979,27455,81,3216,4594,-3538
"2189","Harrow 013E","E01002231","E02000445","Harrow 013","E09000015","Harrow","E12000007","London",1924,1924,0,89.6,679,2.8,"00AQ","Harrow",NA,16643,9431,17286,25332,12583,7875,13661,14877,-4060,-1556,-3625,-10455
"2175","Harrow 011A","E01002232","E02000443","Harrow 011","E09000015","Harrow","E12000007","London",1973,1936,37,89.7,709,2.7,"00AQ","Harrow",NA,14582,10595,12645,20414,15911,11220,17316,21732,1329,625,4671,1318
"2176","Harrow 011B","E01002233","E02000443","Harrow 011","E09000015","Harrow","E12000007","London",2031,2029,2,100.5,754,2.7,"00AQ","Harrow",NA,10709,5433,10716,21567,11342,7381,10718,15307,633,1948,2,-6260
"2177","Harrow 011C","E01002234","E02000443","Harrow 011","E09000015","Harrow","E12000007","London",1741,1741,0,106,548,3.2,"00AQ","Harrow",NA,11095,5595,9060,21574,16097,12050,13353,15642,5002,6455,4293,-5932
"2178","Harrow 011D","E01002235","E02000443","Harrow 011","E09000015","Harrow","E12000007","London",1922,1922,0,111.8,610,3.2,"00AQ","Harrow",NA,8525,2842,8462,16221,7188,4288,7917,8128,-1337,1446,-545,-8093
"2179","Harrow 011E","E01002236","E02000443","Harrow 011","E09000015","Harrow","E12000007","London",1803,1803,0,82,582,3.1,"00AQ","Harrow",NA,9181,3643,10663,14399,12729,7330,14947,15293,3548,3687,4284,894
"2223","Harrow 024A","E01002237","E02000456","Harrow 024","E09000015","Harrow","E12000007","London",1626,1626,0,113,648,2.5,"00AQ","Harrow",NA,12921,10210,11800,22326,14589,13102,12045,22736,1668,2892,245,410
"2224","Harrow 024B","E01002238","E02000456","Harrow 024","E09000015","Harrow","E12000007","London",1804,1800,4,52.5,596,3,"00AQ","Harrow",NA,20629,12330,20933,27796,24509,17219,23315,27747,3880,4889,2382,-49
"2229","Harrow 025C","E01002239","E02000457","Harrow 025","E09000015","Harrow","E12000007","London",1678,1678,0,46.6,635,2.6,"00AQ","Harrow",NA,25577,21087,20118,29366,27717,23388,25283,28728,2140,2301,5165,-638
"2225","Harrow 024C","E01002240","E02000456","Harrow 024","E09000015","Harrow","E12000007","London",1739,1712,27,103.3,655,2.6,"00AQ","Harrow",NA,13327,9862,11887,27478,16431,12555,14347,22327,3104,2693,2460,-5151
"2230","Harrow 025D","E01002241","E02000457","Harrow 025","E09000015","Harrow","E12000007","London",1636,1636,0,69.5,536,3.1,"00AQ","Harrow",NA,16136,9645,16452,27542,17553,11066,14838,25852,1417,1421,-1614,-1690
"2226","Harrow 024D","E01002242","E02000456","Harrow 024","E09000015","Harrow","E12000007","London",1890,1890,0,70.1,613,3.1,"00AQ","Harrow",NA,25667,20511,23818,30714,27783,20840,24925,31138,2116,329,1107,424
"2328","Havering 013A","E01002243","E02000476","Havering 013","E09000016","Havering","E12000007","London",1873,1852,21,79.3,847,2.2,"00AR","Havering",NA,8192,5177,8628,10517,7867,5884,8609,10218,-325,707,-19,-299
"2317","Havering 011A","E01002244","E02000474","Havering 011","E09000016","Havering","E12000007","London",1697,1697,0,50.7,749,2.3,"00AR","Havering",NA,19796,20539,20324,15666,12564,12245,16164,10927,-7232,-8294,-4160,-4739
"2318","Havering 011B","E01002245","E02000474","Havering 011","E09000016","Havering","E12000007","London",1592,1546,46,62.4,630,2.5,"00AR","Havering",NA,16052,12102,21721,16010,14386,11610,22445,16775,-1666,-492,724,765
"2348","Havering 017A","E01002246","E02000480","Havering 017","E09000016","Havering","E12000007","London",1700,1620,80,31.3,637,2.5,"00AR","Havering",NA,23914,20525,23129,12407,17472,15773,18038,12381,-6442,-4752,-5091,-26
"2349","Havering 017B","E01002247","E02000480","Havering 017","E09000016","Havering","E12000007","London",1800,1800,0,55.1,729,2.5,"00AR","Havering",NA,16942,13927,15848,16925,11481,8761,12789,16793,-5461,-5166,-3059,-132
"2350","Havering 017C","E01002248","E02000480","Havering 017","E09000016","Havering","E12000007","London",1397,1395,2,26.1,592,2.4,"00AR","Havering",NA,12834,12317,13465,10463,11781,9937,10278,8809,-1053,-2380,-3187,-1654
"2351","Havering 017D","E01002249","E02000480","Havering 017","E09000016","Havering","E12000007","London",1905,1905,0,33.3,746,2.6,"00AR","Havering",NA,19265,18656,18126,14958,14796,14559,20288,16715,-4469,-4097,2162,1757
"2352","Havering 017E","E01002250","E02000480","Havering 017","E09000016","Havering","E12000007","London",1563,1563,0,14.6,642,2.4,"00AR","Havering",NA,18541,19064,19334,16117,12820,13011,14773,12244,-5721,-6053,-4561,-3873
"2353","Havering 017F","E01002251","E02000480","Havering 017","E09000016","Havering","E12000007","London",1430,1393,37,43.9,526,2.6,"00AR","Havering",NA,10081,6865,12518,7266,9183,6648,10035,8799,-898,-217,-2483,1533
"2354","Havering 018A","E01002252","E02000481","Havering 018","E09000016","Havering","E12000007","London",1511,1511,0,13.1,617,2.4,"00AR","Havering",NA,25956,27075,23838,18502,24888,23598,22482,15070,-1068,-3477,-1356,-3432
"2359","Havering 019A","E01002253","E02000482","Havering 019","E09000016","Havering","E12000007","London",1539,1539,0,15,615,2.5,"00AR","Havering",NA,31000,32292,27197,25033,32089,31141,29287,27042,1089,-1151,2090,2009
"2360","Havering 019B","E01002254","E02000482","Havering 019","E09000016","Havering","E12000007","London",1616,1616,0,28.7,636,2.5,"00AR","Havering",NA,30783,31974,26619,26722,31826,31716,27372,27114,1043,-258,753,392
"2373","Havering 022A","E01002255","E02000485","Havering 022","E09000016","Havering","E12000007","London",1483,1483,0,25.1,630,2.4,"00AR","Havering",NA,22184,21444,19714,16932,21711,20049,21719,14662,-473,-1395,2005,-2270
"2355","Havering 018B","E01002256","E02000481","Havering 018","E09000016","Havering","E12000007","London",1498,1498,0,53.6,620,2.4,"00AR","Havering",NA,28038,28653,26422,17946,29297,25777,24696,18780,1259,-2876,-1726,834
"2361","Havering 019C","E01002257","E02000482","Havering 019","E09000016","Havering","E12000007","London",1719,1697,22,22.7,651,2.6,"00AR","Havering",NA,31317,30705,31947,30802,32359,31959,31978,29897,1042,1254,31,-905
"2356","Havering 018C","E01002258","E02000481","Havering 018","E09000016","Havering","E12000007","London",1676,1676,0,55.7,797,2.1,"00AR","Havering",NA,17316,12205,15181,13784,17373,12749,15014,12096,57,544,-167,-1688
"2357","Havering 018D","E01002259","E02000481","Havering 018","E09000016","Havering","E12000007","London",1486,1486,0,7.9,612,2.4,"00AR","Havering",NA,27278,25490,24184,17106,28305,23647,27329,18743,1027,-1843,3145,1637
"2393","Havering 026A","E01002260","E02000489","Havering 026","E09000016","Havering","E12000007","London",1535,1535,0,13.8,566,2.7,"00AR","Havering",NA,20109,17018,21441,13993,17869,16393,19197,12199,-2240,-625,-2244,-1794
"2394","Havering 026B","E01002261","E02000489","Havering 026","E09000016","Havering","E12000007","London",1649,1649,0,79.7,645,2.6,"00AR","Havering",NA,17712,17784,16038,12825,16283,14551,18199,9565,-1429,-3233,2161,-3260
"2395","Havering 026C","E01002262","E02000489","Havering 026","E09000016","Havering","E12000007","London",1626,1626,0,72.8,625,2.6,"00AR","Havering",NA,16779,11485,16665,10884,15312,12948,12920,12603,-1467,1463,-3745,1719
"2396","Havering 026D","E01002263","E02000489","Havering 026","E09000016","Havering","E12000007","London",1599,1599,0,18.8,609,2.6,"00AR","Havering",NA,23120,25326,24701,14205,26377,27076,23768,15284,3257,1750,-933,1079
"2397","Havering 026E","E01002264","E02000489","Havering 026","E09000016","Havering","E12000007","London",1475,1475,0,72.8,710,2.1,"00AR","Havering",NA,8671,5018,8400,6857,6745,3775,6341,7120,-1926,-1243,-2059,263
"2388","Havering 025A","E01002265","E02000488","Havering 025","E09000016","Havering","E12000007","London",1472,1472,0,28.6,638,2.3,"00AR","Havering",NA,23792,25959,24285,11266,23006,21957,21687,19184,-786,-4002,-2598,7918
"2398","Havering 027A","E01002266","E02000490","Havering 027","E09000016","Havering","E12000007","London",1439,1439,0,41.8,600,2.4,"00AR","Havering",NA,21580,19122,21563,11131,17872,19313,16611,7582,-3708,191,-4952,-3549
"2399","Havering 027B","E01002267","E02000490","Havering 027","E09000016","Havering","E12000007","London",1671,1671,0,80,734,2.3,"00AR","Havering",NA,9712,7687,12100,7467,10161,7618,8773,7285,449,-69,-3327,-182
"2311","Havering 010A","E01002268","E02000473","Havering 010","E09000016","Havering","E12000007","London",1350,1350,0,15.9,519,2.6,"00AR","Havering",NA,22839,19301,21985,18082,19741,18199,18086,16467,-3098,-1102,-3899,-1615
"2312","Havering 010B","E01002269","E02000473","Havering 010","E09000016","Havering","E12000007","London",1785,1785,0,23.2,678,2.6,"00AR","Havering",NA,23795,21985,25002,15891,22433,20271,21804,17887,-1362,-1714,-3198,1996
"2339","Havering 015A","E01002270","E02000478","Havering 015","E09000016","Havering","E12000007","London",1673,1664,9,24.7,634,2.6,"00AR","Havering",NA,27746,29396,29121,23711,28922,29462,31326,24100,1176,66,2205,389
"2340","Havering 015B","E01002271","E02000478","Havering 015","E09000016","Havering","E12000007","London",1491,1479,12,27.2,515,2.9,"00AR","Havering",NA,28010,29609,28014,23085,27441,29479,28918,21083,-569,-130,904,-2002
"2333","Havering 014A","E01002272","E02000477","Havering 014","E09000016","Havering","E12000007","London",1319,1319,0,58.5,536,2.5,"00AR","Havering",NA,25304,23845,25254,15472,22543,20644,18611,19468,-2761,-3201,-6643,3996
"2341","Havering 015C","E01002273","E02000478","Havering 015","E09000016","Havering","E12000007","London",1362,1309,53,16.3,490,2.7,"00AR","Havering",NA,23883,25148,22333,17124,24433,24573,22390,14882,550,-575,57,-2242
"2334","Havering 014B","E01002274","E02000477","Havering 014","E09000016","Havering","E12000007","London",1638,1638,0,53.3,692,2.4,"00AR","Havering",NA,25634,25773,22658,16458,25881,25524,20267,21397,247,-249,-2391,4939
"2342","Havering 015D","E01002275","E02000478","Havering 015","E09000016","Havering","E12000007","London",1359,1359,0,31.6,517,2.6,"00AR","Havering",NA,25850,28321,23219,22431,28564,30394,26571,19520,2714,2073,3352,-2911
"2266","Havering 001A","E01002276","E02000464","Havering 001","E09000016","Havering","E12000007","London",1926,1819,107,4.4,694,2.6,"00AR","Havering",NA,8785,7194,7074,6896,8069,7284,10364,5052,-716,90,3290,-1844
"2270","Havering 002A","E01002277","E02000465","Havering 002","E09000016","Havering","E12000007","London",1494,1494,0,10.2,608,2.5,"00AR","Havering",NA,8576,7515,7678,5932,5830,6209,6456,3442,-2746,-1306,-1222,-2490
"2267","Havering 001B","E01002278","E02000464","Havering 001","E09000016","Havering","E12000007","London",1599,1593,6,70.3,631,2.5,"00AR","Havering",NA,7221,4703,7075,3549,5467,4033,5859,3044,-1754,-670,-1216,-505
"2271","Havering 002B","E01002279","E02000465","Havering 002","E09000016","Havering","E12000007","London",1584,1584,0,44.1,634,2.5,"00AR","Havering",NA,10033,8234,9101,4655,9049,7378,9191,6256,-984,-856,90,1601
"2280","Havering 004A","E01002280","E02000467","Havering 004","E09000016","Havering","E12000007","London",1522,1493,29,96.8,621,2.4,"00AR","Havering",NA,4175,2070,2698,3673,2537,1796,3463,2339,-1638,-274,765,-1334
"2272","Havering 002C","E01002281","E02000465","Havering 002","E09000016","Havering","E12000007","London",1614,1614,0,39.6,756,2.1,"00AR","Havering",NA,5206,3317,4051,3466,3805,3251,2418,4167,-1401,-66,-1633,701
"2281","Havering 004B","E01002282","E02000467","Havering 004","E09000016","Havering","E12000007","London",1594,1594,0,57.5,668,2.4,"00AR","Havering",NA,4888,2383,4246,4050,3287,2712,3422,2791,-1601,329,-824,-1259
"2273","Havering 002D","E01002283","E02000465","Havering 002","E09000016","Havering","E12000007","London",1517,1517,0,66.9,594,2.6,"00AR","Havering",NA,9234,7344,9198,4902,8189,7156,8723,4984,-1045,-188,-475,82
"2282","Havering 004C","E01002284","E02000467","Havering 004","E09000016","Havering","E12000007","London",1842,1842,0,67.4,765,2.4,"00AR","Havering",NA,9794,9317,9045,5304,7952,8097,8227,6086,-1842,-1220,-818,782
"2389","Havering 025B","E01002285","E02000488","Havering 025","E09000016","Havering","E12000007","London",1245,1245,0,27.2,520,2.4,"00AR","Havering",NA,27316,27672,22073,15852,24754,23232,24343,14836,-2562,-4440,2270,-1016
"2390","Havering 025C","E01002286","E02000488","Havering 025","E09000016","Havering","E12000007","London",1650,1650,0,69.6,614,2.7,"00AR","Havering",NA,27431,28755,26518,13174,27782,27721,25445,19211,351,-1034,-1073,6037
"2378","Havering 023A","E01002287","E02000486","Havering 023","E09000016","Havering","E12000007","London",1558,1558,0,69.2,602,2.6,"00AR","Havering",NA,26486,25399,25587,15451,24467,25303,23943,14382,-2019,-96,-1644,-1069
"2391","Havering 025D","E01002288","E02000488","Havering 025","E09000016","Havering","E12000007","London",1548,1548,0,45.5,554,2.8,"00AR","Havering",NA,29338,28459,27581,19546,27742,26782,26758,17704,-1596,-1677,-823,-1842
"2374","Havering 022B","E01002289","E02000485","Havering 022","E09000016","Havering","E12000007","London",1614,1614,0,59.4,621,2.6,"00AR","Havering",NA,20630,18018,18487,16231,23595,20038,21762,16146,2965,2020,3275,-85
"2392","Havering 025E","E01002290","E02000488","Havering 025","E09000016","Havering","E12000007","London",1516,1516,0,54.4,641,2.4,"00AR","Havering",NA,23775,23395,18506,16790,25823,23958,22945,17823,2048,563,4439,1033
"2379","Havering 023B","E01002291","E02000486","Havering 023","E09000016","Havering","E12000007","London",1582,1582,0,52.2,775,2,"00AR","Havering",NA,24599,26548,26506,17305,23037,20505,22428,19965,-1562,-6043,-4078,2660
"2375","Havering 022C","E01002292","E02000485","Havering 022","E09000016","Havering","E12000007","London",1549,1549,0,44.6,637,2.4,"00AR","Havering",NA,13775,10870,15046,9457,13760,12708,11636,9928,-15,1838,-3410,471
"2295","Havering 007A","E01002293","E02000470","Havering 007","E09000016","Havering","E12000007","London",1591,1572,19,23.1,801,2,"00AR","Havering",NA,22766,22467,24683,20502,17569,16251,17518,18560,-5197,-6216,-7165,-1942
"2296","Havering 007B","E01002294","E02000470","Havering 007","E09000016","Havering","E12000007","London",1492,1478,14,12.1,626,2.4,"00AR","Havering",NA,21097,18628,18484,19785,23665,20297,21583,21188,2568,1669,3099,1403
"2313","Havering 010C","E01002295","E02000473","Havering 010","E09000016","Havering","E12000007","London",1558,1525,33,56,670,2.3,"00AR","Havering",NA,19408,18055,15579,24407,19079,15964,18462,17450,-329,-2091,2883,-6957
"2297","Havering 007C","E01002296","E02000470","Havering 007","E09000016","Havering","E12000007","London",1673,1673,0,4.1,691,2.4,"00AR","Havering",NA,21450,26026,19490,16164,17513,21456,19838,15478,-3937,-4570,348,-686
"2283","Havering 004D","E01002297","E02000467","Havering 004","E09000016","Havering","E12000007","London",1484,1484,0,68.3,670,2.2,"00AR","Havering",NA,5683,4851,3202,2771,3892,3147,2064,6044,-1791,-1704,-1138,3273
"2298","Havering 007D","E01002298","E02000470","Havering 007","E09000016","Havering","E12000007","London",1538,1538,0,33.9,654,2.4,"00AR","Havering",NA,20193,17500,18069,11605,18346,17557,17130,15765,-1847,57,-939,4160
"2274","Havering 002E","E01002299","E02000465","Havering 002","E09000016","Havering","E12000007","London",1721,1720,1,51,664,2.6,"00AR","Havering",NA,12148,11561,11638,4854,12469,11162,12978,9305,321,-399,1340,4451
"2299","Havering 007E","E01002300","E02000470","Havering 007","E09000016","Havering","E12000007","London",1593,1593,0,48.1,715,2.2,"00AR","Havering",NA,23499,22632,24214,17113,20093,17442,17336,22890,-3406,-5190,-6878,5777
"2275","Havering 003A","E01002301","E02000466","Havering 003","E09000016","Havering","E12000007","London",1561,1561,0,56.9,627,2.5,"00AR","Havering",NA,21056,18534,21267,11704,20825,19936,16941,10111,-231,1402,-4326,-1593
"2286","Havering 005A","E01002302","E02000468","Havering 005","E09000016","Havering","E12000007","London",1563,1563,0,54.6,598,2.6,"00AR","Havering",NA,20101,15892,19970,11500,14344,13005,13556,7770,-5757,-2887,-6414,-3730
"2276","Havering 003B","E01002303","E02000466","Havering 003","E09000016","Havering","E12000007","London",2043,2043,0,71.4,823,2.5,"00AR","Havering",NA,9429,7941,7215,3935,7299,5116,6332,4580,-2130,-2825,-883,645
"2277","Havering 003C","E01002304","E02000466","Havering 003","E09000016","Havering","E12000007","London",1414,1315,99,2.7,524,2.5,"00AR","Havering",NA,10114,14691,11566,8259,12810,16558,15225,7293,2696,1867,3659,-966
"2287","Havering 005B","E01002305","E02000468","Havering 005","E09000016","Havering","E12000007","London",1519,1519,0,5.5,608,2.5,"00AR","Havering",NA,18035,17387,16872,7396,13949,14230,14674,7873,-4086,-3157,-2198,477
"2278","Havering 003D","E01002306","E02000466","Havering 003","E09000016","Havering","E12000007","London",1596,1596,0,89.2,625,2.6,"00AR","Havering",NA,7875,3712,6664,4524,7004,4672,5736,4574,-871,960,-928,50
"2279","Havering 003E","E01002307","E02000466","Havering 003","E09000016","Havering","E12000007","London",1673,1673,0,70.2,636,2.6,"00AR","Havering",NA,12487,8656,12789,5903,12240,8937,11562,6693,-247,281,-1227,790
"2288","Havering 005C","E01002308","E02000468","Havering 005","E09000016","Havering","E12000007","London",1631,1631,0,36,670,2.4,"00AR","Havering",NA,9711,8350,8399,4900,9020,6736,8561,7047,-691,-1614,162,2147
"2291","Havering 006A","E01002309","E02000469","Havering 006","E09000016","Havering","E12000007","London",1539,1528,11,55.3,651,2.3,"00AR","Havering",NA,12044,8820,7877,9485,11313,9736,9481,10493,-731,916,1604,1008
"2292","Havering 006B","E01002310","E02000469","Havering 006","E09000016","Havering","E12000007","London",1677,1577,100,59.6,712,2.2,"00AR","Havering",NA,6596,6140,3835,3388,4143,4376,2719,6804,-2453,-1764,-1116,3416
"2293","Havering 006C","E01002311","E02000469","Havering 006","E09000016","Havering","E12000007","London",1690,1690,0,18.1,668,2.5,"00AR","Havering",NA,8773,7131,8814,5269,8879,7454,7260,6060,106,323,-1554,791
"2268","Havering 001C","E01002312","E02000464","Havering 001","E09000016","Havering","E12000007","London",1400,1400,0,16,642,2.2,"00AR","Havering",NA,11853,10215,9530,6162,6535,7589,7053,5404,-5318,-2626,-2477,-758
"2269","Havering 001D","E01002313","E02000464","Havering 001","E09000016","Havering","E12000007","London",1526,1526,0,38.8,630,2.4,"00AR","Havering",NA,7530,6032,6914,2787,6806,5276,5535,6229,-724,-756,-1379,3442
"2284","Havering 004E","E01002314","E02000467","Havering 004","E09000016","Havering","E12000007","London",1656,1656,0,88,623,2.7,"00AR","Havering",NA,7774,5146,8444,2128,4507,3135,5146,4254,-3267,-2011,-3298,2126
"2294","Havering 006D","E01002315","E02000469","Havering 006","E09000016","Havering","E12000007","London",1537,1537,0,70.3,633,2.4,"00AR","Havering",NA,11327,11534,11467,6188,9942,10345,9250,5733,-1385,-1189,-2217,-455
"2285","Havering 004F","E01002316","E02000467","Havering 004","E09000016","Havering","E12000007","London",1545,1535,10,62.9,740,2.1,"00AR","Havering",NA,5805,3139,2866,4826,3625,2035,3859,3089,-2180,-1104,993,-1737
"2335","Havering 014C","E01002317","E02000477","Havering 014","E09000016","Havering","E12000007","London",1541,1528,13,41.1,544,2.8,"00AR","Havering",NA,28523,25249,27394,20469,28239,30059,28555,18919,-284,4810,1161,-1550
"2336","Havering 014D","E01002318","E02000477","Havering 014","E09000016","Havering","E12000007","London",1616,1616,0,54.1,614,2.6,"00AR","Havering",NA,23040,22417,23621,15389,24470,20089,22980,16293,1430,-2328,-641,904
"2343","Havering 016A","E01002319","E02000479","Havering 016","E09000016","Havering","E12000007","London",1596,1591,5,42.3,652,2.4,"00AR","Havering",NA,15992,14164,15133,14066,16122,12726,12936,15574,130,-1438,-2197,1508
"2368","Havering 021A","E01002320","E02000484","Havering 021","E09000016","Havering","E12000007","London",1480,1480,0,72.7,537,2.8,"00AR","Havering",NA,26322,24841,25822,17529,25810,23419,26867,16184,-512,-1422,1045,-1345
"2369","Havering 021B","E01002321","E02000484","Havering 021","E09000016","Havering","E12000007","London",1642,1636,6,36.1,635,2.6,"00AR","Havering",NA,22770,22682,22043,19694,23946,26601,23200,16772,1176,3919,1157,-2922
"2370","Havering 021C","E01002322","E02000484","Havering 021","E09000016","Havering","E12000007","London",1940,1940,0,45.4,731,2.7,"00AR","Havering",NA,24846,23136,25585,12155,25040,22020,26137,12582,194,-1116,552,427
"2371","Havering 021D","E01002323","E02000484","Havering 021","E09000016","Havering","E12000007","London",1682,1676,6,57.1,627,2.7,"00AR","Havering",NA,22773,28431,23637,13562,22639,23692,23594,12794,-134,-4739,-43,-768
"2372","Havering 021E","E01002324","E02000484","Havering 021","E09000016","Havering","E12000007","London",1455,1455,0,30.9,650,2.2,"00AR","Havering",NA,17586,14475,15704,11827,12825,12454,11207,8581,-4761,-2021,-4497,-3246
"2319","Havering 011C","E01002325","E02000474","Havering 011","E09000016","Havering","E12000007","London",1709,1709,0,22.6,755,2.3,"00AR","Havering",NA,9493,7407,10708,6251,8927,6730,8819,3852,-566,-677,-1889,-2399
"2289","Havering 005D","E01002326","E02000468","Havering 005","E09000016","Havering","E12000007","London",1496,1496,0,54.2,627,2.4,"00AR","Havering",NA,14242,12724,14311,9371,12465,8914,10438,9000,-1777,-3810,-3873,-371
"2305","Havering 009A","E01002327","E02000472","Havering 009","E09000016","Havering","E12000007","London",1476,1470,6,52.5,595,2.5,"00AR","Havering",NA,22316,21292,20393,12172,19582,18196,18792,10763,-2734,-3096,-1601,-1409
"2306","Havering 009B","E01002328","E02000472","Havering 009","E09000016","Havering","E12000007","London",1685,1685,0,58.9,642,2.6,"00AR","Havering",NA,22021,20363,21012,12051,21050,20437,21308,14122,-971,74,296,2071
"2320","Havering 011D","E01002329","E02000474","Havering 011","E09000016","Havering","E12000007","London",1615,1615,0,43,643,2.5,"00AR","Havering",NA,19607,21854,19553,14521,19893,18379,20910,11947,286,-3475,1357,-2574
"2321","Havering 011E","E01002330","E02000474","Havering 011","E09000016","Havering","E12000007","London",1730,1730,0,35.7,737,2.3,"00AR","Havering",NA,17623,17907,20728,11028,14514,11980,14598,9667,-3109,-5927,-6130,-1361
"2290","Havering 005E","E01002331","E02000468","Havering 005","E09000016","Havering","E12000007","London",1573,1496,77,50.9,596,2.5,"00AR","Havering",NA,16116,16734,20552,9200,18312,17475,18089,8675,2196,741,-2463,-525
"2307","Havering 009C","E01002332","E02000472","Havering 009","E09000016","Havering","E12000007","London",1631,1631,0,58.5,683,2.4,"00AR","Havering",NA,19362,16872,17838,11062,17847,15709,18683,7616,-1515,-1163,845,-3446
"2300","Havering 008A","E01002333","E02000471","Havering 008","E09000016","Havering","E12000007","London",1320,1312,8,48.1,516,2.5,"00AR","Havering",NA,27816,24494,23666,17380,23508,22558,20830,12936,-4308,-1936,-2836,-4444
"2301","Havering 008B","E01002334","E02000471","Havering 008","E09000016","Havering","E12000007","London",1663,1663,0,17.2,674,2.5,"00AR","Havering",NA,25311,27570,26248,13190,23403,23585,22319,16926,-1908,-3985,-3929,3736
"2308","Havering 009D","E01002335","E02000472","Havering 009","E09000016","Havering","E12000007","London",1445,1416,29,69.4,592,2.4,"00AR","Havering",NA,14751,12092,13515,10870,16952,13554,16042,11551,2201,1462,2527,681
"2302","Havering 008C","E01002336","E02000471","Havering 008","E09000016","Havering","E12000007","London",1492,1492,0,58.4,612,2.4,"00AR","Havering",NA,23171,18992,23745,13709,19368,16726,22288,9989,-3803,-2266,-1457,-3720
"2322","Havering 012A","E01002337","E02000475","Havering 012","E09000016","Havering","E12000007","London",1301,1273,28,11.6,512,2.5,"00AR","Havering",NA,22390,21528,27719,24910,22824,23737,27665,20374,434,2209,-54,-4536
"2309","Havering 009E","E01002338","E02000472","Havering 009","E09000016","Havering","E12000007","London",1371,1371,0,56.3,523,2.6,"00AR","Havering",NA,25129,22415,25259,13579,20560,19214,19361,12044,-4569,-3201,-5898,-1535
"2303","Havering 008D","E01002339","E02000471","Havering 008","E09000016","Havering","E12000007","London",1610,1610,0,40.4,602,2.7,"00AR","Havering",NA,29577,26767,25751,22841,28011,27347,26592,18129,-1566,580,841,-4712
"2310","Havering 009F","E01002340","E02000472","Havering 009","E09000016","Havering","E12000007","London",1381,1381,0,58.1,509,2.7,"00AR","Havering",NA,25369,24337,20907,19876,25582,26085,22352,18290,213,1748,1445,-1586
"2304","Havering 008E","E01002341","E02000471","Havering 008","E09000016","Havering","E12000007","London",1372,1372,0,56.4,557,2.5,"00AR","Havering",NA,24907,22694,19572,15549,20192,18259,18076,14033,-4715,-4435,-1496,-1516
"2412","Havering 030A","E01002342","E02000493","Havering 030","E09000016","Havering","E12000007","London",1588,1588,0,86.7,632,2.5,"00AR","Havering",NA,17200,14304,18686,10885,12657,10807,13087,9790,-4543,-3497,-5599,-1095
"2408","Havering 029A","E01002343","E02000492","Havering 029","E09000016","Havering","E12000007","London",1705,1684,21,35.4,636,2.6,"00AR","Havering",NA,21167,21515,17732,9372,19766,21586,17589,7579,-1401,71,-143,-1793
"2409","Havering 029B","E01002344","E02000492","Havering 029","E09000016","Havering","E12000007","London",1528,1524,4,1.5,638,2.4,"00AR","Havering",NA,16669,18457,20253,13667,15318,15251,14291,10584,-1351,-3206,-5962,-3083
"2413","Havering 030B","E01002345","E02000493","Havering 030","E09000016","Havering","E12000007","London",1679,1679,0,38,756,2.2,"00AR","Havering",NA,8543,6568,12119,7255,5819,5960,7767,6481,-2724,-608,-4352,-774
"2414","Havering 030C","E01002346","E02000493","Havering 030","E09000016","Havering","E12000007","London",1503,1503,0,72.3,557,2.7,"00AR","Havering",NA,13430,8808,13577,7661,11885,10108,12827,7403,-1545,1300,-750,-258
"2415","Havering 030D","E01002347","E02000493","Havering 030","E09000016","Havering","E12000007","London",1440,1440,0,31.6,526,2.7,"00AR","Havering",NA,19916,19102,18048,12950,14508,15286,13421,11101,-5408,-3816,-4627,-1849
"2410","Havering 029C","E01002348","E02000492","Havering 029","E09000016","Havering","E12000007","London",1531,1531,0,5.6,642,2.4,"00AR","Havering",NA,22885,22313,22969,11388,23661,19779,22052,9482,776,-2534,-917,-1906
"2411","Havering 029D","E01002349","E02000492","Havering 029","E09000016","Havering","E12000007","London",1508,1508,0,26,608,2.5,"00AR","Havering",NA,19506,18775,16077,10724,20596,19822,18101,8902,1090,1047,2024,-1822
"2344","Havering 016B","E01002350","E02000479","Havering 016","E09000016","Havering","E12000007","London",1551,1483,68,54.3,711,2.1,"00AR","Havering",NA,8424,10975,11316,13068,8982,7718,9920,11243,558,-3257,-1396,-1825
"2345","Havering 016C","E01002351","E02000479","Havering 016","E09000016","Havering","E12000007","London",1580,1580,0,80.8,653,2.4,"00AR","Havering",NA,21221,19363,19713,15193,19322,17386,17820,15280,-1899,-1977,-1893,87
"2346","Havering 016D","E01002352","E02000479","Havering 016","E09000016","Havering","E12000007","London",1635,1596,39,56.5,722,2.2,"00AR","Havering",NA,20743,17675,20339,19835,16361,11487,12572,18699,-4382,-6188,-7767,-1136
"2329","Havering 013B","E01002353","E02000476","Havering 013","E09000016","Havering","E12000007","London",2010,2005,5,43.7,832,2.4,"00AR","Havering",NA,16564,17149,18195,18901,16529,17171,17641,18899,-35,22,-554,-2
"2323","Havering 012B","E01002354","E02000475","Havering 012","E09000016","Havering","E12000007","London",1372,1365,7,44.2,561,2.4,"00AR","Havering",NA,18563,27900,23853,24748,29332,29395,26768,24986,10769,1495,2915,238
"2337","Havering 014E","E01002355","E02000477","Havering 014","E09000016","Havering","E12000007","London",1470,1470,0,64.3,574,2.6,"00AR","Havering",NA,28756,29672,25262,18301,29787,29496,26491,20926,1031,-176,1229,2625
"2330","Havering 013C","E01002356","E02000476","Havering 013","E09000016","Havering","E12000007","London",2143,2135,8,58.7,1037,2.1,"00AR","Havering",NA,4446,4590,5337,9587,4965,4614,7399,5943,519,24,2062,-3644
"2347","Havering 016E","E01002358","E02000479","Havering 016","E09000016","Havering","E12000007","London",1772,1772,0,78.1,791,2.2,"00AR","Havering",NA,16465,11973,19285,15641,16636,13352,20364,11133,171,1379,1079,-4508
"2363","Havering 020A","E01002359","E02000483","Havering 020","E09000016","Havering","E12000007","London",1322,1322,0,58.1,515,2.6,"00AR","Havering",NA,26868,24834,26049,14485,26712,26359,26526,18701,-156,1525,477,4216
"2364","Havering 020B","E01002360","E02000483","Havering 020","E09000016","Havering","E12000007","London",1429,1429,0,37.1,742,1.9,"00AR","Havering",NA,22112,19203,21421,21467,19443,16712,20563,16175,-2669,-2491,-858,-5292
"2365","Havering 020C","E01002361","E02000483","Havering 020","E09000016","Havering","E12000007","London",1700,1695,5,46.8,822,2.1,"00AR","Havering",NA,12623,13494,12896,15122,14052,11894,13419,10625,1429,-1600,523,-4497
"2376","Havering 022D","E01002362","E02000485","Havering 022","E09000016","Havering","E12000007","London",1494,1471,23,44.2,616,2.4,"00AR","Havering",NA,24030,21677,23930,23694,28488,23204,26404,21268,4458,1527,2474,-2426
"2366","Havering 020D","E01002363","E02000483","Havering 020","E09000016","Havering","E12000007","London",1590,1566,24,64.1,686,2.3,"00AR","Havering",NA,10509,10985,13589,11292,13741,10016,12388,7540,3232,-969,-1201,-3752
"2380","Havering 023C","E01002364","E02000486","Havering 023","E09000016","Havering","E12000007","London",1446,1380,66,61.3,542,2.5,"00AR","Havering",NA,24077,22603,21971,19279,26944,23634,22819,17569,2867,1031,848,-1710
"2381","Havering 023D","E01002365","E02000486","Havering 023","E09000016","Havering","E12000007","London",1316,1316,0,57.7,552,2.4,"00AR","Havering",NA,21705,21843,17870,16753,18440,18367,17616,14173,-3265,-3476,-254,-2580
"2382","Havering 023E","E01002366","E02000486","Havering 023","E09000016","Havering","E12000007","London",1464,1464,0,51.8,568,2.6,"00AR","Havering",NA,22881,21373,22702,13631,21467,16828,20629,12979,-1414,-4545,-2073,-652
"2367","Havering 020E","E01002367","E02000483","Havering 020","E09000016","Havering","E12000007","London",1573,1550,23,41.5,658,2.4,"00AR","Havering",NA,20034,19582,23024,21866,21929,18219,21840,19269,1895,-1363,-1184,-2597
"2403","Havering 028A","E01002368","E02000491","Havering 028","E09000016","Havering","E12000007","London",1594,1594,0,12.2,696,2.3,"00AR","Havering",NA,2129,1652,1116,4293,3600,3249,3050,5264,1471,1597,1934,971
"2404","Havering 028B","E01002369","E02000491","Havering 028","E09000016","Havering","E12000007","London",1891,1884,7,39.1,730,2.6,"00AR","Havering",NA,14257,14408,14889,9833,12004,12637,13347,8386,-2253,-1771,-1542,-1447
"2405","Havering 028C","E01002370","E02000491","Havering 028","E09000016","Havering","E12000007","London",1973,1973,0,8,846,2.3,"00AR","Havering",NA,9646,7535,9978,7581,9073,8053,7245,8636,-573,518,-2733,1055
"2406","Havering 028D","E01002371","E02000491","Havering 028","E09000016","Havering","E12000007","London",1627,1627,0,57.7,643,2.5,"00AR","Havering",NA,14679,19821,17822,6980,16170,14410,15051,12123,1491,-5411,-2771,5143
"2400","Havering 027C","E01002372","E02000490","Havering 027","E09000016","Havering","E12000007","London",1611,1611,0,73.3,603,2.7,"00AR","Havering",NA,20128,19863,18439,10506,19887,17768,20289,9268,-241,-2095,1850,-1238
"2401","Havering 027D","E01002373","E02000490","Havering 027","E09000016","Havering","E12000007","London",1581,1581,0,50.7,628,2.5,"00AR","Havering",NA,18689,20650,18714,8396,17337,16102,17116,9544,-1352,-4548,-1598,1148
"2402","Havering 027E","E01002374","E02000490","Havering 027","E09000016","Havering","E12000007","London",1526,1526,0,15.8,604,2.5,"00AR","Havering",NA,16695,16055,18181,8034,16267,14865,14525,14606,-428,-1190,-3656,6572
"2407","Havering 028E","E01002375","E02000491","Havering 028","E09000016","Havering","E12000007","London",1741,1696,45,66.4,688,2.5,"00AR","Havering",NA,10671,6325,11263,5444,9344,7300,8026,7308,-1327,975,-3237,1864
"2324","Havering 012C","E01002376","E02000475","Havering 012","E09000016","Havering","E12000007","London",1442,1426,16,42.4,520,2.7,"00AR","Havering",NA,30051,29900,28927,24131,28466,29792,29556,19137,-1585,-108,629,-4994
"2314","Havering 010D","E01002377","E02000473","Havering 010","E09000016","Havering","E12000007","London",1638,1638,0,38.1,711,2.3,"00AR","Havering",NA,19992,17076,21020,13823,20461,17564,19001,19528,469,488,-2019,5705
"2315","Havering 010E","E01002378","E02000473","Havering 010","E09000016","Havering","E12000007","London",1678,1678,0,70,604,2.8,"00AR","Havering",NA,25029,20893,26471,17669,25366,25403,25048,15721,337,4510,-1423,-1948
"2325","Havering 012D","E01002379","E02000475","Havering 012","E09000016","Havering","E12000007","London",1466,1458,8,41,659,2.2,"00AR","Havering",NA,25587,22837,23758,27154,25993,21463,24589,23280,406,-1374,831,-3874
"2326","Havering 012E","E01002380","E02000475","Havering 012","E09000016","Havering","E12000007","London",2076,2058,18,69,1036,2,"00AR","Havering",NA,14130,11041,11788,14044,17779,12484,15451,17831,3649,1443,3663,3787
"2327","Havering 012F","E01002381","E02000475","Havering 012","E09000016","Havering","E12000007","London",1539,1527,12,41.5,645,2.4,"00AR","Havering",NA,20178,20108,25573,17835,19154,16106,19218,14058,-1024,-4002,-6355,-3777
"2338","Havering 014F","E01002382","E02000477","Havering 014","E09000016","Havering","E12000007","London",1776,1776,0,56.5,765,2.3,"00AR","Havering",NA,24201,24488,20553,18189,23439,22644,22368,19840,-762,-1844,1815,1651
"2316","Havering 010F","E01002383","E02000473","Havering 010","E09000016","Havering","E12000007","London",1579,1579,0,54,659,2.4,"00AR","Havering",NA,22767,24626,24627,18700,24958,26076,24121,22496,2191,1450,-506,3796
"2362","Havering 019D","E01002384","E02000482","Havering 019","E09000016","Havering","E12000007","London",1522,1522,0,31.9,644,2.4,"00AR","Havering",NA,27389,23188,24220,24987,29405,28651,27874,25180,2016,5463,3654,193
"2383","Havering 024A","E01002385","E02000487","Havering 024","E09000016","Havering","E12000007","London",1596,1556,40,1.6,601,2.6,"00AR","Havering",NA,25258,25209,28810,19499,24466,29174,30247,19473,-792,3965,1437,-26
"2377","Havering 022E","E01002386","E02000485","Havering 022","E09000016","Havering","E12000007","London",1846,1839,7,33.8,871,2.1,"00AR","Havering",NA,25486,23962,26110,25767,27462,23457,25991,27135,1976,-505,-119,1368
"2384","Havering 024B","E01002387","E02000487","Havering 024","E09000016","Havering","E12000007","London",1605,1605,0,11.7,607,2.6,"00AR","Havering",NA,29909,31514,30025,27615,30621,30255,29504,27022,712,-1259,-521,-593
"2385","Havering 024C","E01002388","E02000487","Havering 024","E09000016","Havering","E12000007","London",1658,1620,38,45.2,608,2.7,"00AR","Havering",NA,31113,31113,31324,28313,32568,32392,31773,27752,1455,1279,449,-561
"2386","Havering 024D","E01002389","E02000487","Havering 024","E09000016","Havering","E12000007","London",1535,1518,17,17.6,623,2.4,"00AR","Havering",NA,30839,31779,27256,25665,30930,31563,27033,24269,91,-216,-223,-1396
"2387","Havering 024E","E01002390","E02000487","Havering 024","E09000016","Havering","E12000007","London",1449,1449,0,42.6,531,2.7,"00AR","Havering",NA,31872,32113,28725,26134,32423,32568,29809,23506,551,455,1084,-2628
"2358","Havering 018E","E01002391","E02000481","Havering 018","E09000016","Havering","E12000007","London",1622,1501,121,1.9,608,2.5,"00AR","Havering",NA,20084,20789,24472,21094,26400,25522,27301,19351,6316,4733,2829,-1743
"2505","Hillingdon 020A","E01002392","E02000513","Hillingdon 020","E09000017","Hillingdon","E12000007","London",1675,1675,0,35.8,618,2.7,"00AS","Hillingdon",NA,5963,3214,8677,5512,4871,3920,6584,4160,-1092,706,-2093,-1352
"2506","Hillingdon 020B","E01002393","E02000513","Hillingdon 020","E09000017","Hillingdon","E12000007","London",1988,1982,6,61,705,2.8,"00AS","Hillingdon",NA,8558,8963,13034,9375,9705,9762,10981,11862,1147,799,-2053,2487
"2510","Hillingdon 021A","E01002394","E02000514","Hillingdon 021","E09000017","Hillingdon","E12000007","London",1619,1619,0,55.1,508,3.2,"00AS","Hillingdon",NA,12394,9761,12199,10714,15429,12101,15805,13414,3035,2340,3606,2700
"2511","Hillingdon 021B","E01002395","E02000514","Hillingdon 021","E09000017","Hillingdon","E12000007","London",1407,1407,0,81.3,424,3.3,"00AS","Hillingdon",NA,15999,12744,19148,17787,13286,12038,15851,11163,-2713,-706,-3297,-6624
"2537","Hillingdon 026A","E01002396","E02000519","Hillingdon 026","E09000017","Hillingdon","E12000007","London",1749,1747,2,51.4,563,3.1,"00AS","Hillingdon",NA,5501,5634,9284,15625,9122,7798,12244,14324,3621,2164,2960,-1301
"2512","Hillingdon 021C","E01002397","E02000514","Hillingdon 021","E09000017","Hillingdon","E12000007","London",1695,1689,6,95.5,514,3.3,"00AS","Hillingdon",NA,8651,6980,10369,16618,8866,7450,11641,13911,215,470,1272,-2707
"2513","Hillingdon 021D","E01002398","E02000514","Hillingdon 021","E09000017","Hillingdon","E12000007","London",1725,1702,23,105.4,493,3.5,"00AS","Hillingdon",NA,12537,10464,10579,18610,13027,14358,17302,14997,490,3894,6723,-3613
"2514","Hillingdon 021E","E01002399","E02000514","Hillingdon 021","E09000017","Hillingdon","E12000007","London",1591,1591,0,90,474,3.4,"00AS","Hillingdon",NA,14635,10554,17223,18351,15014,14913,18248,15429,379,4359,1025,-2922
"2527","Hillingdon 024A","E01002400","E02000517","Hillingdon 024","E09000017","Hillingdon","E12000007","London",1792,1770,22,29.7,599,3,"00AS","Hillingdon",NA,10248,9695,12611,8774,9038,7980,10365,11045,-1210,-1715,-2246,2271
"2528","Hillingdon 024B","E01002401","E02000517","Hillingdon 024","E09000017","Hillingdon","E12000007","London",1702,1673,29,51.3,609,2.7,"00AS","Hillingdon",NA,9133,7757,10831,12087,8420,6920,9567,11561,-713,-837,-1264,-526
"2529","Hillingdon 024C","E01002402","E02000517","Hillingdon 024","E09000017","Hillingdon","E12000007","London",1499,1494,5,75,491,3,"00AS","Hillingdon",NA,8842,5415,10146,5598,7959,6256,8446,11791,-883,841,-1700,6193
"2530","Hillingdon 024D","E01002403","E02000517","Hillingdon 024","E09000017","Hillingdon","E12000007","London",1795,1795,0,87.9,543,3.3,"00AS","Hillingdon",NA,9385,5719,11485,7270,7677,6433,9005,8317,-1708,714,-2480,1047
"2531","Hillingdon 024E","E01002404","E02000517","Hillingdon 024","E09000017","Hillingdon","E12000007","London",1838,1838,0,88.4,675,2.7,"00AS","Hillingdon",NA,5506,4109,7649,6628,8140,6242,8472,6767,2634,2133,823,139
"2542","Hillingdon 027A","E01002405","E02000520","Hillingdon 027","E09000017","Hillingdon","E12000007","London",1919,1812,107,19.1,634,2.9,"00AS","Hillingdon",NA,9370,8294,9272,8574,9755,7193,10177,9370,385,-1101,905,796
"2543","Hillingdon 027B","E01002406","E02000520","Hillingdon 027","E09000017","Hillingdon","E12000007","London",2135,2135,0,16,680,3.1,"00AS","Hillingdon",NA,9574,7688,9015,14312,13036,11340,14784,12355,3462,3652,5769,-1957
"2558","Hillingdon 030A","E01002407","E02000523","Hillingdon 030","E09000017","Hillingdon","E12000007","London",2354,2269,85,48.4,725,3.1,"00AS","Hillingdon",NA,9297,6627,9804,17465,9569,8357,14564,17595,272,1730,4760,130
"2500","Hillingdon 019A","E01002408","E02000512","Hillingdon 019","E09000017","Hillingdon","E12000007","London",1527,1527,0,75.9,629,2.4,"00AS","Hillingdon",NA,9037,6933,11382,10407,7876,6447,10714,9192,-1161,-486,-668,-1215
"2501","Hillingdon 019B","E01002409","E02000512","Hillingdon 019","E09000017","Hillingdon","E12000007","London",1773,1765,8,73.2,672,2.6,"00AS","Hillingdon",NA,10454,6097,10817,10717,9918,7358,11336,14682,-536,1261,519,3965
"2489","Hillingdon 017A","E01002410","E02000510","Hillingdon 017","E09000017","Hillingdon","E12000007","London",1694,1694,0,41.6,638,2.7,"00AS","Hillingdon",NA,17590,17437,19230,17600,16042,15868,16251,24187,-1548,-1569,-2979,6587
"2516","Hillingdon 022A","E01002411","E02000515","Hillingdon 022","E09000017","Hillingdon","E12000007","London",1712,1703,9,35.2,632,2.7,"00AS","Hillingdon",NA,11757,10713,8837,10042,13386,14986,17780,4507,1629,4273,8943,-5535
"2490","Hillingdon 017B","E01002412","E02000510","Hillingdon 017","E09000017","Hillingdon","E12000007","London",2291,2261,30,32.1,822,2.8,"00AS","Hillingdon",NA,23287,20349,20391,22210,19739,22173,24068,22867,-3548,1824,3677,657
"2517","Hillingdon 022B","E01002413","E02000515","Hillingdon 022","E09000017","Hillingdon","E12000007","London",1530,1530,0,49.3,594,2.6,"00AS","Hillingdon",NA,9506,7311,10258,9182,9611,9165,11436,6429,105,1854,1178,-2753
"2481","Hillingdon 015A","E01002414","E02000508","Hillingdon 015","E09000017","Hillingdon","E12000007","London",3314,1180,2134,36.1,527,2.2,"00AS","Hillingdon",NA,18727,24060,27140,24501,26081,30174,32516,21802,7354,6114,5376,-2699
"2461","Hillingdon 010A","E01002415","E02000503","Hillingdon 010","E09000017","Hillingdon","E12000007","London",1710,1710,0,63.6,643,2.7,"00AS","Hillingdon",NA,27217,23086,25406,21218,28708,24889,28977,20702,1491,1803,3571,-516
"2451","Hillingdon 008A","E01002416","E02000501","Hillingdon 008","E09000017","Hillingdon","E12000007","London",1741,1741,0,84.3,593,2.9,"00AS","Hillingdon",NA,26088,21664,24999,20397,28942,25116,28594,19747,2854,3452,3595,-650
"2452","Hillingdon 008B","E01002417","E02000501","Hillingdon 008","E09000017","Hillingdon","E12000007","London",1596,1596,0,49.3,638,2.5,"00AS","Hillingdon",NA,26041,26985,23316,29786,28899,27679,27953,29593,2858,694,4637,-193
"2441","Hillingdon 006A","E01002418","E02000499","Hillingdon 006","E09000017","Hillingdon","E12000007","London",1789,1789,0,64.7,658,2.7,"00AS","Hillingdon",NA,17535,12496,12808,18688,24011,18425,20363,19192,6476,5929,7555,504
"2442","Hillingdon 006B","E01002419","E02000499","Hillingdon 006","E09000017","Hillingdon","E12000007","London",1531,1531,0,51.8,611,2.5,"00AS","Hillingdon",NA,26806,22243,24176,24429,30398,27810,27771,29319,3592,5567,3595,4890
"2453","Hillingdon 008C","E01002420","E02000501","Hillingdon 008","E09000017","Hillingdon","E12000007","London",1595,1595,0,54.2,662,2.4,"00AS","Hillingdon",NA,17655,10231,17177,18156,21690,13553,17615,22702,4035,3322,438,4546
"2454","Hillingdon 008D","E01002421","E02000501","Hillingdon 008","E09000017","Hillingdon","E12000007","London",1696,1646,50,48.8,636,2.6,"00AS","Hillingdon",NA,24735,19930,23634,22933,27432,21139,24883,24728,2697,1209,1249,1795
"2494","Hillingdon 018A","E01002422","E02000511","Hillingdon 018","E09000017","Hillingdon","E12000007","London",1436,1436,0,74.2,494,2.9,"00AS","Hillingdon",NA,17977,15056,16263,14253,17547,15724,15889,13776,-430,668,-374,-477
"2495","Hillingdon 018B","E01002423","E02000511","Hillingdon 018","E09000017","Hillingdon","E12000007","London",1645,1644,1,24.3,568,2.9,"00AS","Hillingdon",NA,16338,15360,17727,17290,19547,17733,18392,17542,3209,2373,665,252
"2496","Hillingdon 018C","E01002424","E02000511","Hillingdon 018","E09000017","Hillingdon","E12000007","London",1574,1574,0,42.6,526,3,"00AS","Hillingdon",NA,22011,18269,22934,16670,19798,16555,21309,19403,-2213,-1714,-1625,2733
"2497","Hillingdon 018D","E01002425","E02000511","Hillingdon 018","E09000017","Hillingdon","E12000007","London",1795,1795,0,49.8,613,2.9,"00AS","Hillingdon",NA,12392,11054,13700,10618,11769,10911,12476,9122,-623,-143,-1224,-1496
"2515","Hillingdon 021F","E01002426","E02000514","Hillingdon 021","E09000017","Hillingdon","E12000007","London",1783,1783,0,82.9,631,2.8,"00AS","Hillingdon",NA,17306,14646,16931,13078,16236,12712,18004,16732,-1070,-1934,1073,3654
"2498","Hillingdon 018E","E01002427","E02000511","Hillingdon 018","E09000017","Hillingdon","E12000007","London",1506,1444,62,74,514,2.8,"00AS","Hillingdon",NA,20421,17048,22329,18936,21454,18149,24268,18318,1033,1101,1939,-618
"2499","Hillingdon 018F","E01002428","E02000511","Hillingdon 018","E09000017","Hillingdon","E12000007","London",1470,1464,6,25.2,496,3,"00AS","Hillingdon",NA,20736,16548,23045,12955,20441,15992,23750,13647,-295,-556,705,692
"2502","Hillingdon 019C","E01002429","E02000512","Hillingdon 019","E09000017","Hillingdon","E12000007","London",1413,1413,0,38.2,498,2.8,"00AS","Hillingdon",NA,9284,6403,13189,7291,8112,6957,10234,8433,-1172,554,-2955,1142
"2446","Hillingdon 007A","E01002430","E02000500","Hillingdon 007","E09000017","Hillingdon","E12000007","London",1469,1469,0,16.1,524,2.8,"00AS","Hillingdon",NA,30227,31035,30384,29922,30215,30362,30035,30030,-12,-673,-349,108
"2443","Hillingdon 006C","E01002431","E02000499","Hillingdon 006","E09000017","Hillingdon","E12000007","London",1415,1415,0,50.4,489,2.9,"00AS","Hillingdon",NA,27762,27273,30989,30482,31606,30490,31512,31290,3844,3217,523,808
"2444","Hillingdon 006D","E01002432","E02000499","Hillingdon 006","E09000017","Hillingdon","E12000007","London",1561,1561,0,48.2,635,2.5,"00AS","Hillingdon",NA,26007,25660,26436,28228,29169,26096,29254,29419,3162,436,2818,1191
"2432","Hillingdon 004A","E01002433","E02000497","Hillingdon 004","E09000017","Hillingdon","E12000007","London",1826,1823,3,39.6,782,2.3,"00AS","Hillingdon",NA,15761,12067,12512,21122,16603,12982,15209,19171,842,915,2697,-1951
"2447","Hillingdon 007B","E01002434","E02000500","Hillingdon 007","E09000017","Hillingdon","E12000007","London",1358,1358,0,16.3,504,2.7,"00AS","Hillingdon",NA,28976,27773,29696,28892,30069,30706,31052,30401,1093,2933,1356,1509
"2448","Hillingdon 007C","E01002435","E02000500","Hillingdon 007","E09000017","Hillingdon","E12000007","London",1436,1436,0,40.2,535,2.7,"00AS","Hillingdon",NA,29641,31581,28386,29600,31324,30778,28593,30270,1683,-803,207,670
"2433","Hillingdon 004B","E01002436","E02000497","Hillingdon 004","E09000017","Hillingdon","E12000007","London",1608,1608,0,35.2,658,2.4,"00AS","Hillingdon",NA,23217,22524,19633,26610,22723,20547,18895,25441,-494,-1977,-738,-1169
"2445","Hillingdon 006E","E01002437","E02000499","Hillingdon 006","E09000017","Hillingdon","E12000007","London",1469,1469,0,34,608,2.4,"00AS","Hillingdon",NA,29346,29243,28223,30674,30926,30272,31749,31306,1580,1029,3526,632
"2427","Hillingdon 003A","E01002438","E02000496","Hillingdon 003","E09000017","Hillingdon","E12000007","London",1325,1240,85,3.6,480,2.6,"00AS","Hillingdon",NA,21845,20869,25569,19608,22884,22560,22466,20859,1039,1691,-3103,1251
"2428","Hillingdon 003B","E01002439","E02000496","Hillingdon 003","E09000017","Hillingdon","E12000007","London",1571,1482,89,22.3,608,2.4,"00AS","Hillingdon",NA,14023,11043,14695,13258,17575,14056,18514,16719,3552,3013,3819,3461
"2429","Hillingdon 003C","E01002440","E02000496","Hillingdon 003","E09000017","Hillingdon","E12000007","London",1441,1441,0,8.2,618,2.3,"00AS","Hillingdon",NA,14028,13327,15948,8506,12468,12292,11201,10876,-1560,-1035,-4747,2370
"2430","Hillingdon 003D","E01002441","E02000496","Hillingdon 003","E09000017","Hillingdon","E12000007","London",1550,1506,44,2.2,667,2.3,"00AS","Hillingdon",NA,12552,13353,17734,15440,12404,11492,13520,16947,-148,-1861,-4214,1507
"2431","Hillingdon 003E","E01002442","E02000496","Hillingdon 003","E09000017","Hillingdon","E12000007","London",1512,1512,0,7.6,635,2.4,"00AS","Hillingdon",NA,12384,10429,12108,8619,12938,13569,11923,8134,554,3140,-185,-485
"2567","Hillingdon 032A","E01002443","E02000525","Hillingdon 032","E09000017","Hillingdon","E12000007","London",1625,1625,0,6.2,547,3,"00AS","Hillingdon",NA,11094,11703,18431,22528,15017,18058,28032,18816,3923,6355,9601,-3712
"2563","Hillingdon 031A","E01002444","E02000524","Hillingdon 031","E09000017","Hillingdon","E12000007","London",1833,1551,282,1.2,625,2.5,"00AS","Hillingdon",NA,15410,16187,18755,14882,12764,15829,19874,15213,-2646,-358,1119,331
"2553","Hillingdon 029A","E01002445","E02000522","Hillingdon 029","E09000017","Hillingdon","E12000007","London",1703,1703,0,88.4,588,2.9,"00AS","Hillingdon",NA,9961,4934,12387,8423,7627,5076,10603,5015,-2334,142,-1784,-3408
"2564","Hillingdon 031B","E01002446","E02000524","Hillingdon 031","E09000017","Hillingdon","E12000007","London",1612,1562,50,8.3,592,2.6,"00AS","Hillingdon",NA,15102,16954,20193,14188,13848,18607,21912,12904,-1254,1653,1719,-1284
"2565","Hillingdon 031C","E01002447","E02000524","Hillingdon 031","E09000017","Hillingdon","E12000007","London",1697,1696,1,9,623,2.7,"00AS","Hillingdon",NA,12122,9582,16924,18307,13274,15622,20887,11015,1152,6040,3963,-7292
"2568","Hillingdon 032B","E01002448","E02000525","Hillingdon 032","E09000017","Hillingdon","E12000007","London",1957,1957,0,27.3,765,2.6,"00AS","Hillingdon",NA,12946,12106,14548,16946,12930,12870,22600,17577,-16,764,8052,631
"2569","Hillingdon 032C","E01002449","E02000525","Hillingdon 032","E09000017","Hillingdon","E12000007","London",1772,1768,4,46.6,710,2.5,"00AS","Hillingdon",NA,13261,11806,18299,14235,14400,12459,19368,17530,1139,653,1069,3295
"2476","Hillingdon 014A","E01002450","E02000507","Hillingdon 014","E09000017","Hillingdon","E12000007","London",1421,1421,0,66.1,503,2.8,"00AS","Hillingdon",NA,22662,18367,23994,16873,24681,20746,26420,20904,2019,2379,2426,4031
"2477","Hillingdon 014B","E01002451","E02000507","Hillingdon 014","E09000017","Hillingdon","E12000007","London",1514,1514,0,71.7,493,3.1,"00AS","Hillingdon",NA,23166,20408,21715,20750,27083,23384,24074,20960,3917,2976,2359,210
"2478","Hillingdon 014C","E01002452","E02000507","Hillingdon 014","E09000017","Hillingdon","E12000007","London",1539,1539,0,45,500,3.1,"00AS","Hillingdon",NA,21436,19959,25428,20412,25258,20882,24176,20777,3822,923,-1252,365
"2479","Hillingdon 014D","E01002453","E02000507","Hillingdon 014","E09000017","Hillingdon","E12000007","London",1692,1692,0,62.7,599,2.8,"00AS","Hillingdon",NA,18447,17342,21044,15837,23486,18062,25330,20908,5039,720,4286,5071
"2480","Hillingdon 014E","E01002454","E02000507","Hillingdon 014","E09000017","Hillingdon","E12000007","London",1777,1777,0,10.8,661,2.7,"00AS","Hillingdon",NA,13155,10757,13619,12026,12931,10343,14168,11923,-224,-414,549,-103
"2503","Hillingdon 019D","E01002455","E02000512","Hillingdon 019","E09000017","Hillingdon","E12000007","London",1728,1724,4,47.1,652,2.6,"00AS","Hillingdon",NA,13654,11377,14382,13184,13108,12558,14737,15790,-546,1181,355,2606
"2491","Hillingdon 017C","E01002456","E02000510","Hillingdon 017","E09000017","Hillingdon","E12000007","London",1675,1629,46,53.6,621,2.6,"00AS","Hillingdon",NA,13825,12723,19965,11732,15135,11879,17287,13313,1310,-844,-2678,1581
"2504","Hillingdon 019E","E01002457","E02000512","Hillingdon 019","E09000017","Hillingdon","E12000007","London",1560,1560,0,68.6,517,3,"00AS","Hillingdon",NA,9745,5944,9890,9082,9484,8169,10368,10404,-261,2225,478,1322
"2466","Hillingdon 011A","E01002458","E02000504","Hillingdon 011","E09000017","Hillingdon","E12000007","London",1416,1416,0,14.6,543,2.6,"00AS","Hillingdon",NA,31389,31178,28843,27735,30437,31444,27253,28152,-952,266,-1590,417
"2467","Hillingdon 011B","E01002459","E02000504","Hillingdon 011","E09000017","Hillingdon","E12000007","London",1624,1601,23,31.8,622,2.6,"00AS","Hillingdon",NA,31405,30542,25477,28412,31893,30795,29060,29453,488,253,3583,1041
"2468","Hillingdon 011C","E01002460","E02000504","Hillingdon 011","E09000017","Hillingdon","E12000007","London",1338,1338,0,35,597,2.2,"00AS","Hillingdon",NA,24534,23506,26254,29356,29903,23084,30337,28624,5369,-422,4083,-732
"2471","Hillingdon 013A","E01002461","E02000506","Hillingdon 013","E09000017","Hillingdon","E12000007","London",1435,1435,0,5.7,516,2.8,"00AS","Hillingdon",NA,25280,31328,26988,30156,25341,27205,27042,29026,61,-4123,54,-1130
"2469","Hillingdon 011D","E01002462","E02000504","Hillingdon 011","E09000017","Hillingdon","E12000007","London",1418,1418,0,34,506,2.8,"00AS","Hillingdon",NA,26032,30437,30404,30037,29633,32068,32038,31432,3601,1631,1634,1395
"2472","Hillingdon 013B","E01002463","E02000506","Hillingdon 013","E09000017","Hillingdon","E12000007","London",1570,1544,26,25.4,528,2.9,"00AS","Hillingdon",NA,26208,25016,25330,26955,27566,28222,26927,27563,1358,3206,1597,608
"2470","Hillingdon 011E","E01002464","E02000504","Hillingdon 011","E09000017","Hillingdon","E12000007","London",1586,1586,0,20.3,623,2.5,"00AS","Hillingdon",NA,27292,24149,25790,25418,29358,23061,28556,24146,2066,-1088,2766,-1272
"2456","Hillingdon 009A","E01002465","E02000502","Hillingdon 009","E09000017","Hillingdon","E12000007","London",1576,1553,23,53.1,633,2.5,"00AS","Hillingdon",NA,20098,15306,21982,25251,22870,17934,24345,21378,2772,2628,2363,-3873
"2462","Hillingdon 010B","E01002466","E02000503","Hillingdon 010","E09000017","Hillingdon","E12000007","London",1680,1680,0,73,633,2.7,"00AS","Hillingdon",NA,26933,27531,26812,20677,30470,28375,31381,24419,3537,844,4569,3742
"2457","Hillingdon 009B","E01002467","E02000502","Hillingdon 009","E09000017","Hillingdon","E12000007","London",1517,1517,0,41.1,639,2.4,"00AS","Hillingdon",NA,28637,27309,24974,24791,28394,23911,28007,21255,-243,-3398,3033,-3536
"2463","Hillingdon 010C","E01002468","E02000503","Hillingdon 010","E09000017","Hillingdon","E12000007","London",1696,1696,0,86.1,633,2.7,"00AS","Hillingdon",NA,25118,24108,25386,22007,29165,30106,28511,21283,4047,5998,3125,-724
"2464","Hillingdon 010D","E01002469","E02000503","Hillingdon 010","E09000017","Hillingdon","E12000007","London",1670,1670,0,72,631,2.6,"00AS","Hillingdon",NA,24309,25627,26647,19688,29375,28474,29463,22783,5066,2847,2816,3095
"2449","Hillingdon 007D","E01002470","E02000500","Hillingdon 007","E09000017","Hillingdon","E12000007","London",1684,1658,26,43.8,702,2.4,"00AS","Hillingdon",NA,20859,19528,16498,25859,21652,16606,24037,25528,793,-2922,7539,-331
"2455","Hillingdon 008E","E01002471","E02000501","Hillingdon 008","E09000017","Hillingdon","E12000007","London",1619,1619,0,61.2,634,2.6,"00AS","Hillingdon",NA,24813,28050,23192,25002,28997,25073,29787,27167,4184,-2977,6595,2165
"2421","Hillingdon 002A","E01002472","E02000495","Hillingdon 002","E09000017","Hillingdon","E12000007","London",1571,1476,95,29.2,771,1.9,"00AS","Hillingdon",NA,22315,17234,24421,27667,23228,16814,25131,26020,913,-420,710,-1647
"2416","Hillingdon 001A","E01002473","E02000494","Hillingdon 001","E09000017","Hillingdon","E12000007","London",1547,1547,0,4,636,2.4,"00AS","Hillingdon",NA,21186,23957,19657,31349,20585,22961,19886,30523,-601,-996,229,-826
"2422","Hillingdon 002B","E01002474","E02000495","Hillingdon 002","E09000017","Hillingdon","E12000007","London",1507,1507,0,16.3,643,2.3,"00AS","Hillingdon",NA,23320,19324,24996,27515,22147,17904,23252,27958,-1173,-1420,-1744,443
"2417","Hillingdon 001B","E01002475","E02000494","Hillingdon 001","E09000017","Hillingdon","E12000007","London",1497,1455,42,19.8,692,2.1,"00AS","Hillingdon",NA,18011,15640,14173,23597,18266,16671,13105,20522,255,1031,-1068,-3075
"2418","Hillingdon 001C","E01002476","E02000494","Hillingdon 001","E09000017","Hillingdon","E12000007","London",1576,1562,14,25.4,611,2.6,"00AS","Hillingdon",NA,30423,28861,29103,28959,30480,29096,31057,32410,57,235,1954,3451
"2419","Hillingdon 001D","E01002477","E02000494","Hillingdon 001","E09000017","Hillingdon","E12000007","London",1252,1217,35,39.6,559,2.2,"00AS","Hillingdon",NA,26686,21906,22053,31398,24849,22770,21768,27881,-1837,864,-285,-3517
"2423","Hillingdon 002C","E01002478","E02000495","Hillingdon 002","E09000017","Hillingdon","E12000007","London",1519,1494,25,41.5,666,2.2,"00AS","Hillingdon",NA,19266,15509,16546,26649,25320,22350,23093,27500,6054,6841,6547,851
"2434","Hillingdon 004C","E01002479","E02000497","Hillingdon 004","E09000017","Hillingdon","E12000007","London",1702,1644,58,21.7,628,2.6,"00AS","Hillingdon",NA,13085,11547,11838,15379,17129,14855,15893,20857,4044,3308,4055,5478
"2435","Hillingdon 004D","E01002480","E02000497","Hillingdon 004","E09000017","Hillingdon","E12000007","London",1760,1760,0,27.7,713,2.5,"00AS","Hillingdon",NA,30044,28978,30374,31395,31885,28736,31618,30258,1841,-242,1244,-1137
"2436","Hillingdon 004E","E01002481","E02000497","Hillingdon 004","E09000017","Hillingdon","E12000007","London",1633,1633,0,44.5,659,2.5,"00AS","Hillingdon",NA,11813,8196,11398,20190,14591,9235,13140,20986,2778,1039,1742,796
"2420","Hillingdon 001E","E01002482","E02000494","Hillingdon 001","E09000017","Hillingdon","E12000007","London",1607,1607,0,25.1,617,2.6,"00AS","Hillingdon",NA,31176,30498,30721,31634,31295,29960,31269,29258,119,-538,548,-2376
"2424","Hillingdon 002D","E01002483","E02000495","Hillingdon 002","E09000017","Hillingdon","E12000007","London",1739,1739,0,47.8,714,2.4,"00AS","Hillingdon",NA,21212,18364,23324,25144,26802,21700,25523,28300,5590,3336,2199,3156
"2425","Hillingdon 002E","E01002484","E02000495","Hillingdon 002","E09000017","Hillingdon","E12000007","London",1424,1424,0,60.5,585,2.4,"00AS","Hillingdon",NA,15544,10793,13413,19152,17247,14065,12979,21094,1703,3272,-434,1942
"2426","Hillingdon 002F","E01002485","E02000495","Hillingdon 002","E09000017","Hillingdon","E12000007","London",1713,1708,5,56.6,762,2.2,"00AS","Hillingdon",NA,16166,14365,13480,22658,18665,14738,16481,21806,2499,373,3001,-852
"2548","Hillingdon 028A","E01002486","E02000521","Hillingdon 028","E09000017","Hillingdon","E12000007","London",2192,2192,0,21.4,699,3.1,"00AS","Hillingdon",NA,10873,9450,11372,7578,11267,10205,12940,10380,394,755,1568,2802
"2549","Hillingdon 028B","E01002487","E02000521","Hillingdon 028","E09000017","Hillingdon","E12000007","London",1821,1821,0,93.6,614,3,"00AS","Hillingdon",NA,10258,8357,8202,16100,11404,13135,12440,9954,1146,4778,4238,-6146
"2559","Hillingdon 030B","E01002488","E02000523","Hillingdon 030","E09000017","Hillingdon","E12000007","London",1729,1729,0,57.2,533,3.2,"00AS","Hillingdon",NA,14966,13999,14604,12626,14881,12698,16344,14817,-85,-1301,1740,2191
"2560","Hillingdon 030C","E01002489","E02000523","Hillingdon 030","E09000017","Hillingdon","E12000007","London",1824,1814,10,67.7,537,3.4,"00AS","Hillingdon",NA,15228,9217,17194,19245,16137,14891,20850,19852,909,5674,3656,607
"2561","Hillingdon 030D","E01002490","E02000523","Hillingdon 030","E09000017","Hillingdon","E12000007","London",2082,2076,6,62.1,656,3.2,"00AS","Hillingdon",NA,11273,10056,15107,12713,15185,11939,17792,15527,3912,1883,2685,2814
"2570","Hillingdon 032D","E01002491","E02000525","Hillingdon 032","E09000017","Hillingdon","E12000007","London",1604,1604,0,84,519,3.1,"00AS","Hillingdon",NA,9217,4388,9531,8301,8197,7777,10709,7809,-1020,3389,1178,-492
"2562","Hillingdon 030E","E01002492","E02000523","Hillingdon 030","E09000017","Hillingdon","E12000007","London",1647,1647,0,65.2,488,3.4,"00AS","Hillingdon",NA,13253,10439,13925,11523,14150,11347,17732,14036,897,908,3807,2513
"2571","Hillingdon 032E","E01002493","E02000525","Hillingdon 032","E09000017","Hillingdon","E12000007","London",1868,1868,0,105.5,601,3.1,"00AS","Hillingdon",NA,8053,3639,9487,6603,6302,4263,10183,5159,-1751,624,696,-1444
"2458","Hillingdon 009C","E01002494","E02000502","Hillingdon 009","E09000017","Hillingdon","E12000007","London",1696,1696,0,6.4,637,2.7,"00AS","Hillingdon",NA,17782,13228,19876,15829,20293,17628,19390,19767,2511,4400,-486,3938
"2465","Hillingdon 010E","E01002495","E02000503","Hillingdon 010","E09000017","Hillingdon","E12000007","London",2230,1804,426,49.3,695,2.6,"00AS","Hillingdon",NA,19138,11406,22162,14373,24903,20008,27659,16419,5765,8602,5497,2046
"2572","Hillingdon 033A","E01002496","E02006796","Hillingdon 033","E09000017","Hillingdon","E12000007","London",1802,1768,34,30.7,767,2.3,"00AS","Hillingdon",NA,16094,12994,16675,18596,17932,16625,19324,18016,1838,3631,2649,-580
"2573","Hillingdon 033B","E01002497","E02006796","Hillingdon 033","E09000017","Hillingdon","E12000007","London",1832,1832,0,27.2,759,2.4,"00AS","Hillingdon",NA,13522,11340,11976,16711,17762,13184,20403,15601,4240,1844,8427,-1110
"2574","Hillingdon 033C","E01002498","E02006796","Hillingdon 033","E09000017","Hillingdon","E12000007","London",1416,1416,0,35.8,516,2.7,"00AS","Hillingdon",NA,21422,17306,24488,21116,24173,20957,24236,25808,2751,3651,-252,4692
"2575","Hillingdon 033D","E01002499","E02006796","Hillingdon 033","E09000017","Hillingdon","E12000007","London",1705,1705,0,7.5,678,2.5,"00AS","Hillingdon",NA,15005,14213,15331,18619,23385,17929,21180,23594,8380,3716,5849,4975
"2538","Hillingdon 026B","E01002501","E02000519","Hillingdon 026","E09000017","Hillingdon","E12000007","London",1671,1666,5,74.5,506,3.3,"00AS","Hillingdon",NA,12324,8836,13270,14436,13428,11536,14911,13141,1104,2700,1641,-1295
"2539","Hillingdon 026C","E01002502","E02000519","Hillingdon 026","E09000017","Hillingdon","E12000007","London",1589,1583,6,83.3,491,3.2,"00AS","Hillingdon",NA,8799,6849,8260,5089,8657,7214,8763,7274,-142,365,503,2185
"2544","Hillingdon 027C","E01002503","E02000520","Hillingdon 027","E09000017","Hillingdon","E12000007","London",1681,1679,2,87.6,497,3.4,"00AS","Hillingdon",NA,6847,4297,5812,6419,7694,6990,9342,10532,847,2693,3530,4113
"2545","Hillingdon 027D","E01002504","E02000520","Hillingdon 027","E09000017","Hillingdon","E12000007","London",2024,1955,69,45.2,726,2.7,"00AS","Hillingdon",NA,10774,9427,14053,15727,9116,7347,10876,11338,-1658,-2080,-3177,-4389
"2540","Hillingdon 026D","E01002505","E02000519","Hillingdon 026","E09000017","Hillingdon","E12000007","London",1694,1694,0,23.9,682,2.5,"00AS","Hillingdon",NA,5879,4561,7860,13732,6392,5730,9694,11625,513,1169,1834,-2107
"2546","Hillingdon 027E","E01002506","E02000520","Hillingdon 027","E09000017","Hillingdon","E12000007","London",1836,1831,5,64.5,643,2.8,"00AS","Hillingdon",NA,4946,3195,3789,8863,6402,5114,7593,10043,1456,1919,3804,1180
"2547","Hillingdon 027F","E01002507","E02000520","Hillingdon 027","E09000017","Hillingdon","E12000007","London",1656,1656,0,15.1,465,3.6,"00AS","Hillingdon",NA,13838,9367,15303,13588,12182,11357,14744,18467,-1656,1990,-559,4879
"2541","Hillingdon 026E","E01002508","E02000519","Hillingdon 026","E09000017","Hillingdon","E12000007","London",1955,1955,0,55.4,648,3,"00AS","Hillingdon",NA,5856,4673,7868,7706,7154,5530,9393,8053,1298,857,1525,347
"2492","Hillingdon 017D","E01002509","E02000510","Hillingdon 017","E09000017","Hillingdon","E12000007","London",1452,1448,4,31.9,502,2.9,"00AS","Hillingdon",NA,28188,26412,28842,23648,27304,25365,28735,24816,-884,-1047,-107,1168
"2493","Hillingdon 017E","E01002511","E02000510","Hillingdon 017","E09000017","Hillingdon","E12000007","London",1522,1522,0,62.4,613,2.5,"00AS","Hillingdon",NA,13271,10251,11206,16306,12020,10356,13534,18103,-1251,105,2328,1797
"2473","Hillingdon 013C","E01002512","E02000506","Hillingdon 013","E09000017","Hillingdon","E12000007","London",1741,1700,41,14.6,647,2.6,"00AS","Hillingdon",NA,26784,28046,29419,30341,29051,29581,30752,31426,2267,1535,1333,1085
"2474","Hillingdon 013D","E01002513","E02000506","Hillingdon 013","E09000017","Hillingdon","E12000007","London",1341,1341,0,23.6,544,2.5,"00AS","Hillingdon",NA,22331,25936,17899,25532,23828,21460,17878,27696,1497,-4476,-21,2164
"2482","Hillingdon 015C","E01002514","E02000508","Hillingdon 015","E09000017","Hillingdon","E12000007","London",1876,1876,0,65.8,885,2.1,"00AS","Hillingdon",NA,15155,15141,18341,27815,20309,19273,21400,25617,5154,4132,3059,-2198
"2483","Hillingdon 015D","E01002515","E02000508","Hillingdon 015","E09000017","Hillingdon","E12000007","London",1608,1608,0,25.8,718,2.2,"00AS","Hillingdon",NA,14898,13887,13889,23740,14408,11460,14760,20609,-490,-2427,871,-3131
"2475","Hillingdon 013E","E01002516","E02000506","Hillingdon 013","E09000017","Hillingdon","E12000007","London",1454,1435,19,24.8,490,2.9,"00AS","Hillingdon",NA,26396,27157,25127,26810,28339,25448,28304,27960,1943,-1709,3177,1150
"2518","Hillingdon 022C","E01002518","E02000515","Hillingdon 022","E09000017","Hillingdon","E12000007","London",1333,1321,12,57.9,490,2.7,"00AS","Hillingdon",NA,25012,23931,24121,24931,27532,28185,28841,25060,2520,4254,4720,129
"2519","Hillingdon 022D","E01002519","E02000515","Hillingdon 022","E09000017","Hillingdon","E12000007","London",1491,1485,6,23.4,719,2.1,"00AS","Hillingdon",NA,11845,9421,13507,8654,10196,10019,11780,11126,-1649,598,-1727,2472
"2485","Hillingdon 016B","E01002520","E02000509","Hillingdon 016","E09000017","Hillingdon","E12000007","London",1549,1549,0,30.6,603,2.6,"00AS","Hillingdon",NA,14030,9723,13682,17830,16324,12977,16037,15807,2294,3254,2355,-2023
"2486","Hillingdon 016C","E01002521","E02000509","Hillingdon 016","E09000017","Hillingdon","E12000007","London",1716,1716,0,31.7,909,1.9,"00AS","Hillingdon",NA,7181,7159,7377,15084,8894,6567,8940,21372,1713,-592,1563,6288
"2487","Hillingdon 016D","E01002523","E02000509","Hillingdon 016","E09000017","Hillingdon","E12000007","London",1625,1625,0,96.6,549,3,"00AS","Hillingdon",NA,15777,11133,18583,19960,17636,19091,21832,18713,1859,7958,3249,-1247
"2554","Hillingdon 029B","E01002525","E02000522","Hillingdon 029","E09000017","Hillingdon","E12000007","London",1613,1566,47,31.7,647,2.4,"00AS","Hillingdon",NA,17141,14675,21623,19910,16960,17002,22590,18499,-181,2327,967,-1411
"2550","Hillingdon 028C","E01002526","E02000521","Hillingdon 028","E09000017","Hillingdon","E12000007","London",1925,1917,8,64.6,635,3,"00AS","Hillingdon",NA,6818,2967,6749,4956,6968,7301,9683,4847,150,4334,2934,-109
"2566","Hillingdon 031D","E01002527","E02000524","Hillingdon 031","E09000017","Hillingdon","E12000007","London",1521,1462,59,17.4,622,2.4,"00AS","Hillingdon",NA,9883,5989,13335,9445,9110,7553,11744,8454,-773,1564,-1591,-991
"2551","Hillingdon 028D","E01002528","E02000521","Hillingdon 028","E09000017","Hillingdon","E12000007","London",1685,1685,0,48.2,563,3,"00AS","Hillingdon",NA,5126,3697,5871,2741,6606,6542,7150,4080,1480,2845,1279,1339
"2555","Hillingdon 029C","E01002529","E02000522","Hillingdon 029","E09000017","Hillingdon","E12000007","London",2086,2085,1,81.2,771,2.7,"00AS","Hillingdon",NA,15831,10368,17389,19952,15095,11867,19028,14151,-736,1499,1639,-5801
"2556","Hillingdon 029D","E01002530","E02000522","Hillingdon 029","E09000017","Hillingdon","E12000007","London",1634,1634,0,61,619,2.6,"00AS","Hillingdon",NA,6104,3187,6662,4176,5098,4602,5728,4286,-1006,1415,-934,110
"2557","Hillingdon 029E","E01002531","E02000522","Hillingdon 029","E09000017","Hillingdon","E12000007","London",1617,1593,24,47.3,644,2.5,"00AS","Hillingdon",NA,19848,15420,16687,17872,19192,17285,18298,16942,-656,1865,1611,-930
"2552","Hillingdon 028E","E01002532","E02000521","Hillingdon 028","E09000017","Hillingdon","E12000007","London",2289,2289,0,38.8,886,2.6,"00AS","Hillingdon",NA,10544,8245,10570,7449,8832,6941,11212,10516,-1712,-1304,642,3067
"2437","Hillingdon 005A","E01002533","E02000498","Hillingdon 005","E09000017","Hillingdon","E12000007","London",1462,1462,0,10.9,589,2.5,"00AS","Hillingdon",NA,16058,11140,16648,13887,15789,12688,13268,13839,-269,1548,-3380,-48
"2438","Hillingdon 005B","E01002534","E02000498","Hillingdon 005","E09000017","Hillingdon","E12000007","London",1465,1465,0,35.8,607,2.4,"00AS","Hillingdon",NA,20705,16296,27555,20310,25883,20658,24766,23422,5178,4362,-2789,3112
"2450","Hillingdon 007E","E01002535","E02000500","Hillingdon 007","E09000017","Hillingdon","E12000007","London",1767,1743,24,43.2,828,2.1,"00AS","Hillingdon",NA,23506,27111,25322,29523,26530,25007,29576,31051,3024,-2104,4254,1528
"2459","Hillingdon 009D","E01002536","E02000502","Hillingdon 009","E09000017","Hillingdon","E12000007","London",1420,1342,78,36.3,609,2.2,"00AS","Hillingdon",NA,24155,21395,26555,23682,25706,25690,29283,25635,1551,4295,2728,1953
"2460","Hillingdon 009E","E01002537","E02000502","Hillingdon 009","E09000017","Hillingdon","E12000007","London",1404,1404,0,31.1,579,2.4,"00AS","Hillingdon",NA,28236,27828,28613,28818,28374,27539,29776,27950,138,-289,1163,-868
"2439","Hillingdon 005C","E01002538","E02000498","Hillingdon 005","E09000017","Hillingdon","E12000007","London",1569,1569,0,15.4,746,2.1,"00AS","Hillingdon",NA,19420,18264,14949,23074,20739,18268,17490,22329,1319,4,2541,-745
"2440","Hillingdon 005D","E01002539","E02000498","Hillingdon 005","E09000017","Hillingdon","E12000007","London",1524,1524,0,40.9,619,2.5,"00AS","Hillingdon",NA,24574,23695,23849,27946,28968,24757,28296,26434,4394,1062,4447,-1512
"2507","Hillingdon 020C","E01002540","E02000513","Hillingdon 020","E09000017","Hillingdon","E12000007","London",1676,1676,0,74,621,2.7,"00AS","Hillingdon",NA,9025,5413,8021,13644,7901,6749,9301,12232,-1124,1336,1280,-1412
"2522","Hillingdon 023A","E01002541","E02000516","Hillingdon 023","E09000017","Hillingdon","E12000007","London",1949,1949,0,51.1,785,2.5,"00AS","Hillingdon",NA,17612,15173,20427,17907,18615,17857,25703,19383,1003,2684,5276,1476
"2508","Hillingdon 020D","E01002542","E02000513","Hillingdon 020","E09000017","Hillingdon","E12000007","London",1913,1906,7,108,665,2.9,"00AS","Hillingdon",NA,5378,3016,6795,6600,7423,5321,10696,10741,2045,2305,3901,4141
"2509","Hillingdon 020E","E01002543","E02000513","Hillingdon 020","E09000017","Hillingdon","E12000007","London",1728,1728,0,63.2,625,2.8,"00AS","Hillingdon",NA,7092,6903,8222,10272,8450,7182,11325,10086,1358,279,3103,-186
"2523","Hillingdon 023B","E01002544","E02000516","Hillingdon 023","E09000017","Hillingdon","E12000007","London",1678,1678,0,27.1,555,3,"00AS","Hillingdon",NA,19141,14214,18751,21948,17795,17639,21988,18901,-1346,3425,3237,-3047
"2524","Hillingdon 023C","E01002545","E02000516","Hillingdon 023","E09000017","Hillingdon","E12000007","London",1503,1503,0,53,483,3.1,"00AS","Hillingdon",NA,5598,1680,7835,8223,3371,2056,4870,5341,-2227,376,-2965,-2882
"2525","Hillingdon 023D","E01002546","E02000516","Hillingdon 023","E09000017","Hillingdon","E12000007","London",1573,1567,6,82.2,449,3.5,"00AS","Hillingdon",NA,12437,11860,15428,18059,15646,15250,21376,18867,3209,3390,5948,808
"2526","Hillingdon 023E","E01002547","E02000516","Hillingdon 023","E09000017","Hillingdon","E12000007","London",1566,1566,0,87.2,492,3.2,"00AS","Hillingdon",NA,11712,8211,11966,18118,9825,8342,13549,14177,-1887,131,1583,-3941
"2532","Hillingdon 025A","E01002548","E02000518","Hillingdon 025","E09000017","Hillingdon","E12000007","London",1675,1675,0,14.5,657,2.5,"00AS","Hillingdon",NA,9674,5553,10546,5994,8938,5969,9988,6731,-736,416,-558,737
"2533","Hillingdon 025B","E01002549","E02000518","Hillingdon 025","E09000017","Hillingdon","E12000007","London",1751,1743,8,29,672,2.6,"00AS","Hillingdon",NA,11479,10272,12620,15833,12993,13530,16543,14111,1514,3258,3923,-1722
"2520","Hillingdon 022E","E01002550","E02000515","Hillingdon 022","E09000017","Hillingdon","E12000007","London",1810,1806,4,73.9,795,2.3,"00AS","Hillingdon",NA,13228,11285,19116,10239,7793,9236,13834,10098,-5435,-2049,-5282,-141
"2534","Hillingdon 025C","E01002551","E02000518","Hillingdon 025","E09000017","Hillingdon","E12000007","London",1905,1905,0,59.9,641,3,"00AS","Hillingdon",NA,13765,9631,14542,12287,13025,9212,14666,11092,-740,-419,124,-1195
"2535","Hillingdon 025D","E01002552","E02000518","Hillingdon 025","E09000017","Hillingdon","E12000007","London",1582,1582,0,60.8,526,3,"00AS","Hillingdon",NA,8488,6798,13472,6366,8771,7382,14312,4944,283,584,840,-1422
"2536","Hillingdon 025E","E01002553","E02000518","Hillingdon 025","E09000017","Hillingdon","E12000007","London",1693,1688,5,89.4,603,2.8,"00AS","Hillingdon",NA,8933,6427,10182,5334,7311,6887,8701,3680,-1622,460,-1481,-1654
"2521","Hillingdon 022F","E01002554","E02000515","Hillingdon 022","E09000017","Hillingdon","E12000007","London",2563,2543,20,20.6,1073,2.4,"00AS","Hillingdon",NA,10138,8735,13261,12777,9435,10441,13271,13760,-703,1706,10,983
"2678","Hounslow 022A","E01002555","E02000547","Hounslow 022","E09000018","Hounslow","E12000007","London",1917,1917,0,26.7,681,2.8,"00AT","Hounslow",NA,17722,15411,21230,17069,17800,18147,21825,16028,78,2736,595,-1041
"2679","Hounslow 022B","E01002556","E02000547","Hounslow 022","E09000018","Hounslow","E12000007","London",1681,1681,0,83.8,639,2.6,"00AT","Hounslow",NA,14423,13717,18238,11437,16330,15875,20300,14776,1907,2158,2062,3339
"2683","Hounslow 023A","E01002557","E02000548","Hounslow 023","E09000018","Hounslow","E12000007","London",1785,1785,0,52.8,743,2.4,"00AT","Hounslow",NA,11179,9650,19904,9083,9069,10846,14129,9579,-2110,1196,-5775,496
"2684","Hounslow 023B","E01002558","E02000548","Hounslow 023","E09000018","Hounslow","E12000007","London",1945,1945,0,82.7,773,2.5,"00AT","Hounslow",NA,7551,6394,11275,6808,9607,8799,13751,8544,2056,2405,2476,1736
"2685","Hounslow 023C","E01002559","E02000548","Hounslow 023","E09000018","Hounslow","E12000007","London",2279,2274,5,9.6,857,2.7,"00AT","Hounslow",NA,7937,5468,10244,5533,9578,9061,12587,8357,1641,3593,2343,2824
"2686","Hounslow 023D","E01002560","E02000548","Hounslow 023","E09000018","Hounslow","E12000007","London",1715,1702,13,51.4,615,2.8,"00AT","Hounslow",NA,9599,7555,12513,8177,7261,8994,10582,5234,-2338,1439,-1931,-2943
"2687","Hounslow 023E","E01002561","E02000548","Hounslow 023","E09000018","Hounslow","E12000007","London",1379,1379,0,56.4,551,2.5,"00AT","Hounslow",NA,6371,2105,8236,5968,5690,3763,7041,4897,-681,1658,-1195,-1071
"2582","Hounslow 003A","E01002562","E02000528","Hounslow 003","E09000018","Hounslow","E12000007","London",1379,1368,11,14.5,518,2.6,"00AT","Hounslow",NA,9502,6378,11087,16897,7525,7848,11518,15005,-1977,1470,431,-1892
"2597","Hounslow 006A","E01002563","E02000531","Hounslow 006","E09000018","Hounslow","E12000007","London",1642,1633,9,32.6,635,2.6,"00AT","Hounslow",NA,18184,18180,20952,29937,16316,18651,20221,27217,-1868,471,-731,-2720
"2583","Hounslow 003B","E01002564","E02000528","Hounslow 003","E09000018","Hounslow","E12000007","London",1888,1888,0,78.7,736,2.6,"00AT","Hounslow",NA,7496,4766,9915,13290,8332,6004,9443,15410,836,1238,-472,2120
"2598","Hounslow 006B","E01002565","E02000531","Hounslow 006","E09000018","Hounslow","E12000007","London",2829,2053,776,62.7,1020,2,"00AT","Hounslow",NA,12741,14238,16669,27073,18465,23547,28879,27833,5724,9309,12210,760
"2584","Hounslow 003C","E01002566","E02000528","Hounslow 003","E09000018","Hounslow","E12000007","London",2123,2123,0,36.1,1027,2.1,"00AT","Hounslow",NA,5872,2795,5661,13280,6181,4878,7878,11206,309,2083,2217,-2074
"2599","Hounslow 006C","E01002567","E02000531","Hounslow 006","E09000018","Hounslow","E12000007","London",1733,1733,0,79.2,837,2.1,"00AT","Hounslow",NA,13501,15575,18883,26540,16545,18101,22495,28846,3044,2526,3612,2306
"2585","Hounslow 003D","E01002568","E02000528","Hounslow 003","E09000018","Hounslow","E12000007","London",2759,2759,0,138.4,1181,2.3,"00AT","Hounslow",NA,3004,999,3048,8099,6926,5372,12258,17263,3922,4373,9210,9164
"2577","Hounslow 001A","E01002569","E02000526","Hounslow 001","E09000018","Hounslow","E12000007","London",1764,1697,67,85.5,792,2.1,"00AT","Hounslow",NA,19641,18074,24092,27310,22682,22498,26627,32172,3041,4424,2535,4862
"2578","Hounslow 001B","E01002570","E02000526","Hounslow 001","E09000018","Hounslow","E12000007","London",1682,1663,19,116,732,2.3,"00AT","Hounslow",NA,16085,17087,25004,26727,19256,22568,25721,27875,3171,5481,717,1148
"2602","Hounslow 007A","E01002571","E02000532","Hounslow 007","E09000018","Hounslow","E12000007","London",1325,1325,0,66.6,611,2.2,"00AT","Hounslow",NA,25864,31246,30328,32325,28878,31539,32525,32178,3014,293,2197,-147
"2603","Hounslow 007B","E01002572","E02000532","Hounslow 007","E09000018","Hounslow","E12000007","London",1643,1643,0,18.1,710,2.3,"00AT","Hounslow",NA,6633,4943,4223,16388,7685,6050,9636,18568,1052,1107,5413,2180
"2579","Hounslow 001C","E01002573","E02000526","Hounslow 001","E09000018","Hounslow","E12000007","London",1650,1650,0,89.9,679,2.4,"00AT","Hounslow",NA,23039,27331,29873,27692,22322,28803,31135,32540,-717,1472,1262,4848
"2580","Hounslow 001D","E01002574","E02000526","Hounslow 001","E09000018","Hounslow","E12000007","London",1537,1537,0,94.5,645,2.4,"00AT","Hounslow",NA,19698,20941,28158,31995,23132,25884,30124,30233,3434,4943,1966,-1762
"2581","Hounslow 001E","E01002575","E02000526","Hounslow 001","E09000018","Hounslow","E12000007","London",1745,1745,0,76.9,688,2.5,"00AT","Hounslow",NA,18658,21571,25956,29630,25142,26582,31759,30735,6484,5011,5803,1105
"2608","Hounslow 008A","E01002576","E02000533","Hounslow 008","E09000018","Hounslow","E12000007","London",1746,1746,0,93.8,756,2.3,"00AT","Hounslow",NA,12035,8813,13597,25903,11559,11361,12638,22200,-476,2548,-959,-3703
"2604","Hounslow 007C","E01002577","E02000532","Hounslow 007","E09000018","Hounslow","E12000007","London",1635,1635,0,46,660,2.5,"00AT","Hounslow",NA,19287,19510,25784,31680,21178,22776,22848,30823,1891,3266,-2936,-857
"2605","Hounslow 007D","E01002578","E02000532","Hounslow 007","E09000018","Hounslow","E12000007","London",1502,1502,0,29.7,612,2.5,"00AT","Hounslow",NA,19011,19144,24609,31964,19721,22901,23751,32453,710,3757,-858,489
"2609","Hounslow 008B","E01002579","E02000533","Hounslow 008","E09000018","Hounslow","E12000007","London",1746,1746,0,43.2,823,2.1,"00AT","Hounslow",NA,22821,25109,25253,31826,22484,24635,24793,32252,-337,-474,-460,426
"2610","Hounslow 008C","E01002580","E02000533","Hounslow 008","E09000018","Hounslow","E12000007","London",1386,1386,0,117.4,675,2.1,"00AT","Hounslow",NA,9238,8746,12885,20959,9797,9549,13925,28197,559,803,1040,7238
"2611","Hounslow 008D","E01002581","E02000533","Hounslow 008","E09000018","Hounslow","E12000007","London",1860,1860,0,101.1,862,2.2,"00AT","Hounslow",NA,19190,20087,26239,28122,23473,21288,25815,30795,4283,1201,-424,2673
"2612","Hounslow 008E","E01002582","E02000533","Hounslow 008","E09000018","Hounslow","E12000007","London",1668,1668,0,97.5,719,2.3,"00AT","Hounslow",NA,22919,22535,23898,31564,23925,24118,25812,29878,1006,1583,1914,-1686
"2632","Hounslow 013A","E01002583","E02000538","Hounslow 013","E09000018","Hounslow","E12000007","London",1706,1706,0,42.2,512,3.3,"00AT","Hounslow",NA,10329,10371,14511,21897,10593,13362,17909,22931,264,2991,3398,1034
"2633","Hounslow 013B","E01002584","E02000538","Hounslow 013","E09000018","Hounslow","E12000007","London",1691,1691,0,51.5,493,3.4,"00AT","Hounslow",NA,8642,9845,11745,17122,13322,14840,19388,21724,4680,4995,7643,4602
"2634","Hounslow 013C","E01002585","E02000538","Hounslow 013","E09000018","Hounslow","E12000007","London",1651,1651,0,78.8,509,3.2,"00AT","Hounslow",NA,6662,4860,8148,14633,7468,8447,10686,11584,806,3587,2538,-3049
"2635","Hounslow 013D","E01002586","E02000538","Hounslow 013","E09000018","Hounslow","E12000007","London",1650,1650,0,38.7,457,3.6,"00AT","Hounslow",NA,12987,12523,12921,26049,15067,18227,23885,16958,2080,5704,10964,-9091
"2647","Hounslow 016A","E01002587","E02000541","Hounslow 016","E09000018","Hounslow","E12000007","London",1895,1895,0,84.2,605,3.1,"00AT","Hounslow",NA,10092,9309,9446,23569,9062,11937,14993,20525,-1030,2628,5547,-3044
"2648","Hounslow 016B","E01002588","E02000541","Hounslow 016","E09000018","Hounslow","E12000007","London",1755,1755,0,123.5,677,2.6,"00AT","Hounslow",NA,4028,1194,3484,8503,3137,1852,4086,4934,-891,658,602,-3569
"2636","Hounslow 013E","E01002589","E02000538","Hounslow 013","E09000018","Hounslow","E12000007","London",1982,1982,0,20.1,677,2.9,"00AT","Hounslow",NA,8883,4796,9082,14559,9563,7240,12354,13546,680,2444,3272,-1013
"2680","Hounslow 022C","E01002590","E02000547","Hounslow 022","E09000018","Hounslow","E12000007","London",1839,1839,0,52.2,726,2.5,"00AT","Hounslow",NA,10364,10760,11106,9840,14675,15678,19548,10740,4311,4918,8442,900
"2688","Hounslow 024A","E01002591","E02000549","Hounslow 024","E09000018","Hounslow","E12000007","London",1729,1729,0,53.1,626,2.8,"00AT","Hounslow",NA,10239,9668,11499,4280,14139,12860,14892,9622,3900,3192,3393,5342
"2681","Hounslow 022D","E01002592","E02000547","Hounslow 022","E09000018","Hounslow","E12000007","London",1999,1999,0,11.6,789,2.5,"00AT","Hounslow",NA,10047,7823,12128,7394,12298,10220,17281,8769,2251,2397,5153,1375
"2689","Hounslow 024B","E01002593","E02000549","Hounslow 024","E09000018","Hounslow","E12000007","London",2118,1966,152,47.6,725,2.7,"00AT","Hounslow",NA,11842,11812,13798,17136,11716,14925,16051,13833,-126,3113,2253,-3303
"2690","Hounslow 024C","E01002594","E02000549","Hounslow 024","E09000018","Hounslow","E12000007","London",1954,1954,0,73.1,642,3,"00AT","Hounslow",NA,14220,10743,18914,13120,11079,8400,11400,15231,-3141,-2343,-7514,2111
"2682","Hounslow 022E","E01002595","E02000547","Hounslow 022","E09000018","Hounslow","E12000007","London",1924,1924,0,71,712,2.7,"00AT","Hounslow",NA,8132,6245,8784,7791,8878,7296,10203,8887,746,1051,1419,1096
"2705","Hounslow 027A","E01002596","E02000552","Hounslow 027","E09000018","Hounslow","E12000007","London",1996,1828,168,43.3,772,2.4,"00AT","Hounslow",NA,16247,9928,28002,15528,10845,13722,19069,11798,-5402,3794,-8933,-3730
"2694","Hounslow 025B","E01002598","E02000550","Hounslow 025","E09000018","Hounslow","E12000007","London",1840,1840,0,81.9,649,2.8,"00AT","Hounslow",NA,9008,8814,11805,8291,9012,10741,14268,6735,4,1927,2463,-1556
"2695","Hounslow 025C","E01002599","E02000550","Hounslow 025","E09000018","Hounslow","E12000007","London",1607,1607,0,88.1,569,2.8,"00AT","Hounslow",NA,7881,5590,12297,6278,9153,10478,12174,5664,1272,4888,-123,-614
"2696","Hounslow 025D","E01002600","E02000550","Hounslow 025","E09000018","Hounslow","E12000007","London",1524,1524,0,95.9,520,2.9,"00AT","Hounslow",NA,9562,8597,12904,5963,10777,10985,13726,6498,1215,2388,822,535
"2706","Hounslow 027B","E01002601","E02000552","Hounslow 027","E09000018","Hounslow","E12000007","London",1665,1665,0,10.6,637,2.6,"00AT","Hounslow",NA,16203,18564,21915,12356,16699,16730,24784,12437,496,-1834,2869,81
"2707","Hounslow 027C","E01002602","E02000552","Hounslow 027","E09000018","Hounslow","E12000007","London",1477,1477,0,70.5,564,2.6,"00AT","Hounslow",NA,17089,20914,24866,10189,18071,19857,26249,11901,982,-1057,1383,1712
"2697","Hounslow 025E","E01002603","E02000550","Hounslow 025","E09000018","Hounslow","E12000007","London",1924,1924,0,86.4,666,2.9,"00AT","Hounslow",NA,10556,5687,14269,9073,11175,11283,14829,7629,619,5596,560,-1444
"2700","Hounslow 026A","E01002604","E02000551","Hounslow 026","E09000018","Hounslow","E12000007","London",1733,1733,0,57.7,588,2.9,"00AT","Hounslow",NA,2874,469,5641,6140,4809,3423,6087,6779,1935,2954,446,639
"2701","Hounslow 026B","E01002605","E02000551","Hounslow 026","E09000018","Hounslow","E12000007","London",1847,1847,0,56.3,753,2.5,"00AT","Hounslow",NA,5794,8116,8653,8682,7298,7037,10076,10046,1504,-1079,1423,1364
"2702","Hounslow 026C","E01002606","E02000551","Hounslow 026","E09000018","Hounslow","E12000007","London",1641,1641,0,79.5,671,2.4,"00AT","Hounslow",NA,3847,2843,3645,3478,4484,5033,5547,4917,637,2190,1902,1439
"2703","Hounslow 026D","E01002607","E02000551","Hounslow 026","E09000018","Hounslow","E12000007","London",1923,1923,0,55.9,676,2.8,"00AT","Hounslow",NA,10564,7929,12981,9544,13062,10966,16382,9683,2498,3037,3401,139
"2710","Hounslow 028A","E01002608","E02000553","Hounslow 028","E09000018","Hounslow","E12000007","London",1717,1717,0,49.6,676,2.5,"00AT","Hounslow",NA,6624,6370,8212,5718,6111,7172,8090,6679,-513,802,-122,961
"2711","Hounslow 028B","E01002609","E02000553","Hounslow 028","E09000018","Hounslow","E12000007","London",1730,1730,0,81.4,655,2.6,"00AT","Hounslow",NA,16046,17738,24371,9800,17606,16366,22253,17353,1560,-1372,-2118,7553
"2712","Hounslow 028C","E01002610","E02000553","Hounslow 028","E09000018","Hounslow","E12000007","London",1564,1564,0,10.3,632,2.5,"00AT","Hounslow",NA,7780,5642,10313,4597,9045,9023,10554,7739,1265,3381,241,3142
"2691","Hounslow 024D","E01002611","E02000549","Hounslow 024","E09000018","Hounslow","E12000007","London",1785,1785,0,20.7,636,2.8,"00AT","Hounslow",NA,11015,8421,15206,7859,12351,14344,14758,10545,1336,5923,-448,2686
"2692","Hounslow 024E","E01002612","E02000549","Hounslow 024","E09000018","Hounslow","E12000007","London",1670,1670,0,50.3,699,2.4,"00AT","Hounslow",NA,10321,10915,14988,14379,8486,8192,12865,10159,-1835,-2723,-2123,-4220
"2693","Hounslow 024F","E01002613","E02000549","Hounslow 024","E09000018","Hounslow","E12000007","London",1761,1761,0,78.8,609,2.9,"00AT","Hounslow",NA,12502,10739,14784,10014,15489,13567,20402,10283,2987,2828,5618,269
"2708","Hounslow 027D","E01002614","E02000552","Hounslow 027","E09000018","Hounslow","E12000007","London",1746,1746,0,29.3,758,2.3,"00AT","Hounslow",NA,18230,16027,25763,15826,17260,16368,25370,19802,-970,341,-393,3976
"2704","Hounslow 026E","E01002615","E02000551","Hounslow 026","E09000018","Hounslow","E12000007","London",1470,1470,0,15.5,606,2.4,"00AT","Hounslow",NA,4811,3722,6046,5210,4431,4605,7258,6010,-380,883,1212,800
"2709","Hounslow 027E","E01002616","E02000552","Hounslow 027","E09000018","Hounslow","E12000007","London",1382,1382,0,60.8,535,2.6,"00AT","Hounslow",NA,16787,14708,18042,11576,14480,16048,16614,7531,-2307,1340,-1428,-4045
"2713","Hounslow 028D","E01002617","E02000553","Hounslow 028","E09000018","Hounslow","E12000007","London",1594,1594,0,35.3,642,2.5,"00AT","Hounslow",NA,17107,19257,26121,12507,18604,24505,25739,17276,1497,5248,-382,4769
"2622","Hounslow 011A","E01002618","E02000536","Hounslow 011","E09000018","Hounslow","E12000007","London",1758,1714,44,76.2,512,3.3,"00AT","Hounslow",NA,16929,14685,17521,27374,17995,18287,22522,23000,1066,3602,5001,-4374
"2617","Hounslow 010A","E01002619","E02000535","Hounslow 010","E09000018","Hounslow","E12000007","London",1959,1959,0,82.5,624,3.1,"00AT","Hounslow",NA,15618,12346,17359,26477,14822,12312,18333,21579,-796,-34,974,-4898
"2588","Hounslow 004A","E01002620","E02000529","Hounslow 004","E09000018","Hounslow","E12000007","London",1851,1851,0,60.9,676,2.7,"00AT","Hounslow",NA,10419,8326,11911,21329,9809,8893,12341,17135,-610,567,430,-4194
"2623","Hounslow 011B","E01002621","E02000536","Hounslow 011","E09000018","Hounslow","E12000007","London",1817,1813,4,64,594,3.1,"00AT","Hounslow",NA,10466,7994,11469,19368,11187,10706,14632,18945,721,2712,3163,-423
"2618","Hounslow 010B","E01002622","E02000535","Hounslow 010","E09000018","Hounslow","E12000007","London",1731,1731,0,84.2,526,3.3,"00AT","Hounslow",NA,12715,13162,19376,27644,13291,13297,20696,21736,576,135,1320,-5908
"2624","Hounslow 011C","E01002623","E02000536","Hounslow 011","E09000018","Hounslow","E12000007","London",1667,1635,32,83,484,3.4,"00AT","Hounslow",NA,6824,7174,9049,17957,8348,8795,9246,18384,1524,1621,197,427
"2652","Hounslow 017A","E01002624","E02000542","Hounslow 017","E09000018","Hounslow","E12000007","London",1505,1503,2,67.6,480,3.1,"00AT","Hounslow",NA,11341,9639,13942,20900,10833,12152,15283,20701,-508,2513,1341,-199
"2589","Hounslow 004B","E01002625","E02000529","Hounslow 004","E09000018","Hounslow","E12000007","London",1681,1681,0,85.9,492,3.4,"00AT","Hounslow",NA,10196,11176,13603,22308,16022,15840,18010,17279,5826,4664,4407,-5029
"2590","Hounslow 004C","E01002626","E02000529","Hounslow 004","E09000018","Hounslow","E12000007","London",1626,1626,0,46.4,490,3.3,"00AT","Hounslow",NA,14299,14037,13202,25359,14377,13521,17296,20541,78,-516,4094,-4818
"2591","Hounslow 004D","E01002627","E02000529","Hounslow 004","E09000018","Hounslow","E12000007","London",1662,1662,0,133.4,609,2.7,"00AT","Hounslow",NA,6700,3303,5834,16200,7297,5069,7800,13983,597,1766,1966,-2217
"2625","Hounslow 011D","E01002628","E02000536","Hounslow 011","E09000018","Hounslow","E12000007","London",1940,1940,0,54.7,620,3.1,"00AT","Hounslow",NA,17019,13687,19047,27502,18616,16452,23509,24111,1597,2765,4462,-3391
"2626","Hounslow 011E","E01002629","E02000536","Hounslow 011","E09000018","Hounslow","E12000007","London",2087,2087,0,38.9,715,2.9,"00AT","Hounslow",NA,13800,8033,15759,27028,13318,11194,17733,22000,-482,3161,1974,-5028
"2627","Hounslow 012A","E01002630","E02000537","Hounslow 012","E09000018","Hounslow","E12000007","London",1695,1695,0,72.1,569,3,"00AT","Hounslow",NA,18379,14070,25094,28266,16757,17070,23748,26730,-1622,3000,-1346,-1536
"2592","Hounslow 004E","E01002631","E02000529","Hounslow 004","E09000018","Hounslow","E12000007","London",1628,1628,0,78.5,509,3.2,"00AT","Hounslow",NA,11789,8582,13393,23172,11088,10734,13635,18674,-701,2152,242,-4498
"2619","Hounslow 010C","E01002632","E02000535","Hounslow 010","E09000018","Hounslow","E12000007","London",1832,1828,4,49.9,569,3.2,"00AT","Hounslow",NA,12592,9244,13334,26255,15910,13486,20566,22171,3318,4242,7232,-4084
"2593","Hounslow 005A","E01002633","E02000530","Hounslow 005","E09000018","Hounslow","E12000007","London",1643,1642,1,16.6,623,2.6,"00AT","Hounslow",NA,4892,2484,6506,9422,3988,3331,5454,6024,-904,847,-1052,-3398
"2594","Hounslow 005B","E01002634","E02000530","Hounslow 005","E09000018","Hounslow","E12000007","London",1712,1712,0,70.7,546,3.1,"00AT","Hounslow",NA,5385,2069,6890,8829,5166,4268,7309,8523,-219,2199,419,-306
"2620","Hounslow 010D","E01002635","E02000535","Hounslow 010","E09000018","Hounslow","E12000007","London",1753,1753,0,33.1,524,3.3,"00AT","Hounslow",NA,11358,9730,17404,22148,13339,16195,20987,22455,1981,6465,3583,307
"2621","Hounslow 010E","E01002636","E02000535","Hounslow 010","E09000018","Hounslow","E12000007","London",2016,2016,0,96.1,609,3.3,"00AT","Hounslow",NA,16756,11505,17610,27144,15062,13649,18929,19387,-1694,2144,1319,-7757
"2595","Hounslow 005C","E01002637","E02000530","Hounslow 005","E09000018","Hounslow","E12000007","London",1659,1659,0,23.9,563,2.9,"00AT","Hounslow",NA,6245,3652,7120,15066,6193,5418,9230,13272,-52,1766,2110,-1794
"2596","Hounslow 005D","E01002638","E02000530","Hounslow 005","E09000018","Hounslow","E12000007","London",1823,1823,0,22.8,582,3.1,"00AT","Hounslow",NA,7047,4310,9600,12310,6528,7003,11023,10766,-519,2693,1423,-1544
"2628","Hounslow 012B","E01002639","E02000537","Hounslow 012","E09000018","Hounslow","E12000007","London",1703,1695,8,89,497,3.4,"00AT","Hounslow",NA,21104,20908,23091,29259,17929,20582,22924,25869,-3175,-326,-167,-3390
"2629","Hounslow 012C","E01002640","E02000537","Hounslow 012","E09000018","Hounslow","E12000007","London",1800,1800,0,80.5,548,3.3,"00AT","Hounslow",NA,22415,21317,28253,27688,16461,24431,29583,27302,-5954,3114,1330,-386
"2657","Hounslow 018A","E01002641","E02000543","Hounslow 018","E09000018","Hounslow","E12000007","London",1932,1928,4,94.7,637,3,"00AT","Hounslow",NA,11679,9370,16354,26863,11260,14203,18625,21744,-419,4833,2271,-5119
"2642","Hounslow 015A","E01002642","E02000540","Hounslow 015","E09000018","Hounslow","E12000007","London",2005,2005,0,76,735,2.7,"00AT","Hounslow",NA,16702,14281,23578,26031,12719,14895,24315,28122,-3983,614,737,2091
"2643","Hounslow 015B","E01002643","E02000540","Hounslow 015","E09000018","Hounslow","E12000007","London",2289,2276,13,70.8,910,2.5,"00AT","Hounslow",NA,14630,10048,14268,24997,12567,11178,15481,22651,-2063,1130,1213,-2346
"2644","Hounslow 015C","E01002645","E02000540","Hounslow 015","E09000018","Hounslow","E12000007","London",2054,2043,11,79.4,766,2.7,"00AT","Hounslow",NA,10400,9678,13159,24943,9549,12789,16083,19573,-851,3111,2924,-5370
"2653","Hounslow 017B","E01002646","E02000542","Hounslow 017","E09000018","Hounslow","E12000007","London",2016,2016,0,139.6,712,2.8,"00AT","Hounslow",NA,7108,3005,8304,21722,7343,6087,11098,14072,235,3082,2794,-7650
"2673","Hounslow 021A","E01002647","E02000546","Hounslow 021","E09000018","Hounslow","E12000007","London",2213,2213,0,126.8,753,2.9,"00AT","Hounslow",NA,12181,7273,15786,19661,9767,9208,13475,20044,-2414,1935,-2311,383
"2658","Hounslow 018C","E01002648","E02000543","Hounslow 018","E09000018","Hounslow","E12000007","London",2689,2689,0,116,900,3,"00AT","Hounslow",NA,10623,11184,15926,23174,11843,14622,20950,17762,1220,3438,5024,-5412
"2659","Hounslow 018D","E01002649","E02000543","Hounslow 018","E09000018","Hounslow","E12000007","London",1830,1784,46,89.4,692,2.6,"00AT","Hounslow",NA,10849,8773,14760,25228,9572,10193,16636,22015,-1277,1420,1876,-3213
"2674","Hounslow 021B","E01002650","E02000546","Hounslow 021","E09000018","Hounslow","E12000007","London",2436,2436,0,14.3,792,3.1,"00AT","Hounslow",NA,10567,9388,14354,21048,10324,11034,15773,21859,-243,1646,1419,811
"2675","Hounslow 021C","E01002651","E02000546","Hounslow 021","E09000018","Hounslow","E12000007","London",1778,1778,0,135.7,550,3.2,"00AT","Hounslow",NA,12796,10451,15061,23999,14126,13385,16478,23360,1330,2934,1417,-639
"2676","Hounslow 021D","E01002652","E02000546","Hounslow 021","E09000018","Hounslow","E12000007","London",1765,1765,0,91.5,516,3.4,"00AT","Hounslow",NA,15110,12411,14697,26809,14345,13329,17280,21393,-765,918,2583,-5416
"2663","Hounslow 019A","E01002653","E02000544","Hounslow 019","E09000018","Hounslow","E12000007","London",1813,1813,0,84.4,542,3.3,"00AT","Hounslow",NA,18817,19106,18410,25573,20873,19934,21431,22009,2056,828,3021,-3564
"2664","Hounslow 019B","E01002654","E02000544","Hounslow 019","E09000018","Hounslow","E12000007","London",1785,1785,0,41.9,646,2.8,"00AT","Hounslow",NA,18355,16709,20819,27364,20355,21595,24084,25991,2000,4886,3265,-1373
"2665","Hounslow 019C","E01002655","E02000544","Hounslow 019","E09000018","Hounslow","E12000007","London",1885,1885,0,74.2,622,3,"00AT","Hounslow",NA,20062,17226,21132,26160,19409,23045,23631,24199,-653,5819,2499,-1961
"2666","Hounslow 019D","E01002656","E02000544","Hounslow 019","E09000018","Hounslow","E12000007","London",1318,1318,0,63.8,479,2.8,"00AT","Hounslow",NA,21745,19396,26022,24076,19334,19222,20679,22669,-2411,-174,-5343,-1407
"2660","Hounslow 018E","E01002657","E02000543","Hounslow 018","E09000018","Hounslow","E12000007","London",1876,1876,0,80.5,650,2.9,"00AT","Hounslow",NA,21171,18222,23262,29163,24453,24583,28387,26112,3282,6361,5125,-3051
"2645","Hounslow 015D","E01002658","E02000540","Hounslow 015","E09000018","Hounslow","E12000007","London",1333,1333,0,76.2,501,2.7,"00AT","Hounslow",NA,24252,24404,26997,24559,23039,29795,30925,29354,-1213,5391,3928,4795
"2667","Hounslow 019E","E01002659","E02000544","Hounslow 019","E09000018","Hounslow","E12000007","London",1398,1398,0,49.2,504,2.8,"00AT","Hounslow",NA,17546,18972,16185,25988,18208,17018,21236,20912,662,-1954,5051,-5076
"2649","Hounslow 016C","E01002660","E02000541","Hounslow 016","E09000018","Hounslow","E12000007","London",1758,1758,0,65.5,522,3.4,"00AT","Hounslow",NA,12114,11550,12566,25113,14171,13923,18454,21383,2057,2373,5888,-3730
"2650","Hounslow 016D","E01002661","E02000541","Hounslow 016","E09000018","Hounslow","E12000007","London",1849,1847,2,66,518,3.6,"00AT","Hounslow",NA,10062,11167,11377,23437,14076,16231,17727,21513,4014,5064,6350,-1924
"2654","Hounslow 017C","E01002662","E02000542","Hounslow 017","E09000018","Hounslow","E12000007","London",1999,1991,8,81.7,627,3.2,"00AT","Hounslow",NA,11214,11343,17057,28472,17851,22492,26834,27838,6637,11149,9777,-634
"2655","Hounslow 017D","E01002663","E02000542","Hounslow 017","E09000018","Hounslow","E12000007","London",2074,2074,0,119.8,751,2.8,"00AT","Hounslow",NA,10399,7556,14030,22323,12901,11841,18745,20679,2502,4285,4715,-1644
"2656","Hounslow 017E","E01002664","E02000542","Hounslow 017","E09000018","Hounslow","E12000007","London",1802,1714,88,69,596,2.9,"00AT","Hounslow",NA,10896,9673,15179,19662,6538,7343,10649,23866,-4358,-2330,-4530,4204
"2651","Hounslow 016E","E01002665","E02000541","Hounslow 016","E09000018","Hounslow","E12000007","London",1618,1611,7,116.5,524,3.1,"00AT","Hounslow",NA,9261,6173,8697,18103,10077,9444,14117,17923,816,3271,5420,-180
"2677","Hounslow 021E","E01002666","E02000546","Hounslow 021","E09000018","Hounslow","E12000007","London",1558,1376,182,61.3,407,3.4,"00AT","Hounslow",NA,14843,14053,18902,16153,15578,14196,18623,18954,735,143,-279,2801
"2668","Hounslow 020A","E01002667","E02000545","Hounslow 020","E09000018","Hounslow","E12000007","London",1573,1529,44,50.2,651,2.3,"00AT","Hounslow",NA,12452,8064,12008,23915,13564,11415,12327,23598,1112,3351,319,-317
"2637","Hounslow 014A","E01002668","E02000539","Hounslow 014","E09000018","Hounslow","E12000007","London",2014,1943,71,58.7,883,2.2,"00AT","Hounslow",NA,15454,12255,19462,22995,17733,15691,21341,21706,2279,3436,1879,-1289
"2638","Hounslow 014B","E01002669","E02000539","Hounslow 014","E09000018","Hounslow","E12000007","London",1782,1782,0,57.7,711,2.5,"00AT","Hounslow",NA,6165,3960,9439,11078,5069,4425,6731,10019,-1096,465,-2708,-1059
"2669","Hounslow 020B","E01002670","E02000545","Hounslow 020","E09000018","Hounslow","E12000007","London",1737,1737,0,39.2,708,2.5,"00AT","Hounslow",NA,17391,14641,16386,24776,18372,17547,23246,24415,981,2906,6860,-361
"2670","Hounslow 020C","E01002671","E02000545","Hounslow 020","E09000018","Hounslow","E12000007","London",1659,1659,0,69.2,636,2.6,"00AT","Hounslow",NA,14701,12715,13009,16845,15863,14458,14933,21096,1162,1743,1924,4251
"2671","Hounslow 020D","E01002672","E02000545","Hounslow 020","E09000018","Hounslow","E12000007","London",1578,1578,0,59.8,683,2.3,"00AT","Hounslow",NA,7189,4493,8647,20295,10313,8083,11891,17775,3124,3590,3244,-2520
"2672","Hounslow 020E","E01002673","E02000545","Hounslow 020","E09000018","Hounslow","E12000007","London",1634,1634,0,294.9,621,2.6,"00AT","Hounslow",NA,2377,312,3080,10359,2629,1537,3504,7091,252,1225,424,-3268
"2630","Hounslow 012D","E01002674","E02000537","Hounslow 012","E09000018","Hounslow","E12000007","London",1707,1707,0,59.9,668,2.6,"00AT","Hounslow",NA,17524,19924,23690,31915,17647,21255,28583,30517,123,1331,4893,-1398
"2613","Hounslow 009A","E01002675","E02000534","Hounslow 009","E09000018","Hounslow","E12000007","London",2456,2456,0,81.6,877,2.8,"00AT","Hounslow",NA,22514,23998,26363,30691,20569,18499,26170,28311,-1945,-5499,-193,-2380
"2631","Hounslow 012E","E01002676","E02000537","Hounslow 012","E09000018","Hounslow","E12000007","London",1715,1715,0,18,559,3.1,"00AT","Hounslow",NA,17088,26420,23951,31485,17587,22583,27732,31638,499,-3837,3781,153
"2646","Hounslow 015E","E01002677","E02000540","Hounslow 015","E09000018","Hounslow","E12000007","London",1565,1554,11,67.3,652,2.4,"00AT","Hounslow",NA,12322,11009,12276,29759,12273,15324,14828,23033,-49,4315,2552,-6726
"2614","Hounslow 009B","E01002678","E02000534","Hounslow 009","E09000018","Hounslow","E12000007","London",1855,1855,0,5,669,2.8,"00AT","Hounslow",NA,21028,23272,28726,31287,18751,22088,27221,30711,-2277,-1184,-1505,-576
"2615","Hounslow 009C","E01002679","E02000534","Hounslow 009","E09000018","Hounslow","E12000007","London",1781,1781,0,38.5,643,2.8,"00AT","Hounslow",NA,20192,21614,23830,30903,20189,22030,28443,29796,-3,416,4613,-1107
"2616","Hounslow 009D","E01002680","E02000534","Hounslow 009","E09000018","Hounslow","E12000007","London",1952,1937,15,47.7,728,2.7,"00AT","Hounslow",NA,17220,16277,20791,31870,17227,20772,23131,28956,7,4495,2340,-2914
"2639","Hounslow 014C","E01002681","E02000539","Hounslow 014","E09000018","Hounslow","E12000007","London",2063,2052,11,66.4,741,2.8,"00AT","Hounslow",NA,11045,5954,13387,17671,10557,9288,12463,18529,-488,3334,-924,858
"2640","Hounslow 014D","E01002682","E02000539","Hounslow 014","E09000018","Hounslow","E12000007","London",2325,2317,8,53.6,927,2.5,"00AT","Hounslow",NA,8327,8566,10218,17973,15384,16577,20317,21530,7057,8011,10099,3557
"2641","Hounslow 014E","E01002683","E02000539","Hounslow 014","E09000018","Hounslow","E12000007","London",2568,2568,0,102.4,1037,2.5,"00AT","Hounslow",NA,22340,15164,25960,28918,20157,19289,27198,28696,-2183,4125,1238,-222
"2600","Hounslow 006D","E01002684","E02000531","Hounslow 006","E09000018","Hounslow","E12000007","London",2368,2291,77,59.7,1096,2.1,"00AT","Hounslow",NA,8049,6329,10801,19072,11112,9676,15853,23568,3063,3347,5052,4496
"2601","Hounslow 006E","E01002686","E02000531","Hounslow 006","E09000018","Hounslow","E12000007","London",1765,1762,3,17.9,681,2.6,"00AT","Hounslow",NA,4992,4709,5359,7576,5652,5466,7002,9784,660,757,1643,2208
"2714","Hounslow 029A","E01002687","E02006792","Hounslow 029","E09000018","Hounslow","E12000007","London",1707,1707,0,96.5,832,2.1,"00AT","Hounslow",NA,19323,21675,23683,29256,21290,24006,29447,25490,1967,2331,5764,-3766
"2606","Hounslow 007E","E01002689","E02000532","Hounslow 007","E09000018","Hounslow","E12000007","London",1585,1585,0,113.7,796,2,"00AT","Hounslow",NA,13202,10642,12559,22687,13683,13108,12966,21401,481,2466,407,-1286
"2607","Hounslow 007F","E01002690","E02000532","Hounslow 007","E09000018","Hounslow","E12000007","London",1470,1459,11,81.7,612,2.4,"00AT","Hounslow",NA,12071,14147,20105,30748,23567,26016,27391,30799,11496,11869,7286,51
"2715","Hounslow 029B","E01002691","E02006792","Hounslow 029","E09000018","Hounslow","E12000007","London",1596,1596,0,31.3,591,2.7,"00AT","Hounslow",NA,23567,24675,28748,31151,21093,16778,25865,29234,-2474,-7897,-2883,-1917
"2716","Hounslow 029C","E01002692","E02006792","Hounslow 029","E09000018","Hounslow","E12000007","London",1782,1776,6,54.7,911,1.9,"00AT","Hounslow",NA,13577,10912,20104,24162,15422,14953,18662,25634,1845,4041,-1442,1472
"2717","Hounslow 029D","E01002693","E02006792","Hounslow 029","E09000018","Hounslow","E12000007","London",1694,1642,52,82.5,841,2,"00AT","Hounslow",NA,17011,17250,19157,26267,16240,17318,24157,29196,-771,68,5000,2929
"2815","Islington 019A","E01002694","E02000572","Islington 019","E09000019","Islington","E12000007","London",1532,1532,0,217.9,669,2.3,"00AU","Islington",NA,1779,923,2858,8926,1691,1023,3232,8776,-88,100,374,-150
"2825","Islington 021A","E01002695","E02000574","Islington 021","E09000019","Islington","E12000007","London",1710,1639,71,144.5,795,2.1,"00AU","Islington",NA,6724,6444,9075,16325,8778,9941,14870,19382,2054,3497,5795,3057
"2820","Islington 020A","E01002696","E02000573","Islington 020","E09000019","Islington","E12000007","London",1813,1813,0,122.5,895,2,"00AU","Islington",NA,8127,11077,15011,15583,10363,14530,19106,16448,2236,3453,4095,865
"2816","Islington 019B","E01002697","E02000572","Islington 019","E09000019","Islington","E12000007","London",2098,1635,463,188.5,709,2.3,"00AU","Islington",NA,2578,1802,3533,10456,6158,6479,10432,10840,3580,4677,6899,384
"2805","Islington 017A","E01002698","E02000570","Islington 017","E09000019","Islington","E12000007","London",2063,2063,0,187.4,1056,2,"00AU","Islington",NA,7641,7702,8232,22163,12845,12675,16387,17649,5204,4973,8155,-4514
"2806","Islington 017B","E01002699","E02000570","Islington 017","E09000019","Islington","E12000007","London",1507,1507,0,164.7,775,1.9,"00AU","Islington",NA,9235,11506,9621,22184,11521,10769,12405,20900,2286,-737,2784,-1284
"2807","Islington 017C","E01002700","E02000570","Islington 017","E09000019","Islington","E12000007","London",1478,1459,19,82.2,640,2.3,"00AU","Islington",NA,10992,19349,19242,20068,16244,21478,23369,28214,5252,2129,4127,8146
"2837","Islington 023A","E01002701","E02000576","Islington 023","E09000019","Islington","E12000007","London",1582,1471,111,190.8,718,2,"00AU","Islington",NA,5981,3855,8161,11604,6753,6168,11070,14374,772,2313,2909,2770
"2838","Islington 023B","E01002702","E02000576","Islington 023","E09000019","Islington","E12000007","London",1957,1822,135,169.1,870,2.1,"00AU","Islington",NA,3098,1429,4216,12401,5124,4708,8341,12550,2026,3279,4125,149
"2839","Islington 023C","E01002703","E02000576","Islington 023","E09000019","Islington","E12000007","London",1635,1635,0,189.9,774,2.1,"00AU","Islington",NA,3974,3490,7148,11009,3857,2633,6760,11941,-117,-857,-388,932
"2840","Islington 023D","E01002704","E02000576","Islington 023","E09000019","Islington","E12000007","London",2198,1898,300,65.6,1035,1.8,"00AU","Islington",NA,7209,5815,6836,14153,9908,7056,9552,19836,2699,1241,2716,5683
"2841","Islington 023E","E01002706","E02000576","Islington 023","E09000019","Islington","E12000007","London",2016,1961,55,148,925,2.1,"00AU","Islington",NA,5077,4198,8134,11822,7963,7453,12676,17435,2886,3255,4542,5613
"2830","Islington 022B","E01002707","E02000575","Islington 022","E09000019","Islington","E12000007","London",1726,1717,9,145.2,901,1.9,"00AU","Islington",NA,6478,6866,10660,17937,9172,8532,13292,15305,2694,1666,2632,-2632
"2794","Islington 015A","E01002708","E02000568","Islington 015","E09000019","Islington","E12000007","London",1979,1859,120,58.7,917,2,"00AU","Islington",NA,6243,3840,7459,13940,6142,6205,11774,15567,-101,2365,4315,1627
"2817","Islington 019C","E01002709","E02000572","Islington 019","E09000019","Islington","E12000007","London",1754,1754,0,219,751,2.3,"00AU","Islington",NA,5480,3300,7437,9418,4859,3820,7156,11079,-621,520,-281,1661
"2818","Islington 019D","E01002710","E02000572","Islington 019","E09000019","Islington","E12000007","London",1676,1676,0,120.5,679,2.5,"00AU","Islington",NA,5389,2849,6809,12062,5577,4518,6096,15496,188,1669,-713,3434
"2826","Islington 021B","E01002711","E02000574","Islington 021","E09000019","Islington","E12000007","London",1939,1934,5,128.1,963,2,"00AU","Islington",NA,7472,7289,10066,12573,9226,10353,13172,22994,1754,3064,3106,10421
"2795","Islington 015B","E01002712","E02000568","Islington 015","E09000019","Islington","E12000007","London",1780,1192,588,155.1,535,2.2,"00AU","Islington",NA,6078,6266,9119,11644,4682,9399,8080,8789,-1396,3133,-1039,-2855
"2796","Islington 015C","E01002713","E02000568","Islington 015","E09000019","Islington","E12000007","London",1559,1559,0,108.8,820,1.9,"00AU","Islington",NA,3304,2537,3579,8542,2535,2387,3486,9694,-769,-150,-93,1152
"2808","Islington 017D","E01002714","E02000570","Islington 017","E09000019","Islington","E12000007","London",1698,1698,0,148.3,771,2.2,"00AU","Islington",NA,12345,15495,18323,20674,17068,21533,22928,27736,4723,6038,4605,7062
"2819","Islington 019E","E01002715","E02000572","Islington 019","E09000019","Islington","E12000007","London",1511,1511,0,261.4,682,2.2,"00AU","Islington",NA,1403,893,1661,8209,3136,2293,5417,8972,1733,1400,3756,763
"2788","Islington 014A","E01002716","E02000567","Islington 014","E09000019","Islington","E12000007","London",2300,2300,0,176.1,1079,2.1,"00AU","Islington",NA,2142,970,3460,9051,5762,4179,7361,16249,3620,3209,3901,7198
"2799","Islington 016A","E01002717","E02000569","Islington 016","E09000019","Islington","E12000007","London",1315,1315,0,105.7,590,2.2,"00AU","Islington",NA,6563,7642,10513,15288,10919,10602,13888,17592,4356,2960,3375,2304
"2789","Islington 014B","E01002718","E02000567","Islington 014","E09000019","Islington","E12000007","London",1661,1661,0,167.4,799,2.1,"00AU","Islington",NA,8305,10783,10631,22928,11182,16272,16331,20468,2877,5489,5700,-2460
"2800","Islington 016B","E01002719","E02000569","Islington 016","E09000019","Islington","E12000007","London",1490,1490,0,102.1,737,2,"00AU","Islington",NA,8767,10404,10767,25459,12318,15095,19217,16594,3551,4691,8450,-8865
"2801","Islington 016C","E01002720","E02000569","Islington 016","E09000019","Islington","E12000007","London",2334,2334,0,230.6,993,2.4,"00AU","Islington",NA,545,104,727,9690,3127,1691,4054,11272,2582,1587,3327,1582
"2790","Islington 014C","E01002721","E02000567","Islington 014","E09000019","Islington","E12000007","London",1667,1667,0,137.5,839,2,"00AU","Islington",NA,5502,5267,5330,19675,7211,7548,9529,12336,1709,2281,4199,-7339
"2810","Islington 018A","E01002722","E02000571","Islington 018","E09000019","Islington","E12000007","London",1305,1305,0,153.9,668,2,"00AU","Islington",NA,2624,2467,2880,9942,4261,4135,5447,12924,1637,1668,2567,2982
"2831","Islington 022C","E01002723","E02000575","Islington 022","E09000019","Islington","E12000007","London",1529,1529,0,149.2,781,2,"00AU","Islington",NA,6097,4553,6279,14873,6438,5295,9436,14208,341,742,3157,-665
"2832","Islington 022D","E01002724","E02000575","Islington 022","E09000019","Islington","E12000007","London",1973,1748,225,74.7,1025,1.7,"00AU","Islington",NA,15705,19589,24630,23275,17721,24160,29768,19365,2016,4571,5138,-3910
"2833","Islington 022E","E01002725","E02000575","Islington 022","E09000019","Islington","E12000007","London",1444,1235,209,236.7,572,2.2,"00AU","Islington",NA,6572,5788,9921,16891,6778,6557,9251,16359,206,769,-670,-532
"2834","Islington 022F","E01002726","E02000575","Islington 022","E09000019","Islington","E12000007","London",1692,1669,23,100.4,825,2,"00AU","Islington",NA,6398,5035,6228,18593,8742,7648,8370,18514,2344,2613,2142,-79
"2827","Islington 021C","E01002727","E02000574","Islington 021","E09000019","Islington","E12000007","London",1624,1624,0,140.2,871,1.9,"00AU","Islington",NA,5558,7615,7054,18431,9509,9624,10523,21184,3951,2009,3469,2753
"2828","Islington 021D","E01002728","E02000574","Islington 021","E09000019","Islington","E12000007","London",1635,1015,620,179.7,509,2,"00AU","Islington",NA,7640,9326,11420,20575,9208,13076,16413,23423,1568,3750,4993,2848
"2829","Islington 021E","E01002729","E02000574","Islington 021","E09000019","Islington","E12000007","London",1593,1496,97,121,702,2.1,"00AU","Islington",NA,4582,7032,2828,19618,5994,5882,5309,20314,1412,-1150,2481,696
"2753","Islington 007A","E01002730","E02000560","Islington 007","E09000019","Islington","E12000007","London",1781,1781,0,126.2,812,2.2,"00AU","Islington",NA,4876,6868,8101,21982,5704,7726,9909,25210,828,858,1808,3228
"2754","Islington 007B","E01002731","E02000560","Islington 007","E09000019","Islington","E12000007","London",2466,2466,0,141.3,1164,2.1,"00AU","Islington",NA,4433,6204,10157,12482,7170,10939,15845,18797,2737,4735,5688,6315
"2742","Islington 005A","E01002732","E02000558","Islington 005","E09000019","Islington","E12000007","London",1845,1813,32,136.2,821,2.2,"00AU","Islington",NA,755,731,734,11143,1242,1006,1799,14779,487,275,1065,3636
"2755","Islington 007C","E01002733","E02000560","Islington 007","E09000019","Islington","E12000007","London",1392,1392,0,156.6,598,2.3,"00AU","Islington",NA,10225,17415,23881,21675,13219,13683,17907,26853,2994,-3732,-5974,5178
"2743","Islington 005B","E01002734","E02000558","Islington 005","E09000019","Islington","E12000007","London",1692,1692,0,143.6,696,2.4,"00AU","Islington",NA,808,401,1711,8355,614,442,1967,9623,-194,41,256,1268
"2731","Islington 003A","E01002735","E02000556","Islington 003","E09000019","Islington","E12000007","London",1645,1645,0,151.8,777,2.1,"00AU","Islington",NA,4194,4960,4783,14548,5203,5249,6395,20940,1009,289,1612,6392
"2744","Islington 005C","E01002736","E02000558","Islington 005","E09000019","Islington","E12000007","London",1580,1435,145,215.8,595,2.4,"00AU","Islington",NA,1738,616,1641,8181,2291,1631,2300,8596,553,1015,659,415
"2745","Islington 005D","E01002737","E02000558","Islington 005","E09000019","Islington","E12000007","London",1957,1957,0,254.5,788,2.5,"00AU","Islington",NA,1105,1073,1382,11085,4438,2620,5313,10025,3333,1547,3931,-1060
"2761","Islington 009A","E01002738","E02000562","Islington 009","E09000019","Islington","E12000007","London",1785,1733,52,69.9,839,2.1,"00AU","Islington",NA,4634,7395,6159,23041,8554,9554,11901,21540,3920,2159,5742,-1501
"2783","Islington 013A","E01002739","E02000566","Islington 013","E09000019","Islington","E12000007","London",1835,1835,0,156.3,816,2.2,"00AU","Islington",NA,11401,12689,14421,25663,14602,15444,18437,31919,3201,2755,4016,6256
"2784","Islington 013B","E01002740","E02000566","Islington 013","E09000019","Islington","E12000007","London",1826,1826,0,82.3,806,2.3,"00AU","Islington",NA,8658,17169,16353,28186,14033,18773,22691,31593,5375,1604,6338,3407
"2762","Islington 009B","E01002741","E02000562","Islington 009","E09000019","Islington","E12000007","London",1513,1513,0,142.2,656,2.3,"00AU","Islington",NA,2367,1121,2619,16151,4048,2577,4837,16458,1681,1456,2218,307
"2747","Islington 006A","E01002742","E02000559","Islington 006","E09000019","Islington","E12000007","London",1561,1561,0,146.2,675,2.3,"00AU","Islington",NA,13752,17146,20864,25373,17348,16873,23460,32050,3596,-273,2596,6677
"2763","Islington 009C","E01002743","E02000562","Islington 009","E09000019","Islington","E12000007","London",1672,1604,68,171.8,726,2.2,"00AU","Islington",NA,6615,6545,6865,25224,11010,10199,14893,28774,4395,3654,8028,3550
"2764","Islington 009D","E01002744","E02000562","Islington 009","E09000019","Islington","E12000007","London",1442,1442,0,145.7,722,2,"00AU","Islington",NA,6504,10664,8875,21969,12049,12972,13583,28020,5545,2308,4708,6051
"2785","Islington 013C","E01002745","E02000566","Islington 013","E09000019","Islington","E12000007","London",1467,1467,0,137.5,681,2.2,"00AU","Islington",NA,12259,11057,13127,25346,14844,13788,15638,29876,2585,2731,2511,4530
"2748","Islington 006B","E01002747","E02000559","Islington 006","E09000019","Islington","E12000007","London",1635,1635,0,159.2,675,2.4,"00AU","Islington",NA,8577,10321,10891,21789,18800,15959,18112,30128,10223,5638,7221,8339
"2749","Islington 006C","E01002748","E02000559","Islington 006","E09000019","Islington","E12000007","London",1467,1467,0,103.8,667,2.2,"00AU","Islington",NA,3858,3250,3635,10032,2793,2763,4108,22107,-1065,-487,473,12075
"2750","Islington 006D","E01002749","E02000559","Islington 006","E09000019","Islington","E12000007","London",1316,1316,0,158.2,534,2.5,"00AU","Islington",NA,6935,4856,8578,20836,8663,7730,10414,22796,1728,2874,1836,1960
"2746","Islington 005E","E01002751","E02000558","Islington 005","E09000019","Islington","E12000007","London",1796,1796,0,230.8,880,2,"00AU","Islington",NA,2811,2591,3643,12061,2640,1480,3199,15718,-171,-1111,-444,3657
"2765","Islington 009E","E01002752","E02000562","Islington 009","E09000019","Islington","E12000007","London",1522,1522,0,168.7,651,2.3,"00AU","Islington",NA,7184,5156,6420,21342,9540,6955,9846,23403,2356,1799,3426,2061
"2725","Islington 002A","E01002753","E02000555","Islington 002","E09000019","Islington","E12000007","London",1429,1429,0,175.6,626,2.3,"00AU","Islington",NA,5595,4448,6465,16805,7202,6494,8852,10122,1607,2046,2387,-6683
"2726","Islington 002B","E01002754","E02000555","Islington 002","E09000019","Islington","E12000007","London",1508,1508,0,122.5,614,2.5,"00AU","Islington",NA,7565,9190,11882,17864,12303,12759,15262,28344,4738,3569,3380,10480
"2719","Islington 001A","E01002755","E02000554","Islington 001","E09000019","Islington","E12000007","London",1326,1326,0,135.2,635,2.1,"00AU","Islington",NA,2711,2081,1909,13750,3196,2039,1683,19716,485,-42,-226,5966
"2720","Islington 001B","E01002756","E02000554","Islington 001","E09000019","Islington","E12000007","London",1332,1326,6,115.6,610,2.2,"00AU","Islington",NA,6716,8376,6988,23412,8270,8191,8222,26074,1554,-185,1234,2662
"2727","Islington 002C","E01002757","E02000555","Islington 002","E09000019","Islington","E12000007","London",1433,1427,6,157.5,590,2.4,"00AU","Islington",NA,5485,4517,7541,15180,8839,6507,9735,16447,3354,1990,2194,1267
"2721","Islington 001C","E01002758","E02000554","Islington 001","E09000019","Islington","E12000007","London",1576,1561,15,132,709,2.2,"00AU","Islington",NA,1185,847,1162,6731,2321,1689,3860,10634,1136,842,2698,3903
"2728","Islington 002D","E01002759","E02000555","Islington 002","E09000019","Islington","E12000007","London",1647,1600,47,154.9,659,2.4,"00AU","Islington",NA,9171,8785,11567,22572,12447,11616,14999,22170,3276,2831,3432,-402
"2729","Islington 002E","E01002760","E02000555","Islington 002","E09000019","Islington","E12000007","London",1543,1543,0,170.7,626,2.5,"00AU","Islington",NA,2387,1436,2118,11856,2645,2040,2979,7272,258,604,861,-4584
"2771","Islington 011C","E01002762","E02000564","Islington 011","E09000019","Islington","E12000007","London",1949,1940,9,121.7,889,2.2,"00AU","Islington",NA,4544,6838,7085,20877,10803,13539,15610,26576,6259,6701,8525,5699
"2756","Islington 007D","E01002763","E02000560","Islington 007","E09000019","Islington","E12000007","London",1437,1249,188,145.6,603,2.1,"00AU","Islington",NA,5747,11143,11697,19760,4760,7040,9136,17720,-987,-4103,-2561,-2040
"2766","Islington 010A","E01002764","E02000563","Islington 010","E09000019","Islington","E12000007","London",1779,1779,0,134.2,796,2.2,"00AU","Islington",NA,3790,4494,6066,17086,5293,5542,8759,12316,1503,1048,2693,-4770
"2797","Islington 015D","E01002765","E02000568","Islington 015","E09000019","Islington","E12000007","London",2513,2257,256,147.1,980,2.3,"00AU","Islington",NA,3697,3014,4654,9516,4838,5023,7325,12563,1141,2009,2671,3047
"2798","Islington 015E","E01002766","E02000568","Islington 015","E09000019","Islington","E12000007","London",1794,1794,0,131.2,811,2.2,"00AU","Islington",NA,1531,2022,2687,7865,3920,4936,5849,10759,2389,2914,3162,2894
"2772","Islington 011D","E01002767","E02000564","Islington 011","E09000019","Islington","E12000007","London",2044,2044,0,171.9,982,2.1,"00AU","Islington",NA,4035,3579,3535,13690,4229,4617,6313,15349,194,1038,2778,1659
"2737","Islington 004A","E01002768","E02000557","Islington 004","E09000019","Islington","E12000007","London",1604,1604,0,154.7,851,1.9,"00AU","Islington",NA,7062,6529,7313,21683,7263,6682,7610,21389,201,153,297,-294
"2757","Islington 008A","E01002769","E02000561","Islington 008","E09000019","Islington","E12000007","London",2053,1955,98,95.5,847,2.3,"00AU","Islington",NA,9125,11563,8940,28584,14051,17370,21683,29949,4926,5807,12743,1365
"2738","Islington 004B","E01002770","E02000557","Islington 004","E09000019","Islington","E12000007","London",1541,1483,58,73.5,718,2.1,"00AU","Islington",NA,5041,8091,7154,17205,7294,10076,10877,23053,2253,1985,3723,5848
"2739","Islington 004C","E01002771","E02000557","Islington 004","E09000019","Islington","E12000007","London",1483,1483,0,123.8,659,2.3,"00AU","Islington",NA,5657,5515,7253,18196,9109,7276,10602,18599,3452,1761,3349,403
"2730","Islington 002F","E01002772","E02000555","Islington 002","E09000019","Islington","E12000007","London",1848,1848,0,177.7,871,2.1,"00AU","Islington",NA,4068,5897,6185,9849,7167,7999,11268,14186,3099,2102,5083,4337
"2740","Islington 004D","E01002773","E02000557","Islington 004","E09000019","Islington","E12000007","London",1386,1386,0,143.5,696,2,"00AU","Islington",NA,1981,2666,1869,9829,965,1328,1379,8272,-1016,-1338,-490,-1557
"2741","Islington 004E","E01002774","E02000557","Islington 004","E09000019","Islington","E12000007","London",2110,2110,0,118.1,1005,2.1,"00AU","Islington",NA,3318,4537,3414,20383,6024,7917,8202,23690,2706,3380,4788,3307
"2791","Islington 014D","E01002775","E02000567","Islington 014","E09000019","Islington","E12000007","London",1429,1429,0,120.8,683,2.1,"00AU","Islington",NA,5461,8604,9132,11635,11347,12309,14974,23928,5886,3705,5842,12293
"2792","Islington 014E","E01002776","E02000567","Islington 014","E09000019","Islington","E12000007","London",1661,1661,0,143.3,774,2.1,"00AU","Islington",NA,5559,4413,8255,16032,6381,6585,9549,20714,822,2172,1294,4682
"2778","Islington 012A","E01002777","E02000565","Islington 012","E09000019","Islington","E12000007","London",1626,1626,0,138,833,2,"00AU","Islington",NA,5258,6020,9056,19866,7518,8176,12451,25301,2260,2156,3395,5435
"2779","Islington 012B","E01002778","E02000565","Islington 012","E09000019","Islington","E12000007","London",1787,1787,0,170.2,743,2.4,"00AU","Islington",NA,1330,693,2193,9242,2015,2187,4139,10183,685,1494,1946,941
"2780","Islington 012C","E01002779","E02000565","Islington 012","E09000019","Islington","E12000007","London",1891,1687,204,171.1,820,2.1,"00AU","Islington",NA,5131,6366,7152,20899,12443,13344,18228,23730,7312,6978,11076,2831
"2793","Islington 014F","E01002780","E02000567","Islington 014","E09000019","Islington","E12000007","London",1640,1640,0,207.6,763,2.1,"00AU","Islington",NA,5349,4945,6237,20804,7624,7275,8717,20231,2275,2330,2480,-573
"2781","Islington 012D","E01002781","E02000565","Islington 012","E09000019","Islington","E12000007","London",1350,1341,9,148,598,2.2,"00AU","Islington",NA,3077,1936,3652,9877,8195,5047,6447,17608,5118,3111,2795,7731
"2782","Islington 012E","E01002782","E02000565","Islington 012","E09000019","Islington","E12000007","London",1533,1533,0,174,616,2.5,"00AU","Islington",NA,1708,623,3793,5882,2764,1928,3414,10539,1056,1305,-379,4657
"2767","Islington 010B","E01002783","E02000563","Islington 010","E09000019","Islington","E12000007","London",1487,1413,74,151.4,718,2,"00AU","Islington",NA,2007,2051,1635,12802,1897,2968,3044,9727,-110,917,1409,-3075
"2768","Islington 010C","E01002784","E02000563","Islington 010","E09000019","Islington","E12000007","London",1795,1735,60,138.8,732,2.4,"00AU","Islington",NA,4481,3038,6615,10234,4462,3155,5290,13646,-19,117,-1325,3412
"2758","Islington 008B","E01002785","E02000561","Islington 008","E09000019","Islington","E12000007","London",1968,1968,0,138.4,840,2.3,"00AU","Islington",NA,6987,6905,7295,29849,11640,14897,13273,30654,4653,7992,5978,805
"2769","Islington 010D","E01002786","E02000563","Islington 010","E09000019","Islington","E12000007","London",1805,1805,0,165.9,828,2.2,"00AU","Islington",NA,2227,2095,3443,17188,4075,3031,7060,20887,1848,936,3617,3699
"2770","Islington 010E","E01002787","E02000563","Islington 010","E09000019","Islington","E12000007","London",1620,1296,324,146.1,578,2.2,"00AU","Islington",NA,6764,8528,7604,12610,4992,6103,6730,16661,-1772,-2425,-874,4051
"2759","Islington 008C","E01002788","E02000561","Islington 008","E09000019","Islington","E12000007","London",1851,1836,15,151,916,2,"00AU","Islington",NA,7958,10736,7897,29455,12442,14273,13528,30374,4484,3537,5631,919
"2760","Islington 008D","E01002789","E02000561","Islington 008","E09000019","Islington","E12000007","London",1874,1873,1,140.2,810,2.3,"00AU","Islington",NA,11126,14161,15315,26586,17773,19371,21212,31792,6647,5210,5897,5206
"2802","Islington 016D","E01002790","E02000569","Islington 016","E09000019","Islington","E12000007","London",1435,1435,0,181.9,706,2,"00AU","Islington",NA,2396,3279,2046,12038,2728,2728,3540,10313,332,-551,1494,-1725
"2803","Islington 016E","E01002791","E02000569","Islington 016","E09000019","Islington","E12000007","London",1543,1543,0,107.6,762,2,"00AU","Islington",NA,8512,8424,15545,21226,13916,17529,23182,14922,5404,9105,7637,-6304
"2809","Islington 017E","E01002792","E02000570","Islington 017","E09000019","Islington","E12000007","London",1869,1868,1,177.5,877,2.1,"00AU","Islington",NA,9946,9719,15140,19757,12528,16327,22123,18683,2582,6608,6983,-1074
"2804","Islington 016F","E01002793","E02000569","Islington 016","E09000019","Islington","E12000007","London",1905,1898,7,178.7,957,2,"00AU","Islington",NA,4524,4159,4751,14382,4013,3748,6001,17687,-511,-411,1250,3305
"2821","Islington 020B","E01002794","E02000573","Islington 020","E09000019","Islington","E12000007","London",1765,1765,0,97.7,862,2,"00AU","Islington",NA,7471,7750,8562,24701,11983,13544,17420,24454,4512,5794,8858,-247
"2786","Islington 013D","E01002795","E02000566","Islington 013","E09000019","Islington","E12000007","London",1997,1997,0,113.4,863,2.3,"00AU","Islington",NA,5844,3787,7424,16243,7574,7934,9945,15154,1730,4147,2521,-1089
"2787","Islington 013E","E01002796","E02000566","Islington 013","E09000019","Islington","E12000007","London",1039,1039,0,133.4,496,2.1,"00AU","Islington",NA,5834,6596,5958,23567,9775,9556,11568,30537,3941,2960,5610,6970
"2811","Islington 018B","E01002797","E02000571","Islington 018","E09000019","Islington","E12000007","London",1873,1873,0,171.7,872,2.1,"00AU","Islington",NA,2788,3660,3712,12598,4911,5449,7958,12454,2123,1789,4246,-144
"2812","Islington 018C","E01002798","E02000571","Islington 018","E09000019","Islington","E12000007","London",1965,1932,33,142.4,922,2.1,"00AU","Islington",NA,11104,13618,14947,18551,13009,10144,12613,26738,1905,-3474,-2334,8187
"2813","Islington 018D","E01002799","E02000571","Islington 018","E09000019","Islington","E12000007","London",1839,1839,0,217.4,880,2.1,"00AU","Islington",NA,2994,2218,7050,12678,5814,4334,7364,11680,2820,2116,314,-998
"2814","Islington 018E","E01002800","E02000571","Islington 018","E09000019","Islington","E12000007","London",1049,1049,0,128.9,435,2.4,"00AU","Islington",NA,1150,1374,1990,7046,1783,1967,2240,5361,633,593,250,-1685
"2822","Islington 020C","E01002801","E02000573","Islington 020","E09000019","Islington","E12000007","London",1553,1553,0,145.1,806,1.9,"00AU","Islington",NA,9468,12335,14662,27155,13335,18652,22155,22560,3867,6317,7493,-4595
"2823","Islington 020D","E01002802","E02000573","Islington 020","E09000019","Islington","E12000007","London",1480,1480,0,134.7,706,2.1,"00AU","Islington",NA,9492,10666,15208,14152,10403,14092,17597,15309,911,3426,2389,1157
"2824","Islington 020E","E01002803","E02000573","Islington 020","E09000019","Islington","E12000007","London",2063,1896,167,114.9,935,2,"00AU","Islington",NA,6106,6331,9758,13838,9646,8842,14850,15910,3540,2511,5092,2072
"2722","Islington 001D","E01002804","E02000554","Islington 001","E09000019","Islington","E12000007","London",1669,1642,27,151.6,754,2.2,"00AU","Islington",NA,1527,1119,1924,13992,4494,2771,3914,14788,2967,1652,1990,796
"2732","Islington 003B","E01002805","E02000556","Islington 003","E09000019","Islington","E12000007","London",1569,1569,0,122.5,758,2.1,"00AU","Islington",NA,5677,8720,10459,14189,8944,9307,11913,17252,3267,587,1454,3063
"2733","Islington 003C","E01002806","E02000556","Islington 003","E09000019","Islington","E12000007","London",1595,1595,0,142.5,721,2.2,"00AU","Islington",NA,4949,7228,5507,21719,8670,7264,9309,28856,3721,36,3802,7137
"2723","Islington 001E","E01002807","E02000554","Islington 001","E09000019","Islington","E12000007","London",1734,1732,2,188.3,824,2.1,"00AU","Islington",NA,2905,2618,3760,13850,4028,3174,4971,16338,1123,556,1211,2488
"2734","Islington 003D","E01002808","E02000556","Islington 003","E09000019","Islington","E12000007","London",1907,1891,16,145.4,857,2.2,"00AU","Islington",NA,4178,4372,5845,12607,8165,6967,8798,21739,3987,2595,2953,9132
"2735","Islington 003E","E01002809","E02000556","Islington 003","E09000019","Islington","E12000007","London",1640,1640,0,184.5,700,2.3,"00AU","Islington",NA,4015,4985,6199,13336,5799,5903,6310,19112,1784,918,111,5776
"2736","Islington 003F","E01002810","E02000556","Islington 003","E09000019","Islington","E12000007","London",1652,1650,2,200,748,2.2,"00AU","Islington",NA,3845,3778,4005,15869,4923,4177,5101,20788,1078,399,1096,4919
"2724","Islington 001F","E01002811","E02000554","Islington 001","E09000019","Islington","E12000007","London",1545,1545,0,151.3,694,2.2,"00AU","Islington",NA,2963,2850,2210,17493,4854,3470,4918,20524,1891,620,2708,3031
"2901","Kensington and Chelsea 013A","E01002812","E02000589","Kensington and Chelsea 013","E09000020","Kensington and Chelsea","E12000007","London",1917,1763,154,210,895,2,"00AW","Kensington and Chelsea",NA,18614,25095,29111,22795,21054,26206,31322,30695,2440,1111,2211,7900
"2891","Kensington and Chelsea 011A","E01002813","E02000587","Kensington and Chelsea 011","E09000020","Kensington and Chelsea","E12000007","London",1767,1767,0,159.6,835,2.1,"00AW","Kensington and Chelsea",NA,20314,27777,30554,25924,23634,27884,31629,31196,3320,107,1075,5272
"2911","Kensington and Chelsea 015A","E01002814","E02000591","Kensington and Chelsea 015","E09000020","Kensington and Chelsea","E12000007","London",1956,1953,3,133.7,905,2.2,"00AW","Kensington and Chelsea",NA,8565,9807,10988,26240,9660,7536,10938,28276,1095,-2271,-50,2036
"2892","Kensington and Chelsea 011B","E01002815","E02000587","Kensington and Chelsea 011","E09000020","Kensington and Chelsea","E12000007","London",1424,1423,1,222.5,755,1.9,"00AW","Kensington and Chelsea",NA,16098,19823,23900,23420,14069,15494,21672,30902,-2029,-4329,-2228,7482
"2893","Kensington and Chelsea 011C","E01002816","E02000587","Kensington and Chelsea 011","E09000020","Kensington and Chelsea","E12000007","London",1355,1322,33,228.1,693,1.9,"00AW","Kensington and Chelsea",NA,19559,28936,29878,26796,19810,31555,31016,32430,251,2619,1138,5634
"2894","Kensington and Chelsea 011D","E01002817","E02000587","Kensington and Chelsea 011","E09000020","Kensington and Chelsea","E12000007","London",1594,1593,1,101.3,709,2.2,"00AW","Kensington and Chelsea",NA,21687,30732,31618,27149,21071,25028,31327,31806,-616,-5704,-291,4657
"2896","Kensington and Chelsea 012A","E01002818","E02000588","Kensington and Chelsea 012","E09000020","Kensington and Chelsea","E12000007","London",2002,2002,0,105.9,1170,1.7,"00AW","Kensington and Chelsea",NA,20256,30865,32430,23296,18433,32380,32792,27176,-1823,1515,362,3880
"2897","Kensington and Chelsea 012B","E01002819","E02000588","Kensington and Chelsea 012","E09000020","Kensington and Chelsea","E12000007","London",1586,1585,1,74,853,1.9,"00AW","Kensington and Chelsea",NA,20347,32176,32351,27570,21458,32484,32784,22414,1111,308,433,-5156
"2915","Kensington and Chelsea 016A","E01002820","E02000592","Kensington and Chelsea 016","E09000020","Kensington and Chelsea","E12000007","London",1251,1250,1,74.1,666,1.9,"00AW","Kensington and Chelsea",NA,18243,31186,31867,31464,24031,30799,32557,31625,5788,-387,690,161
"2906","Kensington and Chelsea 014A","E01002821","E02000590","Kensington and Chelsea 014","E09000020","Kensington and Chelsea","E12000007","London",1425,1420,5,74.6,692,2.1,"00AW","Kensington and Chelsea",NA,18779,29197,31887,28259,20470,30672,32693,24406,1691,1475,806,-3853
"2916","Kensington and Chelsea 016B","E01002822","E02000592","Kensington and Chelsea 016","E09000020","Kensington and Chelsea","E12000007","London",1206,1205,1,108.6,621,1.9,"00AW","Kensington and Chelsea",NA,19498,32295,32445,29120,19038,32735,32780,29126,-460,440,335,6
"2907","Kensington and Chelsea 014B","E01002823","E02000590","Kensington and Chelsea 014","E09000020","Kensington and Chelsea","E12000007","London",1369,1369,0,170.3,701,2,"00AW","Kensington and Chelsea",NA,11555,10905,13017,20942,8590,7802,8669,21321,-2965,-3103,-4348,379
"2876","Kensington and Chelsea 008A","E01002824","E02000584","Kensington and Chelsea 008","E09000020","Kensington and Chelsea","E12000007","London",1519,1515,4,100.5,684,2.2,"00AW","Kensington and Chelsea",NA,20208,31046,31499,29130,22763,31766,32435,31644,2555,720,936,2514
"2877","Kensington and Chelsea 008B","E01002825","E02000584","Kensington and Chelsea 008","E09000020","Kensington and Chelsea","E12000007","London",1941,1817,124,101.3,827,2.2,"00AW","Kensington and Chelsea",NA,20483,31156,32095,19571,22636,29434,31210,32464,2153,-1722,-885,12893
"2878","Kensington and Chelsea 008C","E01002826","E02000584","Kensington and Chelsea 008","E09000020","Kensington and Chelsea","E12000007","London",1551,1474,77,70.5,798,1.8,"00AW","Kensington and Chelsea",NA,19522,29053,32056,29024,19093,26222,31633,31333,-429,-2831,-423,2309
"2879","Kensington and Chelsea 008D","E01002827","E02000584","Kensington and Chelsea 008","E09000020","Kensington and Chelsea","E12000007","London",1835,1814,21,72.6,903,2,"00AW","Kensington and Chelsea",NA,21517,31555,31321,32478,19919,30813,31943,32842,-1598,-742,622,364
"2880","Kensington and Chelsea 008E","E01002828","E02000584","Kensington and Chelsea 008","E09000020","Kensington and Chelsea","E12000007","London",1332,1332,0,138.6,710,1.9,"00AW","Kensington and Chelsea",NA,17030,23179,21905,25499,18529,21373,21295,30479,1499,-1806,-610,4980
"2856","Kensington and Chelsea 004A","E01002829","E02000580","Kensington and Chelsea 004","E09000020","Kensington and Chelsea","E12000007","London",1466,1455,11,252.8,788,1.8,"00AW","Kensington and Chelsea",NA,6561,7562,8244,23083,6418,6011,7031,26358,-143,-1551,-1213,3275
"2857","Kensington and Chelsea 004B","E01002830","E02000580","Kensington and Chelsea 004","E09000020","Kensington and Chelsea","E12000007","London",1773,1773,0,238.3,917,1.9,"00AW","Kensington and Chelsea",NA,5019,7196,6772,22863,5348,5664,5729,23613,329,-1532,-1043,750
"2858","Kensington and Chelsea 004C","E01002831","E02000580","Kensington and Chelsea 004","E09000020","Kensington and Chelsea","E12000007","London",1977,1958,19,179.2,961,2,"00AW","Kensington and Chelsea",NA,4002,4576,5110,23303,5099,6013,5785,22513,1097,1437,675,-790
"2859","Kensington and Chelsea 004D","E01002832","E02000580","Kensington and Chelsea 004","E09000020","Kensington and Chelsea","E12000007","London",1701,1701,0,225,910,1.9,"00AW","Kensington and Chelsea",NA,5554,7054,8711,18728,6323,6211,9880,26916,769,-843,1169,8188
"2871","Kensington and Chelsea 007A","E01002833","E02000583","Kensington and Chelsea 007","E09000020","Kensington and Chelsea","E12000007","London",1460,1460,0,201.7,793,1.8,"00AW","Kensington and Chelsea",NA,12903,18416,19619,21891,12321,20269,23378,29059,-582,1853,3759,7168
"2902","Kensington and Chelsea 013B","E01002834","E02000589","Kensington and Chelsea 013","E09000020","Kensington and Chelsea","E12000007","London",1430,1410,20,229.9,718,2,"00AW","Kensington and Chelsea",NA,17422,29224,31647,16285,16900,23464,29923,32465,-522,-5760,-1724,16180
"2917","Kensington and Chelsea 016C","E01002835","E02000592","Kensington and Chelsea 016","E09000020","Kensington and Chelsea","E12000007","London",1555,1550,5,103.2,784,2,"00AW","Kensington and Chelsea",NA,21738,28688,32158,24692,22658,30305,31538,32822,920,1617,-620,8130
"2918","Kensington and Chelsea 016D","E01002836","E02000592","Kensington and Chelsea 016","E09000020","Kensington and Chelsea","E12000007","London",1390,1390,0,192.5,795,1.7,"00AW","Kensington and Chelsea",NA,16440,25750,26718,30034,20853,30655,31851,29726,4413,4905,5133,-308
"2919","Kensington and Chelsea 016E","E01002837","E02000592","Kensington and Chelsea 016","E09000020","Kensington and Chelsea","E12000007","London",1359,1329,30,211.4,717,1.9,"00AW","Kensington and Chelsea",NA,20778,30648,32362,25960,24635,32361,32729,31613,3857,1713,367,5653
"2935","Kensington and Chelsea 020A","E01002838","E02000596","Kensington and Chelsea 020","E09000020","Kensington and Chelsea","E12000007","London",1631,1057,574,234.7,579,1.8,"00AW","Kensington and Chelsea",NA,21540,32323,32449,29071,21169,32580,32781,25177,-371,257,332,-3894
"2903","Kensington and Chelsea 013C","E01002839","E02000589","Kensington and Chelsea 013","E09000020","Kensington and Chelsea","E12000007","London",1568,1566,2,248.5,978,1.6,"00AW","Kensington and Chelsea",NA,12110,21200,16870,26724,8117,14380,9738,26098,-3993,-6820,-7132,-626
"2940","Kensington and Chelsea 021A","E01002840","E02000597","Kensington and Chelsea 021","E09000020","Kensington and Chelsea","E12000007","London",1383,1383,0,155.4,691,2,"00AW","Kensington and Chelsea",NA,7944,6454,9257,23467,5121,4492,6246,21639,-2823,-1962,-3011,-1828
"2941","Kensington and Chelsea 021B","E01002841","E02000597","Kensington and Chelsea 021","E09000020","Kensington and Chelsea","E12000007","London",1368,1363,5,122.8,712,1.9,"00AW","Kensington and Chelsea",NA,10622,14868,14202,14112,9833,10492,10384,28059,-789,-4376,-3818,13947
"2942","Kensington and Chelsea 021C","E01002842","E02000597","Kensington and Chelsea 021","E09000020","Kensington and Chelsea","E12000007","London",1253,1248,5,684.7,514,2.4,"00AW","Kensington and Chelsea",NA,4218,2561,6010,11337,1870,725,2469,17264,-2348,-1836,-3541,5927
"2943","Kensington and Chelsea 021D","E01002843","E02000597","Kensington and Chelsea 021","E09000020","Kensington and Chelsea","E12000007","London",1232,1232,0,183.1,610,2,"00AW","Kensington and Chelsea",NA,6819,8856,7156,19074,4418,3499,3542,19797,-2401,-5357,-3614,723
"2930","Kensington and Chelsea 019A","E01002844","E02000595","Kensington and Chelsea 019","E09000020","Kensington and Chelsea","E12000007","London",1370,1369,1,110.8,745,1.8,"00AW","Kensington and Chelsea",NA,19034,27281,29577,23035,19607,24705,28450,31765,573,-2576,-1127,8730
"2931","Kensington and Chelsea 019B","E01002845","E02000595","Kensington and Chelsea 019","E09000020","Kensington and Chelsea","E12000007","London",1358,1326,32,193.2,738,1.8,"00AW","Kensington and Chelsea",NA,9913,15693,14250,26502,11128,12256,15208,26940,1215,-3437,958,438
"2920","Kensington and Chelsea 017A","E01002846","E02000593","Kensington and Chelsea 017","E09000020","Kensington and Chelsea","E12000007","London",1315,1313,2,124.5,781,1.7,"00AW","Kensington and Chelsea",NA,7779,9426,7903,19215,6724,7319,7377,29970,-1055,-2107,-526,10755
"2912","Kensington and Chelsea 015B","E01002847","E02000591","Kensington and Chelsea 015","E09000020","Kensington and Chelsea","E12000007","London",1599,1552,47,221.8,872,1.8,"00AW","Kensington and Chelsea",NA,9769,17893,14495,28610,9766,18080,18029,30809,-3,187,3534,2199
"2913","Kensington and Chelsea 015C","E01002848","E02000591","Kensington and Chelsea 015","E09000020","Kensington and Chelsea","E12000007","London",1572,1567,5,191.5,894,1.8,"00AW","Kensington and Chelsea",NA,7999,11497,11501,26250,6533,9758,9749,25125,-1466,-1739,-1752,-1125
"2921","Kensington and Chelsea 017B","E01002849","E02000593","Kensington and Chelsea 017","E09000020","Kensington and Chelsea","E12000007","London",1525,1523,2,235,787,1.9,"00AW","Kensington and Chelsea",NA,15118,19904,23545,24403,13588,19860,23808,31634,-1530,-44,263,7231
"2904","Kensington and Chelsea 013D","E01002850","E02000589","Kensington and Chelsea 013","E09000020","Kensington and Chelsea","E12000007","London",1451,1377,74,194.5,682,2,"00AW","Kensington and Chelsea",NA,10533,14514,16518,15680,9130,12388,12377,31868,-1403,-2126,-4141,16188
"2914","Kensington and Chelsea 015D","E01002851","E02000591","Kensington and Chelsea 015","E09000020","Kensington and Chelsea","E12000007","London",1642,1576,66,272.3,918,1.7,"00AW","Kensington and Chelsea",NA,6025,8190,6696,26911,4140,4534,4824,29359,-1885,-3656,-1872,2448
"2842","Kensington and Chelsea 001A","E01002852","E02000577","Kensington and Chelsea 001","E09000020","Kensington and Chelsea","E12000007","London",1908,1908,0,37.2,861,2.2,"00AW","Kensington and Chelsea",NA,2566,1615,2492,12944,2507,2593,3570,15637,-59,978,1078,2693
"2843","Kensington and Chelsea 001B","E01002853","E02000577","Kensington and Chelsea 001","E09000020","Kensington and Chelsea","E12000007","London",1093,1093,0,172.4,470,2.3,"00AW","Kensington and Chelsea",NA,3202,2928,2542,16382,1525,1290,2221,8604,-1677,-1638,-321,-7778
"2844","Kensington and Chelsea 001C","E01002854","E02000577","Kensington and Chelsea 001","E09000020","Kensington and Chelsea","E12000007","London",1121,1121,0,87.2,488,2.3,"00AW","Kensington and Chelsea",NA,3326,3576,4084,14286,2884,1645,2871,18237,-442,-1931,-1213,3951
"2845","Kensington and Chelsea 001D","E01002855","E02000577","Kensington and Chelsea 001","E09000020","Kensington and Chelsea","E12000007","London",1728,1724,4,163.2,764,2.3,"00AW","Kensington and Chelsea",NA,1522,2010,1568,10927,2534,1844,2594,19932,1012,-166,1026,9005
"2860","Kensington and Chelsea 004E","E01002856","E02000580","Kensington and Chelsea 004","E09000020","Kensington and Chelsea","E12000007","London",1738,1732,6,223.1,941,1.8,"00AW","Kensington and Chelsea",NA,3091,4535,2761,21450,5349,7314,7094,19872,2258,2779,4333,-1578
"2846","Kensington and Chelsea 001E","E01002857","E02000577","Kensington and Chelsea 001","E09000020","Kensington and Chelsea","E12000007","London",1349,1349,0,224.8,580,2.3,"00AW","Kensington and Chelsea",NA,2899,2596,2693,10627,1243,590,1190,12206,-1656,-2006,-1503,1579
"2908","Kensington and Chelsea 014C","E01002858","E02000590","Kensington and Chelsea 014","E09000020","Kensington and Chelsea","E12000007","London",1254,1254,0,213.3,749,1.7,"00AW","Kensington and Chelsea",NA,15464,14381,25381,21588,10421,9781,13982,23784,-5043,-4600,-11399,2196
"2898","Kensington and Chelsea 012C","E01002859","E02000588","Kensington and Chelsea 012","E09000020","Kensington and Chelsea","E12000007","London",1628,1628,0,127,866,1.9,"00AW","Kensington and Chelsea",NA,19761,32217,32447,20731,23125,32532,32821,28749,3364,315,374,8018
"2899","Kensington and Chelsea 012D","E01002860","E02000588","Kensington and Chelsea 012","E09000020","Kensington and Chelsea","E12000007","London",1502,1502,0,135.1,777,1.9,"00AW","Kensington and Chelsea",NA,25628,32328,32456,28352,21849,32590,32820,30242,-3779,262,364,1890
"2909","Kensington and Chelsea 014D","E01002861","E02000590","Kensington and Chelsea 014","E09000020","Kensington and Chelsea","E12000007","London",1424,1424,0,165,771,1.8,"00AW","Kensington and Chelsea",NA,18362,25474,28502,15292,18775,21965,23975,30516,413,-3509,-4527,15224
"2910","Kensington and Chelsea 014E","E01002862","E02000590","Kensington and Chelsea 014","E09000020","Kensington and Chelsea","E12000007","London",1543,1543,0,351.5,977,1.6,"00AW","Kensington and Chelsea",NA,8827,8327,7425,22849,9340,8516,10306,24577,513,189,2881,1728
"2900","Kensington and Chelsea 012E","E01002863","E02000588","Kensington and Chelsea 012","E09000020","Kensington and Chelsea","E12000007","London",1441,1441,0,116,792,1.8,"00AW","Kensington and Chelsea",NA,21003,31975,32392,17724,23617,32753,32804,29938,2614,778,412,12214
"2881","Kensington and Chelsea 009A","E01002864","E02000585","Kensington and Chelsea 009","E09000020","Kensington and Chelsea","E12000007","London",1500,1496,4,50.5,580,2.6,"00AW","Kensington and Chelsea",NA,21223,31083,32387,32399,23340,30317,32510,32062,2117,-766,123,-337
"2895","Kensington and Chelsea 011E","E01002865","E02000587","Kensington and Chelsea 011","E09000020","Kensington and Chelsea","E12000007","London",1383,1383,0,105.6,544,2.5,"00AW","Kensington and Chelsea",NA,23056,30920,32444,24933,25745,32019,32786,31117,2689,1099,342,6184
"2882","Kensington and Chelsea 009B","E01002866","E02000585","Kensington and Chelsea 009","E09000020","Kensington and Chelsea","E12000007","London",1744,1744,0,110.8,848,2.1,"00AW","Kensington and Chelsea",NA,9604,12582,15804,26723,12840,12437,16713,31440,3236,-145,909,4717
"2883","Kensington and Chelsea 009C","E01002867","E02000585","Kensington and Chelsea 009","E09000020","Kensington and Chelsea","E12000007","London",1981,1981,0,187.1,998,2,"00AW","Kensington and Chelsea",NA,7248,6822,13054,25253,10772,10694,14457,26694,3524,3872,1403,1441
"2884","Kensington and Chelsea 009D","E01002868","E02000585","Kensington and Chelsea 009","E09000020","Kensington and Chelsea","E12000007","London",1652,1633,19,67.2,725,2.3,"00AW","Kensington and Chelsea",NA,23386,32440,32452,17546,23857,32623,32712,31427,471,183,260,13881
"2885","Kensington and Chelsea 009E","E01002869","E02000585","Kensington and Chelsea 009","E09000020","Kensington and Chelsea","E12000007","London",1507,1507,0,148.6,768,2,"00AW","Kensington and Chelsea",NA,14504,18913,24605,27060,13030,14670,19843,26997,-1474,-4243,-4762,-63
"2861","Kensington and Chelsea 005A","E01002870","E02000581","Kensington and Chelsea 005","E09000020","Kensington and Chelsea","E12000007","London",1386,1386,0,109.7,693,2,"00AW","Kensington and Chelsea",NA,2592,2082,2587,11726,2589,1383,3211,15700,-3,-699,624,3974
"2872","Kensington and Chelsea 007B","E01002871","E02000583","Kensington and Chelsea 007","E09000020","Kensington and Chelsea","E12000007","London",1685,1680,5,128.9,742,2.3,"00AW","Kensington and Chelsea",NA,20606,31524,31924,30585,21320,31514,32440,26818,714,-10,516,-3767
"2862","Kensington and Chelsea 005B","E01002872","E02000581","Kensington and Chelsea 005","E09000020","Kensington and Chelsea","E12000007","London",1446,1440,6,149.4,726,2,"00AW","Kensington and Chelsea",NA,7940,6374,7858,23805,4687,3572,4190,18144,-3253,-2802,-3668,-5661
"2873","Kensington and Chelsea 007C","E01002873","E02000583","Kensington and Chelsea 007","E09000020","Kensington and Chelsea","E12000007","London",1331,1331,0,102.4,632,2.1,"00AW","Kensington and Chelsea",NA,14733,17080,21282,26925,12260,15284,15406,27744,-2473,-1796,-5876,819
"2874","Kensington and Chelsea 007D","E01002874","E02000583","Kensington and Chelsea 007","E09000020","Kensington and Chelsea","E12000007","London",1439,1431,8,173.6,648,2.2,"00AW","Kensington and Chelsea",NA,8751,11156,12103,24815,13060,14987,18144,30395,4309,3831,6041,5580
"2875","Kensington and Chelsea 007E","E01002875","E02000583","Kensington and Chelsea 007","E09000020","Kensington and Chelsea","E12000007","London",1388,1388,0,86.9,681,2,"00AW","Kensington and Chelsea",NA,15965,24183,26218,30627,17395,24947,28263,31574,1430,764,2045,947
"2851","Kensington and Chelsea 003A","E01002876","E02000579","Kensington and Chelsea 003","E09000020","Kensington and Chelsea","E12000007","London",1732,1721,11,138.8,744,2.3,"00AW","Kensington and Chelsea",NA,9289,8641,10772,23601,12026,12110,13576,28171,2737,3469,2804,4570
"2852","Kensington and Chelsea 003B","E01002877","E02000579","Kensington and Chelsea 003","E09000020","Kensington and Chelsea","E12000007","London",1710,1703,7,101.8,647,2.6,"00AW","Kensington and Chelsea",NA,3207,1390,4161,22099,3823,2413,4946,16396,616,1023,785,-5703
"2853","Kensington and Chelsea 003C","E01002878","E02000579","Kensington and Chelsea 003","E09000020","Kensington and Chelsea","E12000007","London",1629,1615,14,133.4,868,1.9,"00AW","Kensington and Chelsea",NA,4715,7062,4638,15396,7358,7511,8392,27277,2643,449,3754,11881
"2863","Kensington and Chelsea 005C","E01002879","E02000581","Kensington and Chelsea 005","E09000020","Kensington and Chelsea","E12000007","London",1528,1528,0,179.8,695,2.2,"00AW","Kensington and Chelsea",NA,2004,1562,2934,16272,3887,2019,5871,23532,1883,457,2937,7260
"2864","Kensington and Chelsea 005D","E01002880","E02000581","Kensington and Chelsea 005","E09000020","Kensington and Chelsea","E12000007","London",1540,1540,0,238.4,653,2.4,"00AW","Kensington and Chelsea",NA,4436,2107,4653,15509,3171,1737,3507,14500,-1265,-370,-1146,-1009
"2865","Kensington and Chelsea 005E","E01002881","E02000581","Kensington and Chelsea 005","E09000020","Kensington and Chelsea","E12000007","London",1398,1398,0,238.6,544,2.6,"00AW","Kensington and Chelsea",NA,5174,4481,5500,17651,4578,2467,4072,15568,-596,-2014,-1428,-2083
"2866","Kensington and Chelsea 006A","E01002882","E02000582","Kensington and Chelsea 006","E09000020","Kensington and Chelsea","E12000007","London",1334,1334,0,112.8,703,1.9,"00AW","Kensington and Chelsea",NA,11736,19043,22535,20566,13212,15639,20511,32457,1476,-3404,-2024,11891
"2867","Kensington and Chelsea 006B","E01002883","E02000582","Kensington and Chelsea 006","E09000020","Kensington and Chelsea","E12000007","London",1836,1696,140,158.7,802,2.1,"00AW","Kensington and Chelsea",NA,19861,27403,29890,22516,20289,27017,30256,32200,428,-386,366,9684
"2868","Kensington and Chelsea 006C","E01002884","E02000582","Kensington and Chelsea 006","E09000020","Kensington and Chelsea","E12000007","London",1403,1203,200,182.4,710,1.7,"00AW","Kensington and Chelsea",NA,10817,19168,19636,27340,12352,17609,20726,30772,1535,-1559,1090,3432
"2869","Kensington and Chelsea 006D","E01002885","E02000582","Kensington and Chelsea 006","E09000020","Kensington and Chelsea","E12000007","London",1538,1538,0,284.8,950,1.6,"00AW","Kensington and Chelsea",NA,14597,20750,26830,30565,13951,21600,24371,30838,-646,850,-2459,273
"2870","Kensington and Chelsea 006E","E01002886","E02000582","Kensington and Chelsea 006","E09000020","Kensington and Chelsea","E12000007","London",1548,1546,2,125.9,781,2,"00AW","Kensington and Chelsea",NA,18654,28272,30831,29260,17204,28444,30837,31827,-1450,172,6,2567
"2886","Kensington and Chelsea 010A","E01002887","E02000586","Kensington and Chelsea 010","E09000020","Kensington and Chelsea","E12000007","London",1401,1400,1,182.2,807,1.7,"00AW","Kensington and Chelsea",NA,17888,31661,32330,29365,18242,30227,32402,29428,354,-1434,72,63
"2905","Kensington and Chelsea 013E","E01002888","E02000589","Kensington and Chelsea 013","E09000020","Kensington and Chelsea","E12000007","London",2078,2022,56,261.1,1149,1.8,"00AW","Kensington and Chelsea",NA,18889,28401,30978,27895,20294,29995,32532,32094,1405,1594,1554,4199
"2887","Kensington and Chelsea 010B","E01002889","E02000586","Kensington and Chelsea 010","E09000020","Kensington and Chelsea","E12000007","London",1279,1118,161,106.9,579,1.9,"00AW","Kensington and Chelsea",NA,20197,30483,32094,15798,23374,29423,31340,29168,3177,-1060,-754,13370
"2888","Kensington and Chelsea 010C","E01002890","E02000586","Kensington and Chelsea 010","E09000020","Kensington and Chelsea","E12000007","London",1812,1812,0,115.6,705,2.6,"00AW","Kensington and Chelsea",NA,23572,32263,32446,27264,25763,32731,32772,31936,2191,468,326,4672
"2889","Kensington and Chelsea 010D","E01002891","E02000586","Kensington and Chelsea 010","E09000020","Kensington and Chelsea","E12000007","London",1446,1436,10,146.4,718,2,"00AW","Kensington and Chelsea",NA,20786,31836,32357,30569,22277,31989,32689,29526,1491,153,332,-1043
"2890","Kensington and Chelsea 010E","E01002892","E02000586","Kensington and Chelsea 010","E09000020","Kensington and Chelsea","E12000007","London",1831,1800,31,249.8,920,2,"00AW","Kensington and Chelsea",NA,20703,30933,31953,27227,23189,31095,32663,30865,2486,162,710,3638
"2922","Kensington and Chelsea 017C","E01002893","E02000593","Kensington and Chelsea 017","E09000020","Kensington and Chelsea","E12000007","London",1775,1767,8,181.1,987,1.8,"00AW","Kensington and Chelsea",NA,9199,12901,13457,22893,12118,11595,15008,25772,2919,-1306,1551,2879
"2923","Kensington and Chelsea 017D","E01002894","E02000593","Kensington and Chelsea 017","E09000020","Kensington and Chelsea","E12000007","London",1400,1389,11,137.9,773,1.8,"00AW","Kensington and Chelsea",NA,5095,8499,1776,26534,10649,14466,12129,27497,5554,5967,10353,963
"2936","Kensington and Chelsea 020B","E01002895","E02000596","Kensington and Chelsea 020","E09000020","Kensington and Chelsea","E12000007","London",1395,1395,0,128,610,2.3,"00AW","Kensington and Chelsea",NA,19983,31210,32151,31701,22622,31378,32397,23889,2639,168,246,-7812
"2937","Kensington and Chelsea 020C","E01002896","E02000596","Kensington and Chelsea 020","E09000020","Kensington and Chelsea","E12000007","London",1752,1752,0,154.1,875,2,"00AW","Kensington and Chelsea",NA,17299,26829,28410,27857,22367,29746,32718,30764,5068,2917,4308,2907
"2938","Kensington and Chelsea 020D","E01002897","E02000596","Kensington and Chelsea 020","E09000020","Kensington and Chelsea","E12000007","London",1314,1314,0,91.8,732,1.8,"00AW","Kensington and Chelsea",NA,13010,20077,25040,32180,13626,15009,21770,31265,616,-5068,-3270,-915
"2924","Kensington and Chelsea 017E","E01002898","E02000593","Kensington and Chelsea 017","E09000020","Kensington and Chelsea","E12000007","London",1609,1609,0,125.4,739,2.2,"00AW","Kensington and Chelsea",NA,19507,26808,32310,30429,22988,30216,32654,32582,3481,3408,344,2153
"2925","Kensington and Chelsea 018A","E01002899","E02000594","Kensington and Chelsea 018","E09000020","Kensington and Chelsea","E12000007","London",1355,1355,0,181.9,768,1.8,"00AW","Kensington and Chelsea",NA,13065,16164,15723,24115,11889,13069,13092,22322,-1176,-3095,-2631,-1793
"2926","Kensington and Chelsea 018B","E01002900","E02000594","Kensington and Chelsea 018","E09000020","Kensington and Chelsea","E12000007","London",1430,1430,0,112.2,682,2.1,"00AW","Kensington and Chelsea",NA,24048,32092,32437,25217,24517,32430,32752,31052,469,338,315,5835
"2927","Kensington and Chelsea 018C","E01002901","E02000594","Kensington and Chelsea 018","E09000020","Kensington and Chelsea","E12000007","London",1250,956,294,38.7,560,1.7,"00AW","Kensington and Chelsea",NA,17730,22545,31946,24757,18319,21216,31852,26546,589,-1329,-94,1789
"2928","Kensington and Chelsea 018D","E01002902","E02000594","Kensington and Chelsea 018","E09000020","Kensington and Chelsea","E12000007","London",1704,1704,0,123.3,1009,1.7,"00AW","Kensington and Chelsea",NA,18748,24040,29877,28403,21285,24448,28941,29252,2537,408,-936,849
"2929","Kensington and Chelsea 018E","E01002903","E02000594","Kensington and Chelsea 018","E09000020","Kensington and Chelsea","E12000007","London",1513,1513,0,136.8,691,2.2,"00AW","Kensington and Chelsea",NA,26162,32242,32433,31588,26751,32781,32806,31667,589,539,373,79
"2847","Kensington and Chelsea 002A","E01002904","E02000578","Kensington and Chelsea 002","E09000020","Kensington and Chelsea","E12000007","London",1173,1173,0,118,524,2.2,"00AW","Kensington and Chelsea",NA,4803,3400,6522,10678,1417,703,1467,8853,-3386,-2697,-5055,-1825
"2848","Kensington and Chelsea 002B","E01002905","E02000578","Kensington and Chelsea 002","E09000020","Kensington and Chelsea","E12000007","London",1568,1545,23,93.1,672,2.3,"00AW","Kensington and Chelsea",NA,3168,3600,3278,15737,2663,2691,3954,15373,-505,-909,676,-364
"2849","Kensington and Chelsea 002C","E01002906","E02000578","Kensington and Chelsea 002","E09000020","Kensington and Chelsea","E12000007","London",1681,1612,69,86.8,707,2.3,"00AW","Kensington and Chelsea",NA,5455,4896,6151,12420,4504,4329,4923,17766,-951,-567,-1228,5346
"2850","Kensington and Chelsea 002D","E01002907","E02000578","Kensington and Chelsea 002","E09000020","Kensington and Chelsea","E12000007","London",1376,1376,0,264.6,551,2.5,"00AW","Kensington and Chelsea",NA,3750,1821,3981,12888,1874,1155,1263,10754,-1876,-666,-2718,-2134
"2854","Kensington and Chelsea 003D","E01002908","E02000579","Kensington and Chelsea 003","E09000020","Kensington and Chelsea","E12000007","London",1391,1379,12,144.3,602,2.3,"00AW","Kensington and Chelsea",NA,8848,11263,14079,17227,9902,11063,13519,22331,1054,-200,-560,5104
"2855","Kensington and Chelsea 003E","E01002909","E02000579","Kensington and Chelsea 003","E09000020","Kensington and Chelsea","E12000007","London",2154,2152,2,216.9,1152,1.9,"00AW","Kensington and Chelsea",NA,5180,6719,4570,26613,8402,9892,8555,26305,3222,3173,3985,-308
"2932","Kensington and Chelsea 019C","E01002910","E02000595","Kensington and Chelsea 019","E09000020","Kensington and Chelsea","E12000007","London",1388,1329,59,97.5,756,1.8,"00AW","Kensington and Chelsea",NA,18104,21030,27666,27090,18600,16449,22857,31690,496,-4581,-4809,4600
"2933","Kensington and Chelsea 019D","E01002911","E02000595","Kensington and Chelsea 019","E09000020","Kensington and Chelsea","E12000007","London",1651,1651,0,136.7,767,2.2,"00AW","Kensington and Chelsea",NA,22701,31971,32256,32376,22655,32053,32506,25209,-46,82,250,-7167
"2939","Kensington and Chelsea 020E","E01002912","E02000596","Kensington and Chelsea 020","E09000020","Kensington and Chelsea","E12000007","London",1690,1601,89,150.8,809,2,"00AW","Kensington and Chelsea",NA,16658,19119,27097,25763,18200,21928,26134,22612,1542,2809,-963,-3151
"2944","Kensington and Chelsea 021E","E01002913","E02000597","Kensington and Chelsea 021","E09000020","Kensington and Chelsea","E12000007","London",1894,1894,0,173.6,932,2,"00AW","Kensington and Chelsea",NA,13041,15651,19949,28722,15022,17228,22016,27686,1981,1577,2067,-1036
"2934","Kensington and Chelsea 019E","E01002914","E02000595","Kensington and Chelsea 019","E09000020","Kensington and Chelsea","E12000007","London",1564,1432,132,87.8,741,1.9,"00AW","Kensington and Chelsea",NA,24665,30994,32422,30019,24363,29305,32671,25676,-302,-1689,249,-4343
"3009","Kingston upon Thames 014A","E01002915","E02000611","Kingston upon Thames 014","E09000021","Kingston upon Thames","E12000007","London",1304,1304,0,44.5,479,2.7,"00AX","Kingston upon Thames",NA,24557,24817,29639,26039,24825,24808,25530,26875,268,-9,-4109,836
"3010","Kingston upon Thames 014B","E01002916","E02000611","Kingston upon Thames 014","E09000021","Kingston upon Thames","E12000007","London",1478,1478,0,33.6,520,2.8,"00AX","Kingston upon Thames",NA,26291,26305,28258,31162,28889,28679,26554,29629,2598,2374,-1704,-1533
"3011","Kingston upon Thames 014C","E01002917","E02000611","Kingston upon Thames 014","E09000021","Kingston upon Thames","E12000007","London",1397,1397,0,50.6,497,2.8,"00AX","Kingston upon Thames",NA,28760,29507,28929,30051,31492,30579,29727,31035,2732,1072,798,984
"3024","Kingston upon Thames 017A","E01002918","E02000614","Kingston upon Thames 017","E09000021","Kingston upon Thames","E12000007","London",1758,1758,0,40.3,615,2.9,"00AX","Kingston upon Thames",NA,22138,20118,25782,19939,22489,18761,26933,16354,351,-1357,1151,-3585
"3025","Kingston upon Thames 017B","E01002919","E02000614","Kingston upon Thames 017","E09000021","Kingston upon Thames","E12000007","London",1705,1705,0,22.2,669,2.5,"00AX","Kingston upon Thames",NA,18316,13595,23052,23226,17682,14969,22611,24104,-634,1374,-441,878
"3012","Kingston upon Thames 014D","E01002920","E02000611","Kingston upon Thames 014","E09000021","Kingston upon Thames","E12000007","London",1604,1604,0,34.5,593,2.7,"00AX","Kingston upon Thames",NA,28281,29253,31301,30269,31437,29389,29146,31337,3156,136,-2155,1068
"2995","Kingston upon Thames 011A","E01002921","E02000608","Kingston upon Thames 011","E09000021","Kingston upon Thames","E12000007","London",1555,1532,23,90.4,857,1.8,"00AX","Kingston upon Thames",NA,14194,19206,21582,24899,17302,18535,19788,24261,3108,-671,-1794,-638
"2991","Kingston upon Thames 010A","E01002922","E02000607","Kingston upon Thames 010","E09000021","Kingston upon Thames","E12000007","London",1632,1632,0,51.5,725,2.3,"00AX","Kingston upon Thames",NA,24168,24150,26951,32427,25460,27609,26193,32444,1292,3459,-758,17
"3004","Kingston upon Thames 013A","E01002923","E02000610","Kingston upon Thames 013","E09000021","Kingston upon Thames","E12000007","London",1570,1563,7,134.3,777,2,"00AX","Kingston upon Thames",NA,8882,6306,10343,14767,8346,5608,7508,13147,-536,-698,-2835,-1620
"3013","Kingston upon Thames 014E","E01002924","E02000611","Kingston upon Thames 014","E09000021","Kingston upon Thames","E12000007","London",1530,1530,0,46.9,560,2.7,"00AX","Kingston upon Thames",NA,30347,31780,30079,31946,32109,31593,31084,32189,1762,-187,1005,243
"3005","Kingston upon Thames 013B","E01002925","E02000610","Kingston upon Thames 013","E09000021","Kingston upon Thames","E12000007","London",1615,1553,62,69.8,796,2,"00AX","Kingston upon Thames",NA,20566,23986,28638,28401,23547,22303,26779,31821,2981,-1683,-1859,3420
"2992","Kingston upon Thames 010B","E01002926","E02000607","Kingston upon Thames 010","E09000021","Kingston upon Thames","E12000007","London",1535,1535,0,53.1,590,2.6,"00AX","Kingston upon Thames",NA,26399,28769,31708,30890,28871,29162,30968,29728,2472,393,-740,-1162
"2981","Kingston upon Thames 008A","E01002927","E02000605","Kingston upon Thames 008","E09000021","Kingston upon Thames","E12000007","London",1556,1556,0,70.5,614,2.5,"00AX","Kingston upon Thames",NA,21620,20609,25685,28632,22135,16559,23153,28765,515,-4050,-2532,133
"2982","Kingston upon Thames 008B","E01002928","E02000605","Kingston upon Thames 008","E09000021","Kingston upon Thames","E12000007","London",1604,1523,81,62.8,660,2.3,"00AX","Kingston upon Thames",NA,19035,19511,18973,27549,18527,17604,21951,25148,-508,-1907,2978,-2401
"2976","Kingston upon Thames 007A","E01002929","E02000604","Kingston upon Thames 007","E09000021","Kingston upon Thames","E12000007","London",1633,1633,0,27.2,635,2.6,"00AX","Kingston upon Thames",NA,25508,29505,29028,32285,26422,30156,27303,32350,914,651,-1725,65
"2977","Kingston upon Thames 007B","E01002930","E02000604","Kingston upon Thames 007","E09000021","Kingston upon Thames","E12000007","London",1709,1682,27,64,683,2.5,"00AX","Kingston upon Thames",NA,20665,18075,26012,29172,20939,18998,26530,26405,274,923,518,-2767
"2978","Kingston upon Thames 007C","E01002931","E02000604","Kingston upon Thames 007","E09000021","Kingston upon Thames","E12000007","London",1850,1850,0,60.4,654,2.8,"00AX","Kingston upon Thames",NA,26830,25380,28227,31294,23879,22797,28377,31376,-2951,-2583,150,82
"2971","Kingston upon Thames 006A","E01002932","E02000603","Kingston upon Thames 006","E09000021","Kingston upon Thames","E12000007","London",1757,1726,31,76.2,678,2.5,"00AX","Kingston upon Thames",NA,11793,8189,12496,15917,8849,6170,7532,13465,-2944,-2019,-4964,-2452
"2960","Kingston upon Thames 004A","E01002933","E02000601","Kingston upon Thames 004","E09000021","Kingston upon Thames","E12000007","London",1995,1961,34,121.4,807,2.4,"00AX","Kingston upon Thames",NA,10140,6735,10657,21626,16907,12906,17088,26456,6767,6171,6431,4830
"2961","Kingston upon Thames 004B","E01002934","E02000601","Kingston upon Thames 004","E09000021","Kingston upon Thames","E12000007","London",1821,1821,0,88.2,649,2.8,"00AX","Kingston upon Thames",NA,29630,28494,29922,31470,31511,29190,30552,32382,1881,696,630,912
"2955","Kingston upon Thames 003A","E01002935","E02000600","Kingston upon Thames 003","E09000021","Kingston upon Thames","E12000007","London",1770,1770,0,95.2,775,2.3,"00AX","Kingston upon Thames",NA,25026,27902,27431,32368,27810,25911,31046,32232,2784,-1991,3615,-136
"2962","Kingston upon Thames 004D","E01002937","E02000601","Kingston upon Thames 004","E09000021","Kingston upon Thames","E12000007","London",1729,1729,0,115,645,2.7,"00AX","Kingston upon Thames",NA,25054,24091,29422,31023,31011,30878,30967,31927,5957,6787,1545,904
"2956","Kingston upon Thames 003B","E01002938","E02000600","Kingston upon Thames 003","E09000021","Kingston upon Thames","E12000007","London",1935,1935,0,81.7,782,2.5,"00AX","Kingston upon Thames",NA,26327,24663,28421,30427,29842,26520,29488,31778,3515,1857,1067,1351
"3029","Kingston upon Thames 018A","E01002939","E02000615","Kingston upon Thames 018","E09000021","Kingston upon Thames","E12000007","London",1548,1548,0,59.1,605,2.6,"00AX","Kingston upon Thames",NA,19040,15064,22405,16970,21368,17387,18387,16203,2328,2323,-4018,-767
"3038","Kingston upon Thames 020A","E01002940","E02000617","Kingston upon Thames 020","E09000021","Kingston upon Thames","E12000007","London",1580,1580,0,70.9,604,2.6,"00AX","Kingston upon Thames",NA,15177,12122,17640,13694,17292,16496,16145,11995,2115,4374,-1495,-1699
"3030","Kingston upon Thames 018B","E01002941","E02000615","Kingston upon Thames 018","E09000021","Kingston upon Thames","E12000007","London",1487,1487,0,24,628,2.4,"00AX","Kingston upon Thames",NA,22175,22395,26862,23627,23461,21345,22512,22371,1286,-1050,-4350,-1256
"3031","Kingston upon Thames 018C","E01002942","E02000615","Kingston upon Thames 018","E09000021","Kingston upon Thames","E12000007","London",1370,1370,0,64.7,522,2.6,"00AX","Kingston upon Thames",NA,24969,23720,26683,16115,23958,23135,25098,19239,-1011,-585,-1585,3124
"3039","Kingston upon Thames 020B","E01002943","E02000617","Kingston upon Thames 020","E09000021","Kingston upon Thames","E12000007","London",1396,1396,0,44.9,507,2.8,"00AX","Kingston upon Thames",NA,14763,10979,17613,9686,17596,15987,18869,11900,2833,5008,1256,2214
"3034","Kingston upon Thames 019A","E01002944","E02000616","Kingston upon Thames 019","E09000021","Kingston upon Thames","E12000007","London",1360,1342,18,45,508,2.6,"00AX","Kingston upon Thames",NA,19969,18509,22745,17063,22365,20861,25104,11829,2396,2352,2359,-5234
"3035","Kingston upon Thames 019B","E01002945","E02000616","Kingston upon Thames 019","E09000021","Kingston upon Thames","E12000007","London",1559,1559,0,62.9,655,2.4,"00AX","Kingston upon Thames",NA,21833,23134,25492,20336,25584,23293,28017,18210,3751,159,2525,-2126
"3036","Kingston upon Thames 019C","E01002946","E02000616","Kingston upon Thames 019","E09000021","Kingston upon Thames","E12000007","London",1498,1498,0,32.1,603,2.5,"00AX","Kingston upon Thames",NA,22240,23693,28045,18018,23945,24100,26766,20578,1705,407,-1279,2560
"3037","Kingston upon Thames 019D","E01002947","E02000616","Kingston upon Thames 019","E09000021","Kingston upon Thames","E12000007","London",1614,1614,0,54.8,597,2.7,"00AX","Kingston upon Thames",NA,24348,25066,28546,19723,30050,28316,30609,19404,5702,3250,2063,-319
"3040","Kingston upon Thames 020C","E01002948","E02000617","Kingston upon Thames 020","E09000021","Kingston upon Thames","E12000007","London",2103,2055,48,4,784,2.6,"00AX","Kingston upon Thames",NA,14826,12782,21306,21275,16231,12943,15245,17509,1405,161,-6061,-3766
"3041","Kingston upon Thames 020D","E01002949","E02000617","Kingston upon Thames 020","E09000021","Kingston upon Thames","E12000007","London",1862,1862,0,62.4,677,2.8,"00AX","Kingston upon Thames",NA,23348,29157,28934,21549,25895,19522,27041,19847,2547,-9635,-1893,-1702
"3042","Kingston upon Thames 020E","E01002950","E02000617","Kingston upon Thames 020","E09000021","Kingston upon Thames","E12000007","London",1596,1596,0,16.2,719,2.2,"00AX","Kingston upon Thames",NA,11964,9606,17672,12759,15529,10980,17149,11640,3565,1374,-523,-1119
"2957","Kingston upon Thames 003C","E01002951","E02000600","Kingston upon Thames 003","E09000021","Kingston upon Thames","E12000007","London",1514,1514,0,67.8,624,2.4,"00AX","Kingston upon Thames",NA,28206,26928,31169,32435,27845,21726,31338,32155,-361,-5202,169,-280
"2950","Kingston upon Thames 002A","E01002952","E02000599","Kingston upon Thames 002","E09000021","Kingston upon Thames","E12000007","London",1541,1418,123,10.8,486,2.9,"00AX","Kingston upon Thames",NA,26435,30452,28907,32024,29963,31826,32302,32506,3528,1374,3395,482
"2951","Kingston upon Thames 002B","E01002953","E02000599","Kingston upon Thames 002","E09000021","Kingston upon Thames","E12000007","London",1308,1280,28,11.2,453,2.8,"00AX","Kingston upon Thames",NA,26705,29429,31820,32251,27148,30160,31832,32204,443,731,12,-47
"2958","Kingston upon Thames 003D","E01002954","E02000600","Kingston upon Thames 003","E09000021","Kingston upon Thames","E12000007","London",1289,1148,141,55.9,565,2,"00AX","Kingston upon Thames",NA,22560,17704,29886,26835,22729,13546,26409,32039,169,-4158,-3477,5204
"2952","Kingston upon Thames 002C","E01002955","E02000599","Kingston upon Thames 002","E09000021","Kingston upon Thames","E12000007","London",1377,1377,0,27.9,513,2.7,"00AX","Kingston upon Thames",NA,18433,20141,26949,29780,19233,18832,24676,27959,800,-1309,-2273,-1821
"2953","Kingston upon Thames 002D","E01002956","E02000599","Kingston upon Thames 002","E09000021","Kingston upon Thames","E12000007","London",1611,1193,418,25.2,437,2.7,"00AX","Kingston upon Thames",NA,22785,27496,31240,28061,27664,26197,30843,26180,4879,-1299,-397,-1881
"2959","Kingston upon Thames 003E","E01002957","E02000600","Kingston upon Thames 003","E09000021","Kingston upon Thames","E12000007","London",1717,1717,0,75.1,608,2.8,"00AX","Kingston upon Thames",NA,11091,5160,17129,18655,17021,10173,21566,15695,5930,5013,4437,-2960
"2983","Kingston upon Thames 008C","E01002958","E02000605","Kingston upon Thames 008","E09000021","Kingston upon Thames","E12000007","London",1680,1680,0,90.8,659,2.5,"00AX","Kingston upon Thames",NA,25114,24254,26595,26870,29660,26567,29362,29528,4546,2313,2767,2658
"2954","Kingston upon Thames 002E","E01002959","E02000599","Kingston upon Thames 002","E09000021","Kingston upon Thames","E12000007","London",1433,1420,13,33.4,479,3,"00AX","Kingston upon Thames",NA,29147,30149,32146,32459,32349,32258,32550,32732,3202,2109,404,273
"2972","Kingston upon Thames 006B","E01002960","E02000603","Kingston upon Thames 006","E09000021","Kingston upon Thames","E12000007","London",1627,1608,19,61.6,574,2.8,"00AX","Kingston upon Thames",NA,26364,26341,28793,32420,29732,28643,30494,32298,3368,2302,1701,-122
"2984","Kingston upon Thames 008D","E01002961","E02000605","Kingston upon Thames 008","E09000021","Kingston upon Thames","E12000007","London",1750,1750,0,51.7,609,2.9,"00AX","Kingston upon Thames",NA,28939,27737,31205,32020,29947,22039,27400,31086,1008,-5698,-3805,-934
"2973","Kingston upon Thames 006C","E01002962","E02000603","Kingston upon Thames 006","E09000021","Kingston upon Thames","E12000007","London",1528,1527,1,62.6,511,3,"00AX","Kingston upon Thames",NA,14166,9406,17034,21442,19728,16885,19265,19060,5562,7479,2231,-2382
"2979","Kingston upon Thames 007D","E01002963","E02000604","Kingston upon Thames 007","E09000021","Kingston upon Thames","E12000007","London",1732,1731,1,92.6,768,2.3,"00AX","Kingston upon Thames",NA,22578,22675,31384,30894,24318,19161,25681,31910,1740,-3514,-5703,1016
"2966","Kingston upon Thames 005A","E01002964","E02000602","Kingston upon Thames 005","E09000021","Kingston upon Thames","E12000007","London",2231,2057,174,71.1,982,2.1,"00AX","Kingston upon Thames",NA,9802,8212,14295,23897,12310,14423,23742,17645,2508,6211,9447,-6252
"2986","Kingston upon Thames 009A","E01002965","E02000606","Kingston upon Thames 009","E09000021","Kingston upon Thames","E12000007","London",2325,2322,3,66.7,1071,2.2,"00AX","Kingston upon Thames",NA,17983,19379,25077,31716,21687,20731,28076,31323,3704,1352,2999,-393
"2993","Kingston upon Thames 010C","E01002966","E02000607","Kingston upon Thames 010","E09000021","Kingston upon Thames","E12000007","London",1910,1873,37,37.9,744,2.5,"00AX","Kingston upon Thames",NA,18377,19195,18182,30563,22458,20709,25301,26459,4081,1514,7119,-4104
"2987","Kingston upon Thames 009B","E01002967","E02000606","Kingston upon Thames 009","E09000021","Kingston upon Thames","E12000007","London",1858,1852,6,94.3,958,1.9,"00AX","Kingston upon Thames",NA,25569,30070,30659,30863,27225,29234,31619,30022,1656,-836,960,-841
"2988","Kingston upon Thames 009C","E01002968","E02000606","Kingston upon Thames 009","E09000021","Kingston upon Thames","E12000007","London",2631,2375,256,47.3,1123,2.1,"00AX","Kingston upon Thames",NA,15036,20431,22029,31469,19276,24337,26990,28297,4240,3906,4961,-3172
"2967","Kingston upon Thames 005B","E01002969","E02000602","Kingston upon Thames 005","E09000021","Kingston upon Thames","E12000007","London",1748,1748,0,253.3,756,2.3,"00AX","Kingston upon Thames",NA,3759,1277,3658,10413,4711,2974,5166,7466,952,1697,1508,-2947
"2974","Kingston upon Thames 006D","E01002970","E02000603","Kingston upon Thames 006","E09000021","Kingston upon Thames","E12000007","London",1576,1576,0,55.1,570,2.8,"00AX","Kingston upon Thames",NA,11218,9817,18612,11993,12874,11208,16869,17266,1656,1391,-1743,5273
"2968","Kingston upon Thames 005C","E01002971","E02000602","Kingston upon Thames 005","E09000021","Kingston upon Thames","E12000007","London",1709,1709,0,53.7,705,2.4,"00AX","Kingston upon Thames",NA,18927,17326,25167,26984,21056,19408,25356,20075,2129,2082,189,-6909
"2969","Kingston upon Thames 005D","E01002972","E02000602","Kingston upon Thames 005","E09000021","Kingston upon Thames","E12000007","London",1809,1809,0,108.1,828,2.2,"00AX","Kingston upon Thames",NA,17946,18666,27730,27795,19875,19596,28009,24409,1929,930,279,-3386
"2975","Kingston upon Thames 006E","E01002973","E02000603","Kingston upon Thames 006","E09000021","Kingston upon Thames","E12000007","London",1372,1372,0,46,465,3,"00AX","Kingston upon Thames",NA,10041,6845,15452,13485,12081,10483,13801,10050,2040,3638,-1651,-3435
"2970","Kingston upon Thames 005E","E01002974","E02000602","Kingston upon Thames 005","E09000021","Kingston upon Thames","E12000007","London",1893,1890,3,90.4,726,2.6,"00AX","Kingston upon Thames",NA,14169,10541,15628,27851,19521,17722,20161,26255,5352,7181,4533,-1596
"2999","Kingston upon Thames 012A","E01002975","E02000609","Kingston upon Thames 012","E09000021","Kingston upon Thames","E12000007","London",1381,1381,0,46.7,483,2.9,"00AX","Kingston upon Thames",NA,23759,19170,28601,28314,24201,18461,27537,27408,442,-709,-1064,-906
"3014","Kingston upon Thames 015A","E01002976","E02000612","Kingston upon Thames 015","E09000021","Kingston upon Thames","E12000007","London",1654,1654,0,59.6,641,2.6,"00AX","Kingston upon Thames",NA,23225,22192,26723,19491,29198,25883,29699,21678,5973,3691,2976,2187
"3000","Kingston upon Thames 012B","E01002977","E02000609","Kingston upon Thames 012","E09000021","Kingston upon Thames","E12000007","London",1673,1665,8,56,654,2.5,"00AX","Kingston upon Thames",NA,15100,8668,16022,23565,14642,9394,13719,14810,-458,726,-2303,-8755
"3015","Kingston upon Thames 015B","E01002978","E02000612","Kingston upon Thames 015","E09000021","Kingston upon Thames","E12000007","London",1761,1757,4,48.4,684,2.6,"00AX","Kingston upon Thames",NA,27790,24031,30317,29555,29915,28349,27670,28801,2125,4318,-2647,-754
"3016","Kingston upon Thames 015C","E01002979","E02000612","Kingston upon Thames 015","E09000021","Kingston upon Thames","E12000007","London",1549,1549,0,45.8,614,2.5,"00AX","Kingston upon Thames",NA,26487,25001,27367,27942,26268,22421,24198,28619,-219,-2580,-3169,677
"3001","Kingston upon Thames 012C","E01002980","E02000609","Kingston upon Thames 012","E09000021","Kingston upon Thames","E12000007","London",1413,1396,17,61.2,482,2.9,"00AX","Kingston upon Thames",NA,28918,29415,26900,29157,27927,27399,27609,24639,-991,-2016,709,-4518
"3002","Kingston upon Thames 012D","E01002981","E02000609","Kingston upon Thames 012","E09000021","Kingston upon Thames","E12000007","London",1544,1533,11,40.9,518,3,"00AX","Kingston upon Thames",NA,21656,24341,28514,29969,23699,25022,24604,29994,2043,681,-3910,25
"3017","Kingston upon Thames 015D","E01002982","E02000612","Kingston upon Thames 015","E09000021","Kingston upon Thames","E12000007","London",1438,1350,88,55.7,517,2.6,"00AX","Kingston upon Thames",NA,21084,19369,24505,28377,19144,16342,18832,26665,-1940,-3027,-5673,-1712
"3018","Kingston upon Thames 015E","E01002983","E02000612","Kingston upon Thames 015","E09000021","Kingston upon Thames","E12000007","London",1626,1626,0,25,595,2.7,"00AX","Kingston upon Thames",NA,25595,27237,30010,29253,28758,26436,30421,30726,3163,-801,411,1473
"3003","Kingston upon Thames 012E","E01002984","E02000609","Kingston upon Thames 012","E09000021","Kingston upon Thames","E12000007","London",1426,1405,21,52.5,604,2.3,"00AX","Kingston upon Thames",NA,16582,16126,20241,31102,19419,16855,17340,28861,2837,729,-2901,-2241
"2980","Kingston upon Thames 007E","E01002985","E02000604","Kingston upon Thames 007","E09000021","Kingston upon Thames","E12000007","London",1662,1662,0,96.6,603,2.8,"00AX","Kingston upon Thames",NA,19998,17627,26143,29069,23844,18513,27058,26332,3846,886,915,-2737
"2985","Kingston upon Thames 008E","E01002986","E02000605","Kingston upon Thames 008","E09000021","Kingston upon Thames","E12000007","London",1273,1273,0,29,471,2.7,"00AX","Kingston upon Thames",NA,18235,18201,20272,28955,21189,17028,19800,27102,2954,-1173,-472,-1853
"2996","Kingston upon Thames 011B","E01002987","E02000608","Kingston upon Thames 011","E09000021","Kingston upon Thames","E12000007","London",1702,1508,194,80.1,844,1.8,"00AX","Kingston upon Thames",NA,12820,16010,11444,31025,13080,14204,12805,30351,260,-1806,1361,-674
"2997","Kingston upon Thames 011C","E01002988","E02000608","Kingston upon Thames 011","E09000021","Kingston upon Thames","E12000007","London",1906,1234,672,66.8,572,2.2,"00AX","Kingston upon Thames",NA,23566,29886,30130,32313,26527,28510,31468,25587,2961,-1376,1338,-6726
"2998","Kingston upon Thames 011D","E01002989","E02000608","Kingston upon Thames 011","E09000021","Kingston upon Thames","E12000007","London",1830,1830,0,120.9,909,2,"00AX","Kingston upon Thames",NA,22023,30173,30300,31303,24229,30606,31864,32766,2206,433,1564,1463
"2989","Kingston upon Thames 009D","E01002990","E02000606","Kingston upon Thames 009","E09000021","Kingston upon Thames","E12000007","London",1680,1680,0,99.5,937,1.8,"00AX","Kingston upon Thames",NA,19204,28026,26970,31121,23058,26513,29434,23820,3854,-1513,2464,-7301
"2990","Kingston upon Thames 009E","E01002991","E02000606","Kingston upon Thames 009","E09000021","Kingston upon Thames","E12000007","London",1613,1598,15,70.8,710,2.3,"00AX","Kingston upon Thames",NA,19947,28704,26552,32392,27139,30164,31126,32575,7192,1460,4574,183
"2994","Kingston upon Thames 010D","E01002992","E02000607","Kingston upon Thames 010","E09000021","Kingston upon Thames","E12000007","London",1752,1077,675,53.1,438,2.5,"00AX","Kingston upon Thames",NA,20694,28815,31626,23806,26692,28095,32114,29410,5998,-720,488,5604
"3006","Kingston upon Thames 013C","E01002993","E02000610","Kingston upon Thames 013","E09000021","Kingston upon Thames","E12000007","London",1519,1519,0,91.4,867,1.8,"00AX","Kingston upon Thames",NA,24007,25754,31173,31879,25253,25294,31164,30205,1246,-460,-9,-1674
"3019","Kingston upon Thames 016A","E01002994","E02000613","Kingston upon Thames 016","E09000021","Kingston upon Thames","E12000007","London",1510,1388,122,47.3,602,2.3,"00AX","Kingston upon Thames",NA,23325,25218,28911,32112,29199,26833,31630,31907,5874,1615,2719,-205
"3007","Kingston upon Thames 013D","E01002995","E02000610","Kingston upon Thames 013","E09000021","Kingston upon Thames","E12000007","London",1476,1379,97,36.1,602,2.3,"00AX","Kingston upon Thames",NA,25666,27682,31330,32277,29105,30163,31298,31015,3439,2481,-32,-1262
"3020","Kingston upon Thames 016B","E01002996","E02000613","Kingston upon Thames 016","E09000021","Kingston upon Thames","E12000007","London",1513,1484,29,74.4,589,2.5,"00AX","Kingston upon Thames",NA,24847,26497,27988,28224,28909,28460,27274,30566,4062,1963,-714,2342
"3021","Kingston upon Thames 016C","E01002997","E02000613","Kingston upon Thames 016","E09000021","Kingston upon Thames","E12000007","London",1462,1440,22,62.6,588,2.4,"00AX","Kingston upon Thames",NA,21853,23746,20101,30860,28843,28236,27029,31814,6990,4490,6928,954
"3022","Kingston upon Thames 016D","E01002998","E02000613","Kingston upon Thames 016","E09000021","Kingston upon Thames","E12000007","London",1530,1522,8,106.5,612,2.5,"00AX","Kingston upon Thames",NA,18532,10891,22122,25727,21388,12411,20746,21857,2856,1520,-1376,-3870
"3008","Kingston upon Thames 013E","E01002999","E02000610","Kingston upon Thames 013","E09000021","Kingston upon Thames","E12000007","London",1449,1427,22,76.5,743,1.9,"00AX","Kingston upon Thames",NA,15873,17964,22287,29207,21990,18601,25773,23354,6117,637,3486,-5853
"3026","Kingston upon Thames 017C","E01003000","E02000614","Kingston upon Thames 017","E09000021","Kingston upon Thames","E12000007","London",1553,1553,0,13.5,587,2.6,"00AX","Kingston upon Thames",NA,16342,13277,16482,16997,17200,13875,14425,13356,858,598,-2057,-3641
"3027","Kingston upon Thames 017D","E01003001","E02000614","Kingston upon Thames 017","E09000021","Kingston upon Thames","E12000007","London",1831,1831,0,49.8,627,2.9,"00AX","Kingston upon Thames",NA,23897,24830,28102,21151,24300,23488,28503,20355,403,-1342,401,-796
"3023","Kingston upon Thames 016E","E01003002","E02000613","Kingston upon Thames 016","E09000021","Kingston upon Thames","E12000007","London",1826,1826,0,60.2,783,2.3,"00AX","Kingston upon Thames",NA,15159,12266,18180,23721,17511,13291,18622,13051,2352,1025,442,-10670
"3028","Kingston upon Thames 017E","E01003003","E02000614","Kingston upon Thames 017","E09000021","Kingston upon Thames","E12000007","London",1557,1512,45,66.7,574,2.6,"00AX","Kingston upon Thames",NA,21701,22488,25607,26344,21138,17307,26951,22875,-563,-5181,1344,-3469
"3032","Kingston upon Thames 018D","E01003004","E02000615","Kingston upon Thames 018","E09000021","Kingston upon Thames","E12000007","London",1578,1578,0,50.5,591,2.7,"00AX","Kingston upon Thames",NA,20574,21888,29350,17446,23569,24114,26439,19782,2995,2226,-2911,2336
"3033","Kingston upon Thames 018E","E01003005","E02000615","Kingston upon Thames 018","E09000021","Kingston upon Thames","E12000007","London",1488,1488,0,64.5,570,2.6,"00AX","Kingston upon Thames",NA,23619,21555,26579,15916,26577,24387,27596,18118,2958,2832,1017,2202
"2945","Kingston upon Thames 001A","E01003006","E02000598","Kingston upon Thames 001","E09000021","Kingston upon Thames","E12000007","London",1500,1500,0,46.7,611,2.5,"00AX","Kingston upon Thames",NA,25010,21416,26724,31827,28240,23493,22697,31599,3230,2077,-4027,-228
"2946","Kingston upon Thames 001B","E01003007","E02000598","Kingston upon Thames 001","E09000021","Kingston upon Thames","E12000007","London",1513,1513,0,74.6,549,2.8,"00AX","Kingston upon Thames",NA,27196,24875,26448,30257,31374,27168,29293,31524,4178,2293,2845,1267
"2947","Kingston upon Thames 001C","E01003008","E02000598","Kingston upon Thames 001","E09000021","Kingston upon Thames","E12000007","London",1432,1432,0,71.2,514,2.8,"00AX","Kingston upon Thames",NA,30252,28624,29407,31884,32313,31651,31745,32091,2061,3027,2338,207
"2948","Kingston upon Thames 001D","E01003009","E02000598","Kingston upon Thames 001","E09000021","Kingston upon Thames","E12000007","London",1895,1895,0,62.5,773,2.5,"00AX","Kingston upon Thames",NA,16976,16326,21141,30968,26093,19023,23717,31073,9117,2697,2576,105
"2949","Kingston upon Thames 001E","E01003010","E02000598","Kingston upon Thames 001","E09000021","Kingston upon Thames","E12000007","London",1497,1497,0,49.5,554,2.7,"00AX","Kingston upon Thames",NA,29425,27951,30089,32148,31614,29803,29681,32614,2189,1852,-408,466
"2963","Kingston upon Thames 004E","E01003011","E02000601","Kingston upon Thames 004","E09000021","Kingston upon Thames","E12000007","London",1741,1741,0,69,730,2.4,"00AX","Kingston upon Thames",NA,26379,29592,27830,32266,29264,27045,27672,32649,2885,-2547,-158,383
"3216","Lambeth 036A","E01003013","E02006801","Lambeth 036","E09000022","Lambeth","E12000007","London",1639,1562,77,47.7,854,1.8,"00AY","Lambeth",NA,18932,30550,30063,25254,17611,30846,32665,32629,-1321,296,2602,7375
"3217","Lambeth 036B","E01003014","E02006801","Lambeth 036","E09000022","Lambeth","E12000007","London",1534,1415,119,82.2,678,2.1,"00AY","Lambeth",NA,6465,7339,8150,15516,9741,12207,15394,14206,3276,4868,7244,-1310
"3043","Lambeth 002A","E01003015","E02000619","Lambeth 002","E09000022","Lambeth","E12000007","London",1594,1594,0,166.9,730,2.2,"00AY","Lambeth",NA,4536,4177,5270,11056,6570,6083,7873,13964,2034,1906,2603,2908
"3218","Lambeth 036C","E01003016","E02006801","Lambeth 036","E09000022","Lambeth","E12000007","London",1352,1026,326,82.8,526,2,"00AY","Lambeth",NA,11323,16652,20270,23443,14352,17927,21660,24392,3029,1275,1390,949
"3219","Lambeth 036D","E01003017","E02006801","Lambeth 036","E09000022","Lambeth","E12000007","London",1663,1661,2,127.9,862,1.9,"00AY","Lambeth",NA,6479,8074,7103,14669,7875,9974,9785,20623,1396,1900,2682,5954
"3134","Lambeth 020A","E01003018","E02000637","Lambeth 020","E09000022","Lambeth","E12000007","London",2079,2063,16,138.6,999,2.1,"00AY","Lambeth",NA,7026,12186,11141,23252,14517,15769,20165,22877,7491,3583,9024,-375
"3110","Lambeth 015A","E01003019","E02000632","Lambeth 015","E09000022","Lambeth","E12000007","London",2090,2084,6,139,914,2.3,"00AY","Lambeth",NA,10090,11198,12813,22897,14655,15909,19783,24424,4565,4711,6970,1527
"3115","Lambeth 016A","E01003020","E02000633","Lambeth 016","E09000022","Lambeth","E12000007","London",1775,1772,3,123.7,771,2.3,"00AY","Lambeth",NA,7283,7812,9960,22173,11350,10712,17708,27396,4067,2900,7748,5223
"3139","Lambeth 021A","E01003021","E02000638","Lambeth 021","E09000022","Lambeth","E12000007","London",1903,1514,389,118.3,663,2.3,"00AY","Lambeth",NA,3059,3263,2500,10489,3833,5123,7173,11320,774,1860,4673,831
"3140","Lambeth 021B","E01003022","E02000638","Lambeth 021","E09000022","Lambeth","E12000007","London",1746,1746,0,150.5,770,2.3,"00AY","Lambeth",NA,7663,8370,8854,17659,14430,13599,15345,24843,6767,5229,6491,7184
"3141","Lambeth 021C","E01003023","E02000638","Lambeth 021","E09000022","Lambeth","E12000007","London",2380,2380,0,186.5,1063,2.2,"00AY","Lambeth",NA,8081,7686,10990,19622,11466,12522,18256,18564,3385,4836,7266,-1058
"3142","Lambeth 021D","E01003024","E02000638","Lambeth 021","E09000022","Lambeth","E12000007","London",1798,1798,0,145,766,2.3,"00AY","Lambeth",NA,3736,2756,4551,14864,5266,4324,7232,19153,1530,1568,2681,4289
"3143","Lambeth 021E","E01003025","E02000638","Lambeth 021","E09000022","Lambeth","E12000007","London",2071,2071,0,132.2,842,2.5,"00AY","Lambeth",NA,6220,4582,7738,15990,7853,7390,9628,15759,1633,2808,1890,-231
"3129","Lambeth 019A","E01003026","E02000636","Lambeth 019","E09000022","Lambeth","E12000007","London",1484,1471,13,42.7,656,2.2,"00AY","Lambeth",NA,9490,15187,22576,13325,16859,21772,29258,27538,7369,6585,6682,14213
"3130","Lambeth 019B","E01003027","E02000636","Lambeth 019","E09000022","Lambeth","E12000007","London",1373,1373,0,110.7,480,2.9,"00AY","Lambeth",NA,16922,28209,28004,32016,22336,31518,32500,32763,5414,3309,4496,747
"3131","Lambeth 019C","E01003028","E02000636","Lambeth 019","E09000022","Lambeth","E12000007","London",1469,1469,0,107.5,563,2.6,"00AY","Lambeth",NA,9004,11831,15022,15586,13539,14689,17399,16604,4535,2858,2377,1018
"3120","Lambeth 017A","E01003029","E02000634","Lambeth 017","E09000022","Lambeth","E12000007","London",1808,1781,27,121.6,860,2.1,"00AY","Lambeth",NA,8242,12024,13629,20664,12925,13449,18453,25198,4683,1425,4824,4534
"3132","Lambeth 019D","E01003030","E02000636","Lambeth 019","E09000022","Lambeth","E12000007","London",1795,1782,13,107.4,783,2.3,"00AY","Lambeth",NA,8943,17568,18346,23899,18015,24963,30154,31976,9072,7395,11808,8077
"3149","Lambeth 023A","E01003031","E02000640","Lambeth 023","E09000022","Lambeth","E12000007","London",1658,1658,0,183.2,720,2.3,"00AY","Lambeth",NA,6247,5812,8026,15777,12133,9699,14164,15538,5886,3887,6138,-239
"3121","Lambeth 017B","E01003032","E02000634","Lambeth 017","E09000022","Lambeth","E12000007","London",1747,1747,0,97.1,759,2.3,"00AY","Lambeth",NA,6939,6585,9726,16835,6148,7387,10326,25450,-791,802,600,8615
"3133","Lambeth 019E","E01003033","E02000636","Lambeth 019","E09000022","Lambeth","E12000007","London",1518,1518,0,102.2,594,2.6,"00AY","Lambeth",NA,14099,16065,22086,24323,18760,19718,24293,28595,4661,3653,2207,4272
"3095","Lambeth 012A","E01003034","E02000629","Lambeth 012","E09000022","Lambeth","E12000007","London",1751,1731,20,152.7,723,2.4,"00AY","Lambeth",NA,9053,8838,15084,21162,12579,11470,16643,22013,3526,2632,1559,851
"3096","Lambeth 012B","E01003035","E02000629","Lambeth 012","E09000022","Lambeth","E12000007","London",1557,1557,0,132.4,710,2.2,"00AY","Lambeth",NA,7601,12508,15667,17735,9494,13809,19100,26331,1893,1301,3433,8596
"3097","Lambeth 012C","E01003036","E02000629","Lambeth 012","E09000022","Lambeth","E12000007","London",1608,1603,5,142.2,737,2.2,"00AY","Lambeth",NA,6328,7863,7881,23042,9503,11123,12021,15295,3175,3260,4140,-7747
"3100","Lambeth 013A","E01003037","E02000630","Lambeth 013","E09000022","Lambeth","E12000007","London",1387,1387,0,121.3,606,2.3,"00AY","Lambeth",NA,2999,1904,3929,20273,3949,3369,6104,21135,950,1465,2175,862
"3101","Lambeth 013B","E01003038","E02000630","Lambeth 013","E09000022","Lambeth","E12000007","London",1506,1506,0,113.3,689,2.2,"00AY","Lambeth",NA,12199,20993,21397,30369,18249,23654,27811,31981,6050,2661,6414,1612
"3102","Lambeth 013C","E01003039","E02000630","Lambeth 013","E09000022","Lambeth","E12000007","London",2042,2042,0,110.5,945,2.2,"00AY","Lambeth",NA,11268,18028,20284,22598,21607,26233,30318,29215,10339,8205,10034,6617
"3103","Lambeth 013D","E01003040","E02000630","Lambeth 013","E09000022","Lambeth","E12000007","London",1288,1288,0,85.4,594,2.2,"00AY","Lambeth",NA,10181,15271,20675,21898,13767,16220,19578,24442,3586,949,-1097,2544
"3122","Lambeth 017C","E01003041","E02000634","Lambeth 017","E09000022","Lambeth","E12000007","London",1613,1536,77,168,678,2.3,"00AY","Lambeth",NA,2993,4584,6759,12434,4182,6225,11019,18043,1189,1641,4260,5609
"3104","Lambeth 013E","E01003042","E02000630","Lambeth 013","E09000022","Lambeth","E12000007","London",1043,1042,1,109,502,2.1,"00AY","Lambeth",NA,2606,4067,1525,12435,7332,8942,8147,24440,4726,4875,6622,12005
"3124","Lambeth 018A","E01003043","E02000635","Lambeth 018","E09000022","Lambeth","E12000007","London",1634,1634,0,158,685,2.4,"00AY","Lambeth",NA,7508,8305,12015,19460,10383,11085,14227,26410,2875,2780,2212,6950
"3125","Lambeth 018B","E01003044","E02000635","Lambeth 018","E09000022","Lambeth","E12000007","London",1238,1238,0,184.2,606,2,"00AY","Lambeth",NA,4918,4069,4500,11355,4006,3286,3427,13687,-912,-783,-1073,2332
"3089","Lambeth 011A","E01003045","E02000628","Lambeth 011","E09000022","Lambeth","E12000007","London",1971,1971,0,172.6,728,2.7,"00AY","Lambeth",NA,1191,1054,2000,13786,2450,1495,3430,12608,1259,441,1430,-1178
"3079","Lambeth 009A","E01003046","E02000626","Lambeth 009","E09000022","Lambeth","E12000007","London",1741,1738,3,183.6,743,2.3,"00AY","Lambeth",NA,3236,1976,4294,8480,3977,3274,4667,12833,741,1298,373,4353
"3090","Lambeth 011B","E01003047","E02000628","Lambeth 011","E09000022","Lambeth","E12000007","London",1627,1627,0,90.1,751,2.2,"00AY","Lambeth",NA,2734,3682,4072,17658,3074,3839,7276,19330,340,157,3204,1672
"3080","Lambeth 009B","E01003048","E02000626","Lambeth 009","E09000022","Lambeth","E12000007","London",1764,1764,0,145.3,741,2.4,"00AY","Lambeth",NA,2195,1324,2920,8103,2491,1436,3065,12340,296,112,145,4237
"3091","Lambeth 011C","E01003049","E02000628","Lambeth 011","E09000022","Lambeth","E12000007","London",1695,1686,9,142.4,668,2.5,"00AY","Lambeth",NA,4107,3730,5051,13932,4110,3989,5806,17559,3,259,755,3627
"3116","Lambeth 016B","E01003050","E02000633","Lambeth 016","E09000022","Lambeth","E12000007","London",1650,1618,32,168.2,773,2.1,"00AY","Lambeth",NA,3998,6187,6166,18194,6864,9462,14058,21654,2866,3275,7892,3460
"3126","Lambeth 018C","E01003051","E02000635","Lambeth 018","E09000022","Lambeth","E12000007","London",1643,1641,2,89.6,675,2.4,"00AY","Lambeth",NA,2600,2048,3726,10550,2516,3397,5170,13041,-84,1349,1444,2491
"3117","Lambeth 016C","E01003052","E02000633","Lambeth 016","E09000022","Lambeth","E12000007","London",1821,1821,0,144.6,758,2.4,"00AY","Lambeth",NA,1014,632,1516,13939,2250,1906,4227,11404,1236,1274,2711,-2535
"3111","Lambeth 015B","E01003053","E02000632","Lambeth 015","E09000022","Lambeth","E12000007","London",1728,1724,4,149.1,757,2.3,"00AY","Lambeth",NA,9636,14531,15985,24175,11376,17457,21102,28463,1740,2926,5117,4288
"3112","Lambeth 015C","E01003054","E02000632","Lambeth 015","E09000022","Lambeth","E12000007","London",1832,1825,7,208.9,819,2.2,"00AY","Lambeth",NA,12064,16158,24177,11540,14047,23508,30584,22947,1983,7350,6407,11407
"3118","Lambeth 016D","E01003055","E02000633","Lambeth 016","E09000022","Lambeth","E12000007","London",1490,1464,26,108.9,790,1.9,"00AY","Lambeth",NA,4227,7799,5702,23200,5070,7886,9400,22141,843,87,3698,-1059
"3113","Lambeth 015D","E01003056","E02000632","Lambeth 015","E09000022","Lambeth","E12000007","London",1935,1929,6,232.9,838,2.3,"00AY","Lambeth",NA,7684,8436,9377,17553,11306,11313,14537,23203,3622,2877,5160,5650
"3123","Lambeth 017D","E01003057","E02000634","Lambeth 017","E09000022","Lambeth","E12000007","London",1678,1676,2,174.2,724,2.3,"00AY","Lambeth",NA,3479,3185,3659,19079,4905,5489,5346,20127,1426,2304,1687,1048
"3114","Lambeth 015E","E01003058","E02000632","Lambeth 015","E09000022","Lambeth","E12000007","London",1931,1922,9,212,820,2.3,"00AY","Lambeth",NA,8727,8679,11617,18228,15052,14170,21282,30187,6325,5491,9665,11959
"3092","Lambeth 011D","E01003059","E02000628","Lambeth 011","E09000022","Lambeth","E12000007","London",1634,1592,42,211.1,625,2.5,"00AY","Lambeth",NA,4525,4097,6902,12977,4352,5614,7667,12459,-173,1517,765,-518
"3093","Lambeth 011E","E01003060","E02000628","Lambeth 011","E09000022","Lambeth","E12000007","London",1558,1558,0,182.9,632,2.5,"00AY","Lambeth",NA,3539,3411,5184,15358,3064,3253,6091,10626,-475,-158,907,-4732
"3094","Lambeth 011F","E01003061","E02000628","Lambeth 011","E09000022","Lambeth","E12000007","London",1246,1242,4,156.9,568,2.2,"00AY","Lambeth",NA,4090,5855,6781,20864,4183,8046,9090,14954,93,2191,2309,-5910
"3201","Lambeth 033A","E01003062","E02000650","Lambeth 033","E09000022","Lambeth","E12000007","London",1668,1668,0,123,795,2.1,"00AY","Lambeth",NA,7930,8967,10128,17929,10594,9005,13631,27757,2664,38,3503,9828
"3202","Lambeth 033B","E01003063","E02000650","Lambeth 033","E09000022","Lambeth","E12000007","London",1432,1432,0,116.3,664,2.2,"00AY","Lambeth",NA,3158,2718,3694,13832,3387,2450,2761,17018,229,-268,-933,3186
"3175","Lambeth 028A","E01003064","E02000645","Lambeth 028","E09000022","Lambeth","E12000007","London",1536,1536,0,100.7,660,2.3,"00AY","Lambeth",NA,16335,20526,25208,25430,21202,18830,23781,29069,4867,-1696,-1427,3639
"3190","Lambeth 031A","E01003065","E02000648","Lambeth 031","E09000022","Lambeth","E12000007","London",1472,1472,0,120.2,666,2.2,"00AY","Lambeth",NA,3563,3369,5143,13416,3249,1833,3262,14475,-314,-1536,-1881,1059
"3176","Lambeth 028B","E01003066","E02000645","Lambeth 028","E09000022","Lambeth","E12000007","London",1688,1688,0,49,741,2.3,"00AY","Lambeth",NA,4156,3910,5118,12007,4974,4728,6763,22178,818,818,1645,10171
"3203","Lambeth 033C","E01003067","E02000650","Lambeth 033","E09000022","Lambeth","E12000007","London",1471,1471,0,98,599,2.5,"00AY","Lambeth",NA,11811,10395,14376,17985,14025,13304,16169,23693,2214,2909,1793,5708
"3191","Lambeth 031B","E01003068","E02000648","Lambeth 031","E09000022","Lambeth","E12000007","London",1592,1592,0,89.4,657,2.4,"00AY","Lambeth",NA,5306,3811,5758,16432,6603,5215,8697,19061,1297,1404,2939,2629
"3204","Lambeth 033D","E01003069","E02000650","Lambeth 033","E09000022","Lambeth","E12000007","London",1361,1361,0,57.9,520,2.6,"00AY","Lambeth",NA,4572,4699,5621,9843,6275,7062,7167,16940,1703,2363,1546,7097
"3205","Lambeth 033E","E01003070","E02000650","Lambeth 033","E09000022","Lambeth","E12000007","London",1492,1492,0,116.5,655,2.3,"00AY","Lambeth",NA,3185,1939,2781,10107,2790,1444,2706,14634,-395,-495,-75,4527
"3127","Lambeth 018D","E01003071","E02000635","Lambeth 018","E09000022","Lambeth","E12000007","London",2278,2278,0,128.3,1004,2.3,"00AY","Lambeth",NA,6260,9435,7905,26715,14434,17395,21616,25206,8174,7960,13711,-1509
"3105","Lambeth 014A","E01003072","E02000631","Lambeth 014","E09000022","Lambeth","E12000007","London",1848,1846,2,89,769,2.4,"00AY","Lambeth",NA,12026,16036,12278,28973,14269,15555,18958,31746,2243,-481,6680,2773
"3106","Lambeth 014B","E01003073","E02000631","Lambeth 014","E09000022","Lambeth","E12000007","London",1697,1697,0,100.5,698,2.4,"00AY","Lambeth",NA,5338,5172,6911,15504,7069,6120,6525,20433,1731,948,-386,4929
"3128","Lambeth 018E","E01003074","E02000635","Lambeth 018","E09000022","Lambeth","E12000007","London",2364,2347,17,33.2,1096,2.1,"00AY","Lambeth",NA,4560,7622,5091,24670,9878,14267,13575,24917,5318,6645,8484,247
"3081","Lambeth 009C","E01003075","E02000626","Lambeth 009","E09000022","Lambeth","E12000007","London",1633,1614,19,209.1,685,2.4,"00AY","Lambeth",NA,2565,2481,3140,11573,2718,2509,2937,9013,153,28,-203,-2560
"3107","Lambeth 014C","E01003076","E02000631","Lambeth 014","E09000022","Lambeth","E12000007","London",1915,1887,28,50.9,836,2.3,"00AY","Lambeth",NA,8398,10964,11340,15592,11870,9375,15199,26153,3472,-1589,3859,10561
"3108","Lambeth 014D","E01003077","E02000631","Lambeth 014","E09000022","Lambeth","E12000007","London",1792,1792,0,173.3,786,2.3,"00AY","Lambeth",NA,7697,9857,11575,22035,9977,11398,15529,22287,2280,1541,3954,252
"3109","Lambeth 014E","E01003078","E02000631","Lambeth 014","E09000022","Lambeth","E12000007","London",1580,1576,4,75.7,634,2.5,"00AY","Lambeth",NA,14566,17510,16634,26728,19804,21507,24069,31262,5238,3997,7435,4534
"3170","Lambeth 027A","E01003079","E02000644","Lambeth 027","E09000022","Lambeth","E12000007","London",1797,1709,88,81.1,757,2.3,"00AY","Lambeth",NA,4529,3425,5825,19696,6312,7015,10119,20106,1783,3590,4294,410
"3171","Lambeth 027B","E01003080","E02000644","Lambeth 027","E09000022","Lambeth","E12000007","London",1603,1599,4,125.6,663,2.4,"00AY","Lambeth",NA,12819,13535,17619,25397,13886,11821,16972,26929,1067,-1714,-647,1532
"3177","Lambeth 028C","E01003081","E02000645","Lambeth 028","E09000022","Lambeth","E12000007","London",1783,1766,17,86.8,768,2.3,"00AY","Lambeth",NA,4784,4810,5233,18777,7087,7135,8600,21785,2303,2325,3367,3008
"3192","Lambeth 031C","E01003082","E02000648","Lambeth 031","E09000022","Lambeth","E12000007","London",1452,1446,6,115.7,651,2.2,"00AY","Lambeth",NA,3768,4121,3272,10258,6235,4888,6505,23671,2467,767,3233,13413
"3185","Lambeth 030A","E01003083","E02000647","Lambeth 030","E09000022","Lambeth","E12000007","London",1508,1459,49,101.7,594,2.5,"00AY","Lambeth",NA,12328,11642,14069,26322,13327,13469,13443,27590,999,1827,-626,1268
"3186","Lambeth 030B","E01003084","E02000647","Lambeth 030","E09000022","Lambeth","E12000007","London",1611,1603,8,114.2,673,2.4,"00AY","Lambeth",NA,9068,9903,9511,24458,15286,17669,19177,24027,6218,7766,9666,-431
"3187","Lambeth 030C","E01003085","E02000647","Lambeth 030","E09000022","Lambeth","E12000007","London",1734,1734,0,77.1,697,2.5,"00AY","Lambeth",NA,10261,9553,11667,27643,13631,13377,19280,23049,3370,3824,7613,-4594
"3193","Lambeth 031D","E01003086","E02000648","Lambeth 031","E09000022","Lambeth","E12000007","London",1611,1611,0,110.6,647,2.5,"00AY","Lambeth",NA,3060,1581,2857,11270,5196,3897,4943,12039,2136,2316,2086,769
"3194","Lambeth 031E","E01003087","E02000648","Lambeth 031","E09000022","Lambeth","E12000007","London",1664,1562,102,125.6,611,2.6,"00AY","Lambeth",NA,1572,1376,1946,8130,1596,1214,3017,8325,24,-162,1071,195
"3084","Lambeth 010A","E01003088","E02000627","Lambeth 010","E09000022","Lambeth","E12000007","London",1817,1817,0,192.5,737,2.5,"00AY","Lambeth",NA,4957,4269,7722,15182,6899,8062,12099,17702,1942,3793,4377,2520
"3074","Lambeth 008A","E01003089","E02000625","Lambeth 008","E09000022","Lambeth","E12000007","London",1874,1874,0,141.3,689,2.7,"00AY","Lambeth",NA,4289,3232,7057,12271,5958,5030,10636,14497,1669,1798,3579,2226
"3098","Lambeth 012D","E01003090","E02000629","Lambeth 012","E09000022","Lambeth","E12000007","London",2279,2279,0,161.4,1043,2.2,"00AY","Lambeth",NA,4964,6188,9067,15322,10533,13568,16993,22004,5569,7380,7926,6682
"3075","Lambeth 008B","E01003091","E02000625","Lambeth 008","E09000022","Lambeth","E12000007","London",1667,1667,0,207.3,668,2.5,"00AY","Lambeth",NA,7117,5002,15190,14119,7642,7290,12597,14273,525,2288,-2593,154
"3076","Lambeth 008C","E01003092","E02000625","Lambeth 008","E09000022","Lambeth","E12000007","London",1787,1738,49,113.3,717,2.4,"00AY","Lambeth",NA,3176,2859,4330,10794,3744,3379,6379,15216,568,520,2049,4422
"3085","Lambeth 010B","E01003093","E02000627","Lambeth 010","E09000022","Lambeth","E12000007","London",2371,2305,66,322.6,949,2.4,"00AY","Lambeth",NA,3456,2765,3447,17406,5322,3332,8747,16999,1866,567,5300,-407
"3086","Lambeth 010C","E01003094","E02000627","Lambeth 010","E09000022","Lambeth","E12000007","London",1539,1539,0,189.3,675,2.3,"00AY","Lambeth",NA,8929,9501,11564,21625,7968,8125,14018,23029,-961,-1376,2454,1404
"3099","Lambeth 012E","E01003095","E02000629","Lambeth 012","E09000022","Lambeth","E12000007","London",1838,1834,4,118.7,760,2.4,"00AY","Lambeth",NA,10006,11988,13960,23779,12695,17714,22247,30945,2689,5726,8287,7166
"3087","Lambeth 010D","E01003096","E02000627","Lambeth 010","E09000022","Lambeth","E12000007","London",2071,2062,9,145,926,2.2,"00AY","Lambeth",NA,8222,11760,9631,15179,9556,15306,18304,21314,1334,3546,8673,6135
"3064","Lambeth 006A","E01003097","E02000623","Lambeth 006","E09000022","Lambeth","E12000007","London",1671,1671,0,170.3,724,2.3,"00AY","Lambeth",NA,4238,3310,4152,11996,5341,5501,7349,13134,1103,2191,3197,1138
"3059","Lambeth 005A","E01003098","E02000622","Lambeth 005","E09000022","Lambeth","E12000007","London",1558,1544,14,194,645,2.4,"00AY","Lambeth",NA,6386,6103,12111,18086,10789,9255,17060,20863,4403,3152,4949,2777
"3060","Lambeth 005B","E01003099","E02000622","Lambeth 005","E09000022","Lambeth","E12000007","London",1590,1590,0,52.3,666,2.4,"00AY","Lambeth",NA,4039,4251,7239,15272,6937,6934,12712,18178,2898,2683,5473,2906
"3061","Lambeth 005C","E01003100","E02000622","Lambeth 005","E09000022","Lambeth","E12000007","London",1942,1928,14,191.1,878,2.2,"00AY","Lambeth",NA,8459,18034,20524,18685,17855,24802,27932,27898,9396,6768,7408,9213
"3048","Lambeth 003A","E01003101","E02000620","Lambeth 003","E09000022","Lambeth","E12000007","London",1568,1568,0,135.3,685,2.3,"00AY","Lambeth",NA,4852,3889,7643,14412,8684,7607,11329,20117,3832,3718,3686,5705
"3053","Lambeth 004A","E01003102","E02000621","Lambeth 004","E09000022","Lambeth","E12000007","London",1738,1655,83,104.8,844,2,"00AY","Lambeth",NA,5163,10343,6190,22145,8545,13325,11908,27046,3382,2982,5718,4901
"3054","Lambeth 004C","E01003104","E02000621","Lambeth 004","E09000022","Lambeth","E12000007","London",1608,1608,0,196.6,777,2.1,"00AY","Lambeth",NA,9308,10694,16841,20915,9138,11986,18156,19357,-170,1292,1315,-1558
"3049","Lambeth 003B","E01003105","E02000620","Lambeth 003","E09000022","Lambeth","E12000007","London",1673,1673,0,174.6,780,2.1,"00AY","Lambeth",NA,4070,3485,3528,17023,7374,6213,8616,24079,3304,2728,5088,7056
"3050","Lambeth 003C","E01003106","E02000620","Lambeth 003","E09000022","Lambeth","E12000007","London",1962,1942,20,164.9,911,2.1,"00AY","Lambeth",NA,6800,7572,9894,21504,10252,9496,13171,27722,3452,1924,3277,6218
"3051","Lambeth 003D","E01003107","E02000620","Lambeth 003","E09000022","Lambeth","E12000007","London",1912,1912,0,147.6,929,2.1,"00AY","Lambeth",NA,9657,10921,16075,24592,16773,18133,23609,20709,7116,7212,7534,-3883
"3044","Lambeth 002B","E01003108","E02000619","Lambeth 002","E09000022","Lambeth","E12000007","London",1555,1536,19,194.1,755,2,"00AY","Lambeth",NA,5477,3991,7757,16248,5338,5801,7438,15283,-139,1810,-319,-965
"3052","Lambeth 003E","E01003109","E02000620","Lambeth 003","E09000022","Lambeth","E12000007","London",2255,2255,0,84.7,1093,2.1,"00AY","Lambeth",NA,4442,3503,4643,18113,6876,7308,11645,26121,2434,3805,7002,8008
"3045","Lambeth 002C","E01003110","E02000619","Lambeth 002","E09000022","Lambeth","E12000007","London",1873,1825,48,124.3,849,2.1,"00AY","Lambeth",NA,8197,13041,9891,20376,13729,13007,19363,26349,5532,-34,9472,5973
"3046","Lambeth 002D","E01003111","E02000619","Lambeth 002","E09000022","Lambeth","E12000007","London",1530,1530,0,208.2,638,2.4,"00AY","Lambeth",NA,2139,2206,2068,12212,5275,4368,5713,11644,3136,2162,3645,-568
"3047","Lambeth 002E","E01003112","E02000619","Lambeth 002","E09000022","Lambeth","E12000007","London",1502,1502,0,101.1,771,1.9,"00AY","Lambeth",NA,5491,5218,4819,13516,5843,5712,6300,19180,352,494,1481,5664
"3195","Lambeth 032A","E01003113","E02000649","Lambeth 032","E09000022","Lambeth","E12000007","London",1988,1922,66,120.9,817,2.4,"00AY","Lambeth",NA,6149,7462,8114,22056,8940,9885,14731,16414,2791,2423,6617,-5642
"3196","Lambeth 032B","E01003114","E02000649","Lambeth 032","E09000022","Lambeth","E12000007","London",1817,1812,5,91.6,765,2.4,"00AY","Lambeth",NA,8606,11791,12684,21463,12457,16916,19540,25479,3851,5125,6856,4016
"3206","Lambeth 034A","E01003115","E02000651","Lambeth 034","E09000022","Lambeth","E12000007","London",1618,1601,17,148.7,669,2.4,"00AY","Lambeth",NA,6196,6619,9964,20700,12391,11823,14622,24877,6195,5204,4658,4177
"3180","Lambeth 029A","E01003116","E02000646","Lambeth 029","E09000022","Lambeth","E12000007","London",1598,1583,15,56.7,634,2.5,"00AY","Lambeth",NA,11709,11764,15811,27116,14950,15999,18433,21553,3241,4235,2622,-5563
"3181","Lambeth 029B","E01003117","E02000646","Lambeth 029","E09000022","Lambeth","E12000007","London",1926,1914,12,114.9,841,2.3,"00AY","Lambeth",NA,7560,10619,11271,23124,11836,12676,14651,25401,4276,2057,3380,2277
"3182","Lambeth 029C","E01003118","E02000646","Lambeth 029","E09000022","Lambeth","E12000007","London",1735,1677,58,82,688,2.4,"00AY","Lambeth",NA,8250,11313,8815,27703,10612,10365,15672,26443,2362,-948,6857,-1260
"3197","Lambeth 032C","E01003119","E02000649","Lambeth 032","E09000022","Lambeth","E12000007","London",1885,1833,52,110.4,813,2.3,"00AY","Lambeth",NA,5717,11774,11813,23624,11003,15330,15446,28952,5286,3556,3633,5328
"3198","Lambeth 032D","E01003120","E02000649","Lambeth 032","E09000022","Lambeth","E12000007","London",1983,1939,44,136.2,961,2,"00AY","Lambeth",NA,3589,8017,5222,17611,5935,10251,10699,21029,2346,2234,5477,3418
"3065","Lambeth 006B","E01003121","E02000623","Lambeth 006","E09000022","Lambeth","E12000007","London",1624,1624,0,262.8,691,2.4,"00AY","Lambeth",NA,3816,2027,4870,14075,5851,4223,6896,15468,2035,2196,2026,1393
"3055","Lambeth 004D","E01003122","E02000621","Lambeth 004","E09000022","Lambeth","E12000007","London",1813,1811,2,175.7,870,2.1,"00AY","Lambeth",NA,7507,6436,11990,18302,9596,9573,15589,20029,2089,3137,3599,1727
"3066","Lambeth 006C","E01003123","E02000623","Lambeth 006","E09000022","Lambeth","E12000007","London",1489,1484,5,103,683,2.2,"00AY","Lambeth",NA,7180,10432,13196,20626,11941,14292,18189,28213,4761,3860,4993,7587
"3067","Lambeth 006D","E01003124","E02000623","Lambeth 006","E09000022","Lambeth","E12000007","London",1444,1438,6,177.6,619,2.3,"00AY","Lambeth",NA,5510,8202,10231,16868,6130,6952,14897,18734,620,-1250,4666,1866
"3068","Lambeth 006E","E01003125","E02000623","Lambeth 006","E09000022","Lambeth","E12000007","London",1762,1762,0,241.7,692,2.5,"00AY","Lambeth",NA,2844,1179,3771,14534,5207,3712,6070,15692,2363,2533,2299,1158
"3077","Lambeth 008D","E01003126","E02000625","Lambeth 008","E09000022","Lambeth","E12000007","London",1532,1532,0,156.5,645,2.4,"00AY","Lambeth",NA,4841,4989,8957,15797,5910,5512,7465,16393,1069,523,-1492,596
"3088","Lambeth 010E","E01003127","E02000627","Lambeth 010","E09000022","Lambeth","E12000007","London",1773,1773,0,132,755,2.3,"00AY","Lambeth",NA,5759,8547,10565,15575,9046,12161,14431,20277,3287,3614,3866,4702
"3078","Lambeth 008E","E01003128","E02000625","Lambeth 008","E09000022","Lambeth","E12000007","London",1501,1499,2,173.1,664,2.3,"00AY","Lambeth",NA,3416,4241,4077,12019,4016,5050,5604,11261,600,809,1527,-758
"3056","Lambeth 004E","E01003129","E02000621","Lambeth 004","E09000022","Lambeth","E12000007","London",1839,1839,0,212.8,808,2.3,"00AY","Lambeth",NA,8279,8790,13115,23781,11118,12322,17764,24036,2839,3532,4649,255
"3165","Lambeth 026A","E01003130","E02000643","Lambeth 026","E09000022","Lambeth","E12000007","London",1740,1735,5,117.8,739,2.3,"00AY","Lambeth",NA,10354,11211,11193,24515,13374,12059,18039,27220,3020,848,6846,2705
"3166","Lambeth 026B","E01003131","E02000643","Lambeth 026","E09000022","Lambeth","E12000007","London",1447,1447,0,79.1,617,2.3,"00AY","Lambeth",NA,10194,14540,17262,25879,13608,19767,20311,28558,3414,5227,3049,2679
"3155","Lambeth 024A","E01003132","E02000641","Lambeth 024","E09000022","Lambeth","E12000007","London",1522,1413,109,107,536,2.6,"00AY","Lambeth",NA,7015,5270,6061,15410,5187,3818,5494,18189,-1828,-1452,-567,2779
"3172","Lambeth 027C","E01003133","E02000644","Lambeth 027","E09000022","Lambeth","E12000007","London",1719,1719,0,98.9,765,2.2,"00AY","Lambeth",NA,7827,8677,7706,25702,10309,11292,11938,30328,2482,2615,4232,4626
"3173","Lambeth 027D","E01003134","E02000644","Lambeth 027","E09000022","Lambeth","E12000007","London",1556,1552,4,96.5,619,2.5,"00AY","Lambeth",NA,9687,9186,12574,21865,13150,12661,15169,24698,3463,3475,2595,2833
"3167","Lambeth 026C","E01003135","E02000643","Lambeth 026","E09000022","Lambeth","E12000007","London",1684,1684,0,163.2,724,2.3,"00AY","Lambeth",NA,5452,5410,5362,21548,7907,7125,10547,20012,2455,1715,5185,-1536
"3144","Lambeth 022A","E01003136","E02000639","Lambeth 022","E09000022","Lambeth","E12000007","London",1583,1583,0,135.9,735,2.2,"00AY","Lambeth",NA,6065,8001,10974,19853,9358,10359,12666,27039,3293,2358,1692,7186
"3145","Lambeth 022B","E01003137","E02000639","Lambeth 022","E09000022","Lambeth","E12000007","London",1475,1446,29,130.9,676,2.1,"00AY","Lambeth",NA,5870,6260,9322,21025,5626,6383,9554,17233,-244,123,232,-3792
"3168","Lambeth 026D","E01003138","E02000643","Lambeth 026","E09000022","Lambeth","E12000007","London",1537,1531,6,116.1,689,2.2,"00AY","Lambeth",NA,15097,21265,21799,23244,23389,26257,29981,29304,8292,4992,8182,6060
"3211","Lambeth 035A","E01003139","E02000652","Lambeth 035","E09000022","Lambeth","E12000007","London",1564,1564,0,122.6,542,2.9,"00AY","Lambeth",NA,10156,8053,14581,20855,15444,12235,20684,15430,5288,4182,6103,-5425
"3212","Lambeth 035B","E01003140","E02000652","Lambeth 035","E09000022","Lambeth","E12000007","London",1489,1489,0,107.6,492,3,"00AY","Lambeth",NA,11716,8298,12852,20640,13652,10404,16865,13660,1936,2106,4013,-6980
"3207","Lambeth 034B","E01003141","E02000651","Lambeth 034","E09000022","Lambeth","E12000007","London",1715,1707,8,105.2,723,2.4,"00AY","Lambeth",NA,7927,6965,7664,18900,9193,8921,10514,19780,1266,1956,2850,880
"3213","Lambeth 035C","E01003142","E02000652","Lambeth 035","E09000022","Lambeth","E12000007","London",1359,1359,0,98.9,453,3,"00AY","Lambeth",NA,9979,7632,9847,21550,13189,10305,15342,15267,3210,2673,5495,-6283
"3214","Lambeth 035D","E01003143","E02000652","Lambeth 035","E09000022","Lambeth","E12000007","London",1434,1395,39,88.8,516,2.7,"00AY","Lambeth",NA,6638,2856,9234,17202,7256,5132,7918,15964,618,2276,-1316,-1238
"3208","Lambeth 034C","E01003144","E02000651","Lambeth 034","E09000022","Lambeth","E12000007","London",1569,1499,70,31.1,520,2.9,"00AY","Lambeth",NA,10157,18691,11062,30640,13602,16791,18603,30322,3445,-1900,7541,-318
"3209","Lambeth 034D","E01003145","E02000651","Lambeth 034","E09000022","Lambeth","E12000007","London",1699,1675,24,102.5,783,2.1,"00AY","Lambeth",NA,6551,8048,8933,19990,9516,11715,15747,19739,2965,3667,6814,-251
"3215","Lambeth 035E","E01003146","E02000652","Lambeth 035","E09000022","Lambeth","E12000007","London",1517,1517,0,123.8,524,2.9,"00AY","Lambeth",NA,7599,6076,9419,18362,9785,7883,10704,15300,2186,1807,1285,-3062
"3210","Lambeth 034E","E01003147","E02000651","Lambeth 034","E09000022","Lambeth","E12000007","London",1990,1974,16,112.4,797,2.5,"00AY","Lambeth",NA,7347,8618,7629,19903,11694,10796,11299,21707,4347,2178,3670,1804
"3199","Lambeth 032E","E01003148","E02000649","Lambeth 032","E09000022","Lambeth","E12000007","London",1792,1777,15,92.2,762,2.3,"00AY","Lambeth",NA,7953,9220,10470,18772,12419,11412,13614,23740,4466,2192,3144,4968
"3188","Lambeth 030D","E01003149","E02000647","Lambeth 030","E09000022","Lambeth","E12000007","London",1791,1693,98,67.4,694,2.4,"00AY","Lambeth",NA,12565,14049,14862,28885,18264,15193,21746,30125,5699,1144,6884,1240
"3200","Lambeth 032F","E01003150","E02000649","Lambeth 032","E09000022","Lambeth","E12000007","London",1716,1690,26,105.8,769,2.2,"00AY","Lambeth",NA,4397,5260,6535,16191,6343,4719,9660,19815,1946,-541,3125,3624
"3169","Lambeth 026E","E01003151","E02000643","Lambeth 026","E09000022","Lambeth","E12000007","London",1961,1950,11,145.8,820,2.4,"00AY","Lambeth",NA,3250,1576,5734,14761,4219,2282,6715,13096,969,706,981,-1665
"3174","Lambeth 027E","E01003152","E02000644","Lambeth 027","E09000022","Lambeth","E12000007","London",1945,1945,0,88.3,761,2.6,"00AY","Lambeth",NA,11686,12866,16949,28078,17280,17423,22186,29577,5594,4557,5237,1499
"3183","Lambeth 029D","E01003153","E02000646","Lambeth 029","E09000022","Lambeth","E12000007","London",2066,2066,0,169.1,929,2.2,"00AY","Lambeth",NA,8714,11503,19145,24669,17096,18819,26086,26802,8382,7316,6941,2133
"3189","Lambeth 030E","E01003154","E02000647","Lambeth 030","E09000022","Lambeth","E12000007","London",1839,1836,3,98.2,786,2.3,"00AY","Lambeth",NA,5772,4324,4141,16703,7655,5719,6439,18461,1883,1395,2298,1758
"3184","Lambeth 029E","E01003155","E02000646","Lambeth 029","E09000022","Lambeth","E12000007","London",1796,1743,53,108.8,750,2.3,"00AY","Lambeth",NA,9014,12030,11923,20302,14427,16736,19140,27351,5413,4706,7217,7049
"3150","Lambeth 023B","E01003156","E02000640","Lambeth 023","E09000022","Lambeth","E12000007","London",1555,1555,0,133.1,665,2.3,"00AY","Lambeth",NA,9724,9907,11023,22218,14596,13989,15407,29262,4872,4082,4384,7044
"3151","Lambeth 023C","E01003157","E02000640","Lambeth 023","E09000022","Lambeth","E12000007","London",1549,1549,0,92.4,577,2.7,"00AY","Lambeth",NA,13439,12607,16869,30070,19411,16742,22874,32405,5972,4135,6005,2335
"3152","Lambeth 023D","E01003158","E02000640","Lambeth 023","E09000022","Lambeth","E12000007","London",1596,1596,0,128.6,737,2.2,"00AY","Lambeth",NA,18025,23560,24904,30431,26757,30522,30263,30788,8732,6962,5359,357
"3146","Lambeth 022C","E01003159","E02000639","Lambeth 022","E09000022","Lambeth","E12000007","London",1473,1473,0,101.7,599,2.5,"00AY","Lambeth",NA,2953,3759,6423,17684,5965,5805,6077,16449,3012,2046,-346,-1235
"3147","Lambeth 022D","E01003160","E02000639","Lambeth 022","E09000022","Lambeth","E12000007","London",1462,1462,0,144.8,558,2.6,"00AY","Lambeth",NA,4421,2908,7341,15475,5071,3871,7985,10583,650,963,644,-4892
"3153","Lambeth 023E","E01003161","E02000640","Lambeth 023","E09000022","Lambeth","E12000007","London",1250,1237,13,105.1,498,2.5,"00AY","Lambeth",NA,10951,8705,20372,17098,13200,9465,19942,20826,2249,760,-430,3728
"3148","Lambeth 022E","E01003162","E02000639","Lambeth 022","E09000022","Lambeth","E12000007","London",2126,2126,0,194.5,830,2.6,"00AY","Lambeth",NA,2996,1062,5563,14492,6049,5103,8557,10087,3053,4041,2994,-4405
"3154","Lambeth 023F","E01003163","E02000640","Lambeth 023","E09000022","Lambeth","E12000007","London",1515,1515,0,75.7,588,2.6,"00AY","Lambeth",NA,9516,9539,10920,25656,16992,14733,20608,29731,7476,5194,9688,4075
"3160","Lambeth 025A","E01003164","E02000642","Lambeth 025","E09000022","Lambeth","E12000007","London",2120,2118,2,116.8,935,2.3,"00AY","Lambeth",NA,6783,7426,9775,19604,8428,10518,13694,19853,1645,3092,3919,249
"3161","Lambeth 025B","E01003165","E02000642","Lambeth 025","E09000022","Lambeth","E12000007","London",1610,1610,0,87.9,712,2.3,"00AY","Lambeth",NA,9686,9890,14861,20424,12363,9096,13911,24408,2677,-794,-950,3984
"3178","Lambeth 028D","E01003166","E02000645","Lambeth 028","E09000022","Lambeth","E12000007","London",2290,2279,11,99,1020,2.2,"00AY","Lambeth",NA,9717,11825,12031,27234,12962,13336,17579,22548,3245,1511,5548,-4686
"3179","Lambeth 028E","E01003167","E02000645","Lambeth 028","E09000022","Lambeth","E12000007","London",1723,1723,0,86.6,681,2.5,"00AY","Lambeth",NA,17070,18936,16347,31656,19987,23309,22014,31836,2917,4373,5667,180
"3162","Lambeth 025C","E01003168","E02000642","Lambeth 025","E09000022","Lambeth","E12000007","London",1584,1584,0,76.3,647,2.4,"00AY","Lambeth",NA,6629,5000,8277,7344,5185,3905,5164,12331,-1444,-1095,-3113,4987
"3163","Lambeth 025D","E01003169","E02000642","Lambeth 025","E09000022","Lambeth","E12000007","London",2455,2446,9,129.1,1071,2.3,"00AY","Lambeth",NA,9496,9515,11015,22869,11026,10156,12000,25795,1530,641,985,2926
"3164","Lambeth 025E","E01003170","E02000642","Lambeth 025","E09000022","Lambeth","E12000007","London",1859,1859,0,57.8,797,2.3,"00AY","Lambeth",NA,18493,18795,23155,30320,22093,20988,26115,32174,3600,2193,2960,1854
"3135","Lambeth 020B","E01003171","E02000637","Lambeth 020","E09000022","Lambeth","E12000007","London",1745,1740,5,167.3,827,2.1,"00AY","Lambeth",NA,6822,9417,8322,19531,9067,8916,12475,21763,2245,-501,4153,2232
"3156","Lambeth 024B","E01003172","E02000641","Lambeth 024","E09000022","Lambeth","E12000007","London",1949,1922,27,159.9,815,2.4,"00AY","Lambeth",NA,5346,3748,5417,13826,6870,5041,6888,14549,1524,1293,1471,723
"3136","Lambeth 020C","E01003173","E02000637","Lambeth 020","E09000022","Lambeth","E12000007","London",1610,1610,0,128.5,694,2.3,"00AY","Lambeth",NA,12791,15080,16389,21710,15714,17938,21129,29751,2923,2858,4740,8041
"3157","Lambeth 024C","E01003174","E02000641","Lambeth 024","E09000022","Lambeth","E12000007","London",2045,2045,0,134.9,829,2.5,"00AY","Lambeth",NA,2445,578,4474,12707,4993,2397,6658,12610,2548,1819,2184,-97
"3158","Lambeth 024D","E01003175","E02000641","Lambeth 024","E09000022","Lambeth","E12000007","London",1610,1610,0,132.7,608,2.6,"00AY","Lambeth",NA,4616,2067,4300,14717,4312,4599,4099,10261,-304,2532,-201,-4456
"3119","Lambeth 016E","E01003176","E02000633","Lambeth 016","E09000022","Lambeth","E12000007","London",1906,1906,0,150,780,2.4,"00AY","Lambeth",NA,3045,3269,5517,18858,3818,3256,8238,16240,773,-13,2721,-2618
"3137","Lambeth 020D","E01003177","E02000637","Lambeth 020","E09000022","Lambeth","E12000007","London",1648,1648,0,169.5,703,2.3,"00AY","Lambeth",NA,6132,5407,6052,19951,8311,8972,13809,18723,2179,3565,7757,-1228
"3138","Lambeth 020E","E01003178","E02000637","Lambeth 020","E09000022","Lambeth","E12000007","London",1605,1576,29,149.3,712,2.2,"00AY","Lambeth",NA,5705,9922,6061,21090,12116,14373,16258,29357,6411,4451,10197,8267
"3159","Lambeth 024E","E01003179","E02000641","Lambeth 024","E09000022","Lambeth","E12000007","London",1653,1648,5,226.4,654,2.5,"00AY","Lambeth",NA,4911,1850,5092,17238,4371,3352,5681,10879,-540,1502,589,-6359
"3062","Lambeth 005D","E01003180","E02000622","Lambeth 005","E09000022","Lambeth","E12000007","London",1506,1471,35,107.1,662,2.2,"00AY","Lambeth",NA,5496,5773,6246,15324,7104,7057,7829,16891,1608,1284,1583,1567
"3069","Lambeth 007A","E01003181","E02000624","Lambeth 007","E09000022","Lambeth","E12000007","London",1472,1449,23,181.1,644,2.3,"00AY","Lambeth",NA,3936,5012,6272,14171,4550,4667,6841,17110,614,-345,569,2939
"3082","Lambeth 009D","E01003182","E02000626","Lambeth 009","E09000022","Lambeth","E12000007","London",1822,1804,18,100.9,720,2.5,"00AY","Lambeth",NA,4853,4684,3736,19705,7266,6416,8173,18268,2413,1732,4437,-1437
"3063","Lambeth 005E","E01003183","E02000622","Lambeth 005","E09000022","Lambeth","E12000007","London",1498,1498,0,98.7,631,2.4,"00AY","Lambeth",NA,3452,2680,3714,14910,5329,5169,6225,19369,1877,2489,2511,4459
"3070","Lambeth 007B","E01003184","E02000624","Lambeth 007","E09000022","Lambeth","E12000007","London",1414,1414,0,253.9,586,2.4,"00AY","Lambeth",NA,2354,1490,2955,14522,2785,1044,3272,13561,431,-446,317,-961
"3071","Lambeth 007C","E01003185","E02000624","Lambeth 007","E09000022","Lambeth","E12000007","London",1655,1645,10,188.1,768,2.1,"00AY","Lambeth",NA,5412,5674,7689,20749,7517,7887,11967,17962,2105,2213,4278,-2787
"3072","Lambeth 007D","E01003186","E02000624","Lambeth 007","E09000022","Lambeth","E12000007","London",1948,1939,9,93.4,876,2.2,"00AY","Lambeth",NA,6757,9601,11042,25601,10697,12076,15473,29058,3940,2475,4431,3457
"3073","Lambeth 007E","E01003187","E02000624","Lambeth 007","E09000022","Lambeth","E12000007","London",1487,1486,1,104.9,626,2.4,"00AY","Lambeth",NA,1681,1042,1368,15315,3904,3690,4710,17005,2223,2648,3342,1690
"3083","Lambeth 009E","E01003188","E02000626","Lambeth 009","E09000022","Lambeth","E12000007","London",1341,1336,5,165.6,554,2.4,"00AY","Lambeth",NA,3118,2483,2512,14921,3018,2484,3087,15080,-100,1,575,159
"3366","Lewisham 034A","E01003189","E02000686","Lewisham 034","E09000023","Lewisham","E12000007","London",1670,1662,8,87.4,624,2.7,"00AZ","Lewisham",NA,4956,3049,5951,4640,4810,3582,5251,6213,-146,533,-700,1573
"3367","Lewisham 034B","E01003190","E02000686","Lewisham 034","E09000023","Lewisham","E12000007","London",1878,1877,1,57.6,809,2.3,"00AZ","Lewisham",NA,5574,4052,7356,10854,5686,4952,7305,15846,112,900,-51,4992
"3368","Lewisham 034C","E01003191","E02000686","Lewisham 034","E09000023","Lewisham","E12000007","London",1494,1494,0,75.6,665,2.2,"00AZ","Lewisham",NA,5557,4411,8858,7633,5909,4676,6635,6267,352,265,-2223,-1366
"3369","Lewisham 034D","E01003192","E02000686","Lewisham 034","E09000023","Lewisham","E12000007","London",1639,1639,0,16.1,741,2.2,"00AZ","Lewisham",NA,1707,2230,1910,6402,2090,2295,2501,5795,383,65,591,-607
"3347","Lewisham 029A","E01003193","E02000681","Lewisham 029","E09000023","Lewisham","E12000007","London",1568,1568,0,45,666,2.4,"00AZ","Lewisham",NA,7736,8571,7390,11281,8288,7678,8242,14551,552,-893,852,3270
"3348","Lewisham 029B","E01003194","E02000681","Lewisham 029","E09000023","Lewisham","E12000007","London",1678,1678,0,50.9,716,2.3,"00AZ","Lewisham",NA,5259,5334,5104,13021,5776,5094,7820,10713,517,-240,2716,-2308
"3349","Lewisham 029C","E01003195","E02000681","Lewisham 029","E09000023","Lewisham","E12000007","London",1547,1547,0,78.9,637,2.4,"00AZ","Lewisham",NA,13764,14307,16830,19564,14879,11998,15623,22177,1115,-2309,-1207,2613
"3350","Lewisham 029D","E01003196","E02000681","Lewisham 029","E09000023","Lewisham","E12000007","London",1673,1673,0,62.6,624,2.7,"00AZ","Lewisham",NA,3888,3636,7585,4543,4301,5070,5939,5694,413,1434,-1646,1151
"3351","Lewisham 029E","E01003197","E02000681","Lewisham 029","E09000023","Lewisham","E12000007","London",1628,1628,0,76.6,625,2.6,"00AZ","Lewisham",NA,5245,3157,4213,6066,3736,2330,4025,4787,-1509,-827,-188,-1279
"3256","Lewisham 009A","E01003198","E02000661","Lewisham 009","E09000023","Lewisham","E12000007","London",1461,1406,55,86.3,639,2.2,"00AZ","Lewisham",NA,10079,9575,14161,18186,13542,11811,13727,18304,3463,2236,-434,118
"3246","Lewisham 007A","E01003199","E02000659","Lewisham 007","E09000023","Lewisham","E12000007","London",1728,1715,13,54.6,801,2.1,"00AZ","Lewisham",NA,13718,14415,22041,24843,19770,19086,24093,26106,6052,4671,2052,1263
"3257","Lewisham 009B","E01003200","E02000661","Lewisham 009","E09000023","Lewisham","E12000007","London",1553,1553,0,21,756,2.1,"00AZ","Lewisham",NA,13960,20216,23500,25552,21847,25078,30084,25836,7887,4862,6584,284
"3247","Lewisham 007B","E01003201","E02000659","Lewisham 007","E09000023","Lewisham","E12000007","London",1664,1626,38,106.3,680,2.4,"00AZ","Lewisham",NA,6785,7523,7786,19516,8115,9396,8357,21728,1330,1873,571,2212
"3258","Lewisham 009C","E01003202","E02000661","Lewisham 009","E09000023","Lewisham","E12000007","London",1559,1559,0,67.5,764,2,"00AZ","Lewisham",NA,20337,24484,27180,29742,27371,28498,32188,32187,7034,4014,5008,2445
"3259","Lewisham 009D","E01003203","E02000661","Lewisham 009","E09000023","Lewisham","E12000007","London",1769,1757,12,119.4,980,1.8,"00AZ","Lewisham",NA,6133,6281,8652,15944,10726,8817,13741,21423,4593,2536,5089,5479
"3248","Lewisham 007C","E01003204","E02000659","Lewisham 007","E09000023","Lewisham","E12000007","London",1391,1370,21,54.1,603,2.3,"00AZ","Lewisham",NA,8754,6340,11325,17520,12197,11373,15501,19938,3443,5033,4176,2418
"3249","Lewisham 007D","E01003205","E02000659","Lewisham 007","E09000023","Lewisham","E12000007","London",1332,1332,0,148,502,2.7,"00AZ","Lewisham",NA,3578,1165,4346,8713,3469,2090,4550,8043,-109,925,204,-670
"3250","Lewisham 007E","E01003206","E02000659","Lewisham 007","E09000023","Lewisham","E12000007","London",1582,1568,14,77,698,2.2,"00AZ","Lewisham",NA,12358,14630,14260,26052,20561,20591,23817,29269,8203,5961,9557,3217
"3236","Lewisham 005A","E01003207","E02000657","Lewisham 005","E09000023","Lewisham","E12000007","London",1399,1399,0,115.7,615,2.3,"00AZ","Lewisham",NA,5799,4580,6482,11695,3054,3507,4342,13635,-2745,-1073,-2140,1940
"3237","Lewisham 005B","E01003209","E02000657","Lewisham 005","E09000023","Lewisham","E12000007","London",2007,1868,139,158.4,778,2.4,"00AZ","Lewisham",NA,6530,5317,5991,20042,8064,8576,12351,23160,1534,3259,6360,3118
"3238","Lewisham 005C","E01003210","E02000657","Lewisham 005","E09000023","Lewisham","E12000007","London",1746,1727,19,92.6,850,2,"00AZ","Lewisham",NA,7662,10527,11105,15467,11165,13155,15238,27021,3503,2628,4133,11554
"3251","Lewisham 008B","E01003211","E02000660","Lewisham 008","E09000023","Lewisham","E12000007","London",1566,1554,12,77.8,753,2.1,"00AZ","Lewisham",NA,10137,13076,12509,22705,11246,11665,14177,21956,1109,-1411,1668,-749
"3239","Lewisham 005D","E01003212","E02000657","Lewisham 005","E09000023","Lewisham","E12000007","London",1976,1976,0,87.8,867,2.3,"00AZ","Lewisham",NA,8044,9932,9587,17641,10543,13116,15236,24371,2499,3184,5649,6730
"3252","Lewisham 008C","E01003213","E02000660","Lewisham 008","E09000023","Lewisham","E12000007","London",1938,1834,104,90.4,813,2.3,"00AZ","Lewisham",NA,8685,8104,10877,23265,12800,13728,16942,25668,4115,5624,6065,2403
"3253","Lewisham 008D","E01003214","E02000660","Lewisham 008","E09000023","Lewisham","E12000007","London",1772,1755,17,113.2,745,2.4,"00AZ","Lewisham",NA,6251,6923,6704,17627,8513,9251,10644,22807,2262,2328,3940,5180
"3240","Lewisham 005E","E01003215","E02000657","Lewisham 005","E09000023","Lewisham","E12000007","London",1950,1596,354,91.7,666,2.4,"00AZ","Lewisham",NA,8290,10064,12217,18809,9489,15343,22752,14405,1199,5279,10535,-4404
"3330","Lewisham 025A","E01003216","E02000677","Lewisham 025","E09000023","Lewisham","E12000007","London",1875,1824,51,88.6,689,2.6,"00AZ","Lewisham",NA,10340,11646,7455,24538,11192,11681,10469,21061,852,35,3014,-3477
"3315","Lewisham 022A","E01003217","E02000674","Lewisham 022","E09000023","Lewisham","E12000007","London",1670,1667,3,103.9,622,2.7,"00AZ","Lewisham",NA,13616,13868,16571,16182,15307,10598,16798,20769,1691,-3270,227,4587
"3316","Lewisham 022B","E01003218","E02000674","Lewisham 022","E09000023","Lewisham","E12000007","London",1498,1498,0,105.3,539,2.8,"00AZ","Lewisham",NA,16087,14909,16130,21247,20724,14713,20612,26265,4637,-196,4482,5018
"3331","Lewisham 025B","E01003219","E02000677","Lewisham 025","E09000023","Lewisham","E12000007","London",1647,1647,0,78.6,631,2.6,"00AZ","Lewisham",NA,15188,15126,14501,19691,17728,13983,14369,22945,2540,-1143,-132,3254
"3317","Lewisham 022C","E01003220","E02000674","Lewisham 022","E09000023","Lewisham","E12000007","London",1554,1499,55,86.5,604,2.5,"00AZ","Lewisham",NA,10540,10198,8986,22051,10401,8797,10932,21039,-139,-1401,1946,-1012
"3332","Lewisham 025C","E01003221","E02000677","Lewisham 025","E09000023","Lewisham","E12000007","London",1962,1917,45,58.8,769,2.5,"00AZ","Lewisham",NA,9452,10584,11943,18672,7438,8346,8109,20263,-2014,-2238,-3834,1591
"3318","Lewisham 022D","E01003222","E02000674","Lewisham 022","E09000023","Lewisham","E12000007","London",1632,1632,0,89.2,629,2.6,"00AZ","Lewisham",NA,14518,14296,15122,21186,14360,11035,14546,19094,-158,-3261,-576,-2092
"3333","Lewisham 025D","E01003223","E02000677","Lewisham 025","E09000023","Lewisham","E12000007","London",1715,1715,0,58.1,603,2.8,"00AZ","Lewisham",NA,17295,19355,18404,25227,17120,16466,18575,23302,-175,-2889,171,-1925
"3319","Lewisham 022E","E01003224","E02000674","Lewisham 022","E09000023","Lewisham","E12000007","London",1661,1648,13,109.2,626,2.6,"00AZ","Lewisham",NA,11663,11413,13556,14708,13696,12673,11623,16409,2033,1260,-1933,1701
"3283","Lewisham 015A","E01003225","E02000667","Lewisham 015","E09000023","Lewisham","E12000007","London",1507,1507,0,70.8,590,2.6,"00AZ","Lewisham",NA,15802,15986,19465,25165,23514,20160,22610,27511,7712,4174,3145,2346
"3300","Lewisham 019A","E01003226","E02000671","Lewisham 019","E09000023","Lewisham","E12000007","London",1742,1742,0,96.2,709,2.5,"00AZ","Lewisham",NA,11937,14135,15757,24058,17094,14938,18452,23089,5157,803,2695,-969
"3301","Lewisham 019B","E01003227","E02000671","Lewisham 019","E09000023","Lewisham","E12000007","London",1658,1658,0,67.2,678,2.4,"00AZ","Lewisham",NA,14100,14139,16879,22362,19403,17690,22877,26696,5303,3551,5998,4334
"3302","Lewisham 019C","E01003228","E02000671","Lewisham 019","E09000023","Lewisham","E12000007","London",1512,1487,25,106.3,673,2.2,"00AZ","Lewisham",NA,11950,14469,12720,19801,17277,16767,19291,28526,5327,2298,6571,8725
"3303","Lewisham 019D","E01003229","E02000671","Lewisham 019","E09000023","Lewisham","E12000007","London",1558,1555,3,72.9,742,2.1,"00AZ","Lewisham",NA,6569,6391,6998,13236,5448,4540,5034,12062,-1121,-1851,-1964,-1174
"3304","Lewisham 019E","E01003230","E02000671","Lewisham 019","E09000023","Lewisham","E12000007","London",1933,1933,0,91.7,866,2.2,"00AZ","Lewisham",NA,7205,6270,5068,19059,10406,8127,9099,15970,3201,1857,4031,-3089
"3284","Lewisham 015B","E01003231","E02000667","Lewisham 015","E09000023","Lewisham","E12000007","London",1606,1603,3,92.9,687,2.3,"00AZ","Lewisham",NA,10189,10267,9893,22107,10958,11711,13050,21046,769,1444,3157,-1061
"3285","Lewisham 015C","E01003232","E02000667","Lewisham 015","E09000023","Lewisham","E12000007","London",1719,1714,5,84.5,649,2.6,"00AZ","Lewisham",NA,14010,16340,17173,21537,19188,17618,17186,26211,5178,1278,13,4674
"3286","Lewisham 015D","E01003233","E02000667","Lewisham 015","E09000023","Lewisham","E12000007","London",1702,1702,0,123.2,669,2.5,"00AZ","Lewisham",NA,11972,12329,13070,17027,14736,12369,15857,20366,2764,40,2787,3339
"3380","Lewisham 038A","E01003235","E02006784","Lewisham 038","E09000023","Lewisham","E12000007","London",1279,1279,0,26.2,523,2.4,"00AZ","Lewisham",NA,10304,8560,12663,13496,8168,7154,8349,14754,-2136,-1406,-4314,1258
"3375","Lewisham 037A","E01003236","E02006783","Lewisham 037","E09000023","Lewisham","E12000007","London",1590,1590,0,89.9,648,2.5,"00AZ","Lewisham",NA,5057,3754,7163,4731,4576,4553,5176,7699,-481,799,-1987,2968
"3376","Lewisham 037B","E01003237","E02006783","Lewisham 037","E09000023","Lewisham","E12000007","London",1471,1471,0,56.7,608,2.4,"00AZ","Lewisham",NA,4392,3277,5936,3330,5863,4624,5377,8299,1471,1347,-559,4969
"3377","Lewisham 037C","E01003238","E02006783","Lewisham 037","E09000023","Lewisham","E12000007","London",1407,1407,0,108.5,565,2.5,"00AZ","Lewisham",NA,6571,4683,7796,5024,5583,4072,5637,8172,-988,-611,-2159,3148
"3378","Lewisham 037D","E01003239","E02006783","Lewisham 037","E09000023","Lewisham","E12000007","London",1428,1428,0,65,564,2.5,"00AZ","Lewisham",NA,7038,5936,9549,5026,5093,3777,6684,8098,-1945,-2159,-2865,3072
"3381","Lewisham 038B","E01003240","E02006784","Lewisham 038","E09000023","Lewisham","E12000007","London",1789,1788,1,85.6,725,2.5,"00AZ","Lewisham",NA,4100,3667,5956,6907,4534,3649,6463,11434,434,-18,507,4527
"3382","Lewisham 038C","E01003241","E02006784","Lewisham 038","E09000023","Lewisham","E12000007","London",1541,1541,0,54.1,695,2.2,"00AZ","Lewisham",NA,3890,4279,2900,10826,6552,7004,5856,13249,2662,2725,2956,2423
"3383","Lewisham 038D","E01003243","E02006784","Lewisham 038","E09000023","Lewisham","E12000007","London",1358,1358,0,55.6,581,2.3,"00AZ","Lewisham",NA,5983,6082,9833,5251,3927,3740,6553,7696,-2056,-2342,-3280,2445
"3221","Lewisham 001A","E01003244","E02000653","Lewisham 001","E09000023","Lewisham","E12000007","London",1629,1629,0,243.1,618,2.6,"00AZ","Lewisham",NA,4097,2188,4756,9356,7322,4026,7385,16971,3225,1838,2629,7615
"3222","Lewisham 001B","E01003245","E02000653","Lewisham 001","E09000023","Lewisham","E12000007","London",1559,1559,0,141.6,584,2.7,"00AZ","Lewisham",NA,1165,230,5761,7631,2696,1636,5061,11348,1531,1406,-700,3717
"3226","Lewisham 002A","E01003246","E02000654","Lewisham 002","E09000023","Lewisham","E12000007","London",1439,1438,1,59.6,559,2.6,"00AZ","Lewisham",NA,3078,2419,4193,12179,2165,770,3981,17614,-913,-1649,-212,5435
"3223","Lewisham 001C","E01003247","E02000653","Lewisham 001","E09000023","Lewisham","E12000007","London",1673,1673,0,84.6,685,2.4,"00AZ","Lewisham",NA,10212,11086,15411,14005,13224,15945,21067,25220,3012,4859,5656,11215
"3227","Lewisham 002B","E01003248","E02000654","Lewisham 002","E09000023","Lewisham","E12000007","London",1622,1619,3,63.6,718,2.3,"00AZ","Lewisham",NA,6362,3346,10267,12748,4928,3440,9135,15685,-1434,94,-1132,2937
"3224","Lewisham 001D","E01003249","E02000653","Lewisham 001","E09000023","Lewisham","E12000007","London",1928,1909,19,172.9,897,2.1,"00AZ","Lewisham",NA,4737,1878,6546,12402,11098,6644,11375,25902,6361,4766,4829,13500
"3225","Lewisham 001E","E01003250","E02000653","Lewisham 001","E09000023","Lewisham","E12000007","London",1755,1755,0,92.4,763,2.3,"00AZ","Lewisham",NA,5561,3958,7062,11879,7020,6077,10198,20968,1459,2119,3136,9089
"3228","Lewisham 002C","E01003251","E02000654","Lewisham 002","E09000023","Lewisham","E12000007","London",2003,2003,0,87.3,777,2.6,"00AZ","Lewisham",NA,3264,1154,5347,8623,7222,6309,9774,12341,3958,5155,4427,3718
"3229","Lewisham 002D","E01003252","E02000654","Lewisham 002","E09000023","Lewisham","E12000007","London",1557,1557,0,217.5,613,2.5,"00AZ","Lewisham",NA,3075,1128,5100,9778,2509,918,2786,11351,-566,-210,-2314,1573
"3230","Lewisham 002E","E01003253","E02000654","Lewisham 002","E09000023","Lewisham","E12000007","London",1438,1438,0,97,669,2.1,"00AZ","Lewisham",NA,3960,4418,4692,13135,4551,4929,5666,13740,591,511,974,605
"3310","Lewisham 021A","E01003254","E02000673","Lewisham 021","E09000023","Lewisham","E12000007","London",1437,1418,19,44.5,602,2.4,"00AZ","Lewisham",NA,14882,18760,18923,30021,19296,22447,24173,29148,4414,3687,5250,-873
"3311","Lewisham 021B","E01003255","E02000673","Lewisham 021","E09000023","Lewisham","E12000007","London",1886,1886,0,104.3,964,2,"00AZ","Lewisham",NA,9176,11513,11355,22642,12855,13874,17746,25277,3679,2361,6391,2635
"3343","Lewisham 028A","E01003256","E02000680","Lewisham 028","E09000023","Lewisham","E12000007","London",2055,2055,0,92.4,931,2.2,"00AZ","Lewisham",NA,6120,5869,6785,19065,5903,7200,6929,17197,-217,1331,144,-1868
"3344","Lewisham 028B","E01003257","E02000680","Lewisham 028","E09000023","Lewisham","E12000007","London",1678,1607,71,77,735,2.2,"00AZ","Lewisham",NA,7239,6854,7763,17758,10205,9120,11803,20618,2966,2266,4040,2860
"3345","Lewisham 028C","E01003258","E02000680","Lewisham 028","E09000023","Lewisham","E12000007","London",1499,1477,22,124.7,594,2.5,"00AZ","Lewisham",NA,5281,1665,6179,13154,5260,3300,5965,14347,-21,1635,-214,1193
"3346","Lewisham 028D","E01003259","E02000680","Lewisham 028","E09000023","Lewisham","E12000007","London",1615,1611,4,78.1,756,2.1,"00AZ","Lewisham",NA,10197,9454,13617,22283,11864,12130,14781,27258,1667,2676,1164,4975
"3312","Lewisham 021C","E01003260","E02000673","Lewisham 021","E09000023","Lewisham","E12000007","London",1824,1824,0,84.8,681,2.7,"00AZ","Lewisham",NA,13428,15717,13985,26026,13941,15550,11903,22773,513,-167,-2082,-3253
"3313","Lewisham 021D","E01003261","E02000673","Lewisham 021","E09000023","Lewisham","E12000007","London",1495,1495,0,82.7,619,2.4,"00AZ","Lewisham",NA,11243,13312,12468,19875,16935,14585,15150,29287,5692,1273,2682,9412
"3314","Lewisham 021E","E01003262","E02000673","Lewisham 021","E09000023","Lewisham","E12000007","London",1365,1365,0,84.8,624,2.2,"00AZ","Lewisham",NA,10245,9909,13943,17557,15929,17141,17426,20518,5684,7232,3483,2961
"3320","Lewisham 023A","E01003263","E02000675","Lewisham 023","E09000023","Lewisham","E12000007","London",1675,1642,33,47.5,739,2.2,"00AZ","Lewisham",NA,7525,7090,9384,14109,7303,5906,8260,15488,-222,-1184,-1124,1379
"3357","Lewisham 031A","E01003264","E02000683","Lewisham 031","E09000023","Lewisham","E12000007","London",1610,1610,0,70.9,728,2.2,"00AZ","Lewisham",NA,11610,9793,12802,18046,9581,8537,10195,11679,-2029,-1256,-2607,-6367
"3358","Lewisham 031B","E01003265","E02000683","Lewisham 031","E09000023","Lewisham","E12000007","London",1531,1531,0,66.4,680,2.3,"00AZ","Lewisham",NA,7453,6336,10493,6116,5870,5162,6863,11231,-1583,-1174,-3630,5115
"3359","Lewisham 031C","E01003266","E02000683","Lewisham 031","E09000023","Lewisham","E12000007","London",1735,1734,1,101.5,757,2.3,"00AZ","Lewisham",NA,4866,3501,4880,5857,4205,3956,3388,9512,-661,455,-1492,3655
"3360","Lewisham 031D","E01003267","E02000683","Lewisham 031","E09000023","Lewisham","E12000007","London",1568,1568,0,47.5,598,2.6,"00AZ","Lewisham",NA,6312,4827,7068,6166,6108,5243,4921,9291,-204,416,-2147,3125
"3321","Lewisham 023B","E01003268","E02000675","Lewisham 023","E09000023","Lewisham","E12000007","London",1670,1664,6,56.9,718,2.3,"00AZ","Lewisham",NA,12191,12707,12589,21121,11351,11592,13121,24159,-840,-1115,532,3038
"3322","Lewisham 023C","E01003269","E02000675","Lewisham 023","E09000023","Lewisham","E12000007","London",1554,1554,0,73.5,647,2.4,"00AZ","Lewisham",NA,6723,7243,8429,16735,8569,7415,9448,11926,1846,172,1019,-4809
"3323","Lewisham 023D","E01003270","E02000675","Lewisham 023","E09000023","Lewisham","E12000007","London",1638,1638,0,58.1,678,2.4,"00AZ","Lewisham",NA,19263,20661,20710,21995,20799,21193,22142,24118,1536,532,1432,2123
"3324","Lewisham 023E","E01003271","E02000675","Lewisham 023","E09000023","Lewisham","E12000007","London",1667,1667,0,56.7,637,2.6,"00AZ","Lewisham",NA,19581,21453,22222,21512,27504,26074,28325,24654,7923,4621,6103,3142
"3279","Lewisham 014A","E01003272","E02000666","Lewisham 014","E09000023","Lewisham","E12000007","London",1966,1959,7,132.3,798,2.5,"00AZ","Lewisham",NA,9633,11269,8690,25795,16840,15293,19293,29882,7207,4024,10603,4087
"3265","Lewisham 011A","E01003273","E02000663","Lewisham 011","E09000023","Lewisham","E12000007","London",2000,2000,0,108,666,3,"00AZ","Lewisham",NA,13040,10944,13547,25182,17016,17062,24773,15294,3976,6118,11226,-9888
"3280","Lewisham 014B","E01003274","E02000666","Lewisham 014","E09000023","Lewisham","E12000007","London",1724,1717,7,117.7,721,2.4,"00AZ","Lewisham",NA,13803,13227,17710,22399,15492,12746,16472,25481,1689,-481,-1238,3082
"3281","Lewisham 014C","E01003275","E02000666","Lewisham 014","E09000023","Lewisham","E12000007","London",1727,1640,87,88.8,640,2.6,"00AZ","Lewisham",NA,9023,6034,10090,12585,7180,4675,7641,14548,-1843,-1359,-2449,1963
"3282","Lewisham 014D","E01003276","E02000666","Lewisham 014","E09000023","Lewisham","E12000007","London",1904,1898,6,41.2,700,2.7,"00AZ","Lewisham",NA,12214,12606,13504,21299,13711,12566,13297,26172,1497,-40,-207,4873
"3266","Lewisham 011B","E01003277","E02000663","Lewisham 011","E09000023","Lewisham","E12000007","London",1714,1706,8,119.9,778,2.2,"00AZ","Lewisham",NA,10672,10710,10269,22185,11230,12165,10660,23734,558,1455,391,1549
"3267","Lewisham 011C","E01003278","E02000663","Lewisham 011","E09000023","Lewisham","E12000007","London",1887,1887,0,125.5,805,2.3,"00AZ","Lewisham",NA,10031,11139,14003,17683,11844,10408,15259,22294,1813,-731,1256,4611
"3268","Lewisham 011D","E01003279","E02000663","Lewisham 011","E09000023","Lewisham","E12000007","London",1593,1593,0,89.6,654,2.4,"00AZ","Lewisham",NA,14609,13654,14544,24031,16270,14073,16815,29555,1661,419,2271,5524
"3287","Lewisham 016A","E01003280","E02000668","Lewisham 016","E09000023","Lewisham","E12000007","London",1606,1596,10,80.7,651,2.5,"00AZ","Lewisham",NA,8159,6451,7862,15874,8838,8252,8512,12010,679,1801,650,-3864
"3288","Lewisham 016B","E01003281","E02000668","Lewisham 016","E09000023","Lewisham","E12000007","London",1534,1534,0,44.2,601,2.6,"00AZ","Lewisham",NA,13120,16551,12521,26032,17876,19251,17519,28459,4756,2700,4998,2427
"3275","Lewisham 013A","E01003282","E02000665","Lewisham 013","E09000023","Lewisham","E12000007","London",2418,2418,0,111.9,1047,2.3,"00AZ","Lewisham",NA,9011,10057,11691,16615,12669,12407,14688,17551,3658,2350,2997,936
"3276","Lewisham 013B","E01003283","E02000665","Lewisham 013","E09000023","Lewisham","E12000007","London",2108,2108,0,90.2,923,2.3,"00AZ","Lewisham",NA,18369,19446,22746,29765,21495,22928,25570,32028,3126,3482,2824,2263
"3277","Lewisham 013C","E01003284","E02000665","Lewisham 013","E09000023","Lewisham","E12000007","London",1757,1748,9,109.6,748,2.3,"00AZ","Lewisham",NA,10875,10533,11170,18969,14531,13418,14669,19600,3656,2885,3499,631
"3289","Lewisham 016C","E01003285","E02000668","Lewisham 016","E09000023","Lewisham","E12000007","London",1608,1608,0,73.2,767,2.1,"00AZ","Lewisham",NA,16422,17972,19798,28609,16925,16547,20785,26726,503,-1425,987,-1883
"3278","Lewisham 013D","E01003286","E02000665","Lewisham 013","E09000023","Lewisham","E12000007","London",1633,1633,0,85.9,786,2.1,"00AZ","Lewisham",NA,7652,6046,7686,15540,7992,6415,8110,19808,340,369,424,4268
"3290","Lewisham 016D","E01003287","E02000668","Lewisham 016","E09000023","Lewisham","E12000007","London",1909,1909,0,78.6,797,2.4,"00AZ","Lewisham",NA,15759,18593,13993,27888,20821,21264,19535,30706,5062,2671,5542,2818
"3269","Lewisham 012A","E01003288","E02000664","Lewisham 012","E09000023","Lewisham","E12000007","London",1810,1767,43,106.2,794,2.2,"00AZ","Lewisham",NA,5153,5512,6136,16734,5875,4519,6592,19865,722,-993,456,3131
"3270","Lewisham 012C","E01003290","E02000664","Lewisham 012","E09000023","Lewisham","E12000007","London",1730,1701,29,120.1,725,2.3,"00AZ","Lewisham",NA,2795,4206,2140,10289,3647,3329,3979,17815,852,-877,1839,7526
"3271","Lewisham 012D","E01003291","E02000664","Lewisham 012","E09000023","Lewisham","E12000007","London",1512,1478,34,53.5,682,2.2,"00AZ","Lewisham",NA,2608,1492,2449,10684,1483,1014,1484,7608,-1125,-478,-965,-3076
"3291","Lewisham 017A","E01003292","E02000669","Lewisham 017","E09000023","Lewisham","E12000007","London",1565,1565,0,117.6,702,2.2,"00AZ","Lewisham",NA,12654,13679,15240,18889,13781,13417,15985,21934,1127,-262,745,3045
"3292","Lewisham 017B","E01003293","E02000669","Lewisham 017","E09000023","Lewisham","E12000007","London",1518,1515,3,136.6,676,2.2,"00AZ","Lewisham",NA,8096,10504,7544,17741,8320,7577,9128,20847,224,-2927,1584,3106
"3293","Lewisham 017D","E01003295","E02000669","Lewisham 017","E09000023","Lewisham","E12000007","London",1672,1622,50,92.1,653,2.5,"00AZ","Lewisham",NA,6808,7357,7130,16708,8695,8401,8558,16136,1887,1044,1428,-572
"3272","Lewisham 012E","E01003296","E02000664","Lewisham 012","E09000023","Lewisham","E12000007","London",2046,2046,0,56.3,1021,2,"00AZ","Lewisham",NA,6144,7626,16054,11884,8101,10390,17174,20064,1957,2764,1120,8180
"3231","Lewisham 003A","E01003297","E02000655","Lewisham 003","E09000023","Lewisham","E12000007","London",1538,1538,0,41.3,767,2,"00AZ","Lewisham",NA,6494,9374,12782,17344,4967,13289,13820,18066,-1527,3915,1038,722
"3385","Lewisham 039A","E01003298","E02006798","Lewisham 039","E09000023","Lewisham","E12000007","London",1292,1292,0,94.4,475,2.7,"00AZ","Lewisham",NA,4679,3305,5884,14444,4994,3892,6779,20056,315,587,895,5612
"3232","Lewisham 003B","E01003299","E02000655","Lewisham 003","E09000023","Lewisham","E12000007","London",1623,1623,0,107.3,609,2.7,"00AZ","Lewisham",NA,5170,4460,5187,13844,6232,7623,8313,15832,1062,3163,3126,1988
"3386","Lewisham 039B","E01003300","E02006798","Lewisham 039","E09000023","Lewisham","E12000007","London",1356,1356,0,114.6,561,2.4,"00AZ","Lewisham",NA,5208,3565,6290,9334,4178,3407,5153,11752,-1030,-158,-1137,2418
"3233","Lewisham 003C","E01003301","E02000655","Lewisham 003","E09000023","Lewisham","E12000007","London",2166,1936,230,100.7,767,2.5,"00AZ","Lewisham",NA,8876,8535,17366,16872,10675,12591,21623,23909,1799,4056,4257,7037
"3234","Lewisham 003D","E01003302","E02000655","Lewisham 003","E09000023","Lewisham","E12000007","London",1509,1509,0,119.9,710,2.1,"00AZ","Lewisham",NA,6216,5533,10538,14447,6084,4891,7609,16709,-132,-642,-2929,2262
"3387","Lewisham 039C","E01003303","E02006798","Lewisham 039","E09000023","Lewisham","E12000007","London",1550,1377,173,70.1,560,2.5,"00AZ","Lewisham",NA,6042,8135,9306,12984,3406,4986,8231,19191,-2636,-3149,-1075,6207
"3388","Lewisham 039D","E01003304","E02006798","Lewisham 039","E09000023","Lewisham","E12000007","London",1890,1890,0,111,903,2.1,"00AZ","Lewisham",NA,6112,7240,9700,15858,4141,5887,9275,13171,-1971,-1353,-425,-2687
"3235","Lewisham 003E","E01003305","E02000655","Lewisham 003","E09000023","Lewisham","E12000007","London",1372,1281,91,120.9,513,2.5,"00AZ","Lewisham",NA,2849,2277,3521,12234,4761,5240,7033,13719,1912,2963,3512,1485
"3325","Lewisham 024A","E01003307","E02000676","Lewisham 024","E09000023","Lewisham","E12000007","London",1521,1521,0,105.1,627,2.4,"00AZ","Lewisham",NA,14352,12197,15468,23718,14578,11174,15537,23063,226,-1023,69,-655
"3326","Lewisham 024B","E01003308","E02000676","Lewisham 024","E09000023","Lewisham","E12000007","London",1824,1808,16,115.7,734,2.5,"00AZ","Lewisham",NA,6620,9070,8882,19713,9960,8321,10800,23583,3340,-749,1918,3870
"3338","Lewisham 027A","E01003309","E02000679","Lewisham 027","E09000023","Lewisham","E12000007","London",1510,1483,27,95.2,645,2.3,"00AZ","Lewisham",NA,5012,3920,5537,16107,5977,4312,8105,10641,965,392,2568,-5466
"3339","Lewisham 027B","E01003310","E02000679","Lewisham 027","E09000023","Lewisham","E12000007","London",1559,1551,8,97.4,756,2.1,"00AZ","Lewisham",NA,3314,4105,3067,14161,5460,4351,6394,17161,2146,246,3327,3000
"3340","Lewisham 027C","E01003311","E02000679","Lewisham 027","E09000023","Lewisham","E12000007","London",1546,1543,3,82.6,605,2.6,"00AZ","Lewisham",NA,15742,17532,17935,23726,18190,17686,17431,27972,2448,154,-504,4246
"3341","Lewisham 027D","E01003312","E02000679","Lewisham 027","E09000023","Lewisham","E12000007","London",1760,1760,0,88.7,779,2.3,"00AZ","Lewisham",NA,11151,12563,12641,24834,13935,12723,15085,19692,2784,160,2444,-5142
"3342","Lewisham 027E","E01003313","E02000679","Lewisham 027","E09000023","Lewisham","E12000007","London",1530,1530,0,65.2,670,2.3,"00AZ","Lewisham",NA,5169,3221,8319,13347,3759,2953,5557,10280,-1410,-268,-2762,-3067
"3327","Lewisham 024C","E01003314","E02000676","Lewisham 024","E09000023","Lewisham","E12000007","London",1599,1596,3,103.1,683,2.3,"00AZ","Lewisham",NA,9700,9952,12688,23486,15717,13284,16148,25504,6017,3332,3460,2018
"3328","Lewisham 024D","E01003315","E02000676","Lewisham 024","E09000023","Lewisham","E12000007","London",1287,1287,0,89.5,599,2.1,"00AZ","Lewisham",NA,6770,7514,8777,20393,8947,8836,13111,14631,2177,1322,4334,-5762
"3329","Lewisham 024E","E01003316","E02000676","Lewisham 024","E09000023","Lewisham","E12000007","London",1482,1482,0,102.5,609,2.4,"00AZ","Lewisham",NA,8589,12954,13153,24097,15862,15738,21393,26822,7273,2784,8240,2725
"3305","Lewisham 020A","E01003317","E02000672","Lewisham 020","E09000023","Lewisham","E12000007","London",1882,1882,0,47.3,688,2.7,"00AZ","Lewisham",NA,8686,10616,11579,22108,10967,14778,13673,20676,2281,4162,2094,-1432
"3306","Lewisham 020B","E01003318","E02000672","Lewisham 020","E09000023","Lewisham","E12000007","London",1638,1513,125,46.4,705,2.1,"00AZ","Lewisham",NA,3381,8465,4301,13294,1866,4097,2752,15069,-1515,-4368,-1549,1775
"3296","Lewisham 018A","E01003319","E02000670","Lewisham 018","E09000023","Lewisham","E12000007","London",1831,1831,0,139.7,752,2.4,"00AZ","Lewisham",NA,8616,7454,11249,15134,7264,7949,8711,12956,-1352,495,-2538,-2178
"3297","Lewisham 018B","E01003320","E02000670","Lewisham 018","E09000023","Lewisham","E12000007","London",1494,1494,0,80,650,2.3,"00AZ","Lewisham",NA,6553,6153,6505,13766,5399,4315,7006,11361,-1154,-1838,501,-2405
"3307","Lewisham 020C","E01003321","E02000672","Lewisham 020","E09000023","Lewisham","E12000007","London",1961,1915,46,117.8,810,2.4,"00AZ","Lewisham",NA,2577,3966,2254,17575,6003,6271,6156,18207,3426,2305,3902,632
"3308","Lewisham 020D","E01003322","E02000672","Lewisham 020","E09000023","Lewisham","E12000007","London",1429,1429,0,96.6,593,2.4,"00AZ","Lewisham",NA,8627,9170,9702,15312,10744,10362,10607,22514,2117,1192,905,7202
"3298","Lewisham 018C","E01003323","E02000670","Lewisham 018","E09000023","Lewisham","E12000007","London",1485,1478,7,87.6,624,2.4,"00AZ","Lewisham",NA,8454,8923,6121,17314,5489,5526,5860,15121,-2965,-3397,-261,-2193
"3309","Lewisham 020E","E01003324","E02000672","Lewisham 020","E09000023","Lewisham","E12000007","London",1467,1467,0,157.2,713,2.1,"00AZ","Lewisham",NA,4065,5464,2705,16783,5049,6408,10540,15849,984,944,7835,-934
"3299","Lewisham 018D","E01003325","E02000670","Lewisham 018","E09000023","Lewisham","E12000007","London",1729,1719,10,129,722,2.4,"00AZ","Lewisham",NA,6679,6816,5854,15121,3786,5117,5610,15698,-2893,-1699,-244,577
"3370","Lewisham 035A","E01003326","E02000687","Lewisham 035","E09000023","Lewisham","E12000007","London",1475,1397,78,107.4,638,2.2,"00AZ","Lewisham",NA,9031,10003,10871,19497,11250,8456,13018,19957,2219,-1547,2147,460
"3371","Lewisham 035B","E01003327","E02000687","Lewisham 035","E09000023","Lewisham","E12000007","London",1796,1796,0,87.3,714,2.5,"00AZ","Lewisham",NA,11797,16913,16977,23036,16395,15839,20390,19791,4598,-1074,3413,-3245
"3372","Lewisham 035C","E01003328","E02000687","Lewisham 035","E09000023","Lewisham","E12000007","London",1718,1700,18,89.9,833,2,"00AZ","Lewisham",NA,8077,7674,8301,21508,9647,7735,9918,21167,1570,61,1617,-341
"3361","Lewisham 033A","E01003329","E02000685","Lewisham 033","E09000023","Lewisham","E12000007","London",1590,1590,0,90.2,666,2.4,"00AZ","Lewisham",NA,8947,7808,11459,14563,11535,9564,15554,21605,2588,1756,4095,7042
"3362","Lewisham 033B","E01003330","E02000685","Lewisham 033","E09000023","Lewisham","E12000007","London",1550,1550,0,59.8,662,2.3,"00AZ","Lewisham",NA,5164,4128,8296,9887,5310,5149,7818,17022,146,1021,-478,7135
"3363","Lewisham 033C","E01003331","E02000685","Lewisham 033","E09000023","Lewisham","E12000007","London",1412,1373,39,89.6,572,2.4,"00AZ","Lewisham",NA,8107,7037,6326,20142,8244,7310,7460,17966,137,273,1134,-2176
"3364","Lewisham 033D","E01003332","E02000685","Lewisham 033","E09000023","Lewisham","E12000007","London",1467,1467,0,71.8,679,2.2,"00AZ","Lewisham",NA,6773,5262,8514,12815,9854,8591,10462,17695,3081,3329,1948,4880
"3373","Lewisham 035D","E01003333","E02000687","Lewisham 035","E09000023","Lewisham","E12000007","London",1542,1542,0,122.7,657,2.3,"00AZ","Lewisham",NA,8392,11131,12153,14347,12250,11310,12525,15683,3858,179,372,1336
"3365","Lewisham 033E","E01003334","E02000685","Lewisham 033","E09000023","Lewisham","E12000007","London",1660,1604,56,97.8,778,2.1,"00AZ","Lewisham",NA,4984,4464,4669,17597,5658,5947,6177,15960,674,1483,1508,-1637
"3374","Lewisham 035E","E01003335","E02000687","Lewisham 035","E09000023","Lewisham","E12000007","London",1395,1393,2,119,594,2.3,"00AZ","Lewisham",NA,4403,2023,4435,12569,5342,3040,4495,12319,939,1017,60,-250
"3260","Lewisham 010A","E01003336","E02000662","Lewisham 010","E09000023","Lewisham","E12000007","London",1378,1378,0,109.4,577,2.4,"00AZ","Lewisham",NA,4176,2065,5422,6353,4450,2320,4055,17931,274,255,-1367,11578
"3261","Lewisham 010B","E01003337","E02000662","Lewisham 010","E09000023","Lewisham","E12000007","London",1636,1636,0,123.7,600,2.7,"00AZ","Lewisham",NA,4169,2630,4956,12913,5306,4007,4864,6353,1137,1377,-92,-6560
"3241","Lewisham 006A","E01003338","E02000658","Lewisham 006","E09000023","Lewisham","E12000007","London",1784,1772,12,126.9,771,2.3,"00AZ","Lewisham",NA,3359,2679,4468,10552,4349,3842,5550,12508,990,1163,1082,1956
"3242","Lewisham 006B","E01003339","E02000658","Lewisham 006","E09000023","Lewisham","E12000007","London",1760,1753,7,117.7,763,2.3,"00AZ","Lewisham",NA,5715,6256,8375,9907,8512,7869,9973,21621,2797,1613,1598,11714
"3243","Lewisham 006C","E01003340","E02000658","Lewisham 006","E09000023","Lewisham","E12000007","London",1906,1906,0,108.9,797,2.4,"00AZ","Lewisham",NA,9904,14038,14627,18293,15409,17729,21433,28766,5505,3691,6806,10473
"3244","Lewisham 006D","E01003341","E02000658","Lewisham 006","E09000023","Lewisham","E12000007","London",1508,1508,0,82.8,581,2.6,"00AZ","Lewisham",NA,11532,14969,14574,28569,14396,15057,16004,30196,2864,88,1430,1627
"3262","Lewisham 010C","E01003342","E02000662","Lewisham 010","E09000023","Lewisham","E12000007","London",1641,1634,7,100.4,702,2.3,"00AZ","Lewisham",NA,11362,12534,16117,19470,15116,10152,19130,28216,3754,-2382,3013,8746
"3245","Lewisham 006E","E01003343","E02000658","Lewisham 006","E09000023","Lewisham","E12000007","London",1356,1356,0,107,626,2.2,"00AZ","Lewisham",NA,9319,10320,10584,16509,11142,9752,10779,27850,1823,-568,195,11341
"3263","Lewisham 010D","E01003344","E02000662","Lewisham 010","E09000023","Lewisham","E12000007","London",1731,1731,0,92.2,719,2.4,"00AZ","Lewisham",NA,7916,6362,7342,18908,12656,11520,13504,22834,4740,5158,6162,3926
"3264","Lewisham 010E","E01003345","E02000662","Lewisham 010","E09000023","Lewisham","E12000007","London",1714,1714,0,106.9,719,2.4,"00AZ","Lewisham",NA,11531,11425,11773,21629,15983,14379,20963,25153,4452,2954,9190,3524
"3334","Lewisham 026A","E01003346","E02000678","Lewisham 026","E09000023","Lewisham","E12000007","London",1537,1537,0,44.4,598,2.6,"00AZ","Lewisham",NA,5862,5331,9662,6288,5103,5104,7875,8268,-759,-227,-1787,1980
"3352","Lewisham 030A","E01003347","E02000682","Lewisham 030","E09000023","Lewisham","E12000007","London",1735,1735,0,121.5,638,2.7,"00AZ","Lewisham",NA,3294,1247,3731,4646,2734,1029,2997,8900,-560,-218,-734,4254
"3353","Lewisham 030B","E01003348","E02000682","Lewisham 030","E09000023","Lewisham","E12000007","London",1459,1459,0,45.1,571,2.6,"00AZ","Lewisham",NA,7548,7118,7870,9609,8720,7366,8903,15869,1172,248,1033,6260
"3335","Lewisham 026B","E01003349","E02000678","Lewisham 026","E09000023","Lewisham","E12000007","London",1412,1412,0,102.8,541,2.6,"00AZ","Lewisham",NA,5651,4342,6039,3197,5114,4113,6530,5079,-537,-229,491,1882
"3354","Lewisham 030C","E01003350","E02000682","Lewisham 030","E09000023","Lewisham","E12000007","London",1412,1412,0,58.3,519,2.7,"00AZ","Lewisham",NA,6206,4899,8503,7848,4270,3334,5191,7279,-1936,-1565,-3312,-569
"3336","Lewisham 026C","E01003351","E02000678","Lewisham 026","E09000023","Lewisham","E12000007","London",1463,1463,0,79.7,592,2.5,"00AZ","Lewisham",NA,5388,3510,8540,6410,4875,3219,5007,8267,-513,-291,-3533,1857
"3355","Lewisham 030D","E01003352","E02000682","Lewisham 030","E09000023","Lewisham","E12000007","London",1816,1801,15,81.3,735,2.5,"00AZ","Lewisham",NA,6194,5605,9949,9533,7100,5793,6820,10434,906,188,-3129,901
"3356","Lewisham 030E","E01003353","E02000682","Lewisham 030","E09000023","Lewisham","E12000007","London",1740,1740,0,67.3,632,2.8,"00AZ","Lewisham",NA,11957,13163,14423,14363,12894,11775,13398,16960,937,-1388,-1025,2597
"3337","Lewisham 026D","E01003354","E02000678","Lewisham 026","E09000023","Lewisham","E12000007","London",1675,1675,0,45.7,701,2.4,"00AZ","Lewisham",NA,14838,14665,19316,17300,11757,10354,11499,24503,-3081,-4311,-7817,7203
"3429","Merton 009A","E01003355","E02000697","Merton 009","E09000024","Merton","E12000007","London",1581,1556,25,111.4,765,2,"00BA","Merton",NA,23659,22977,29438,25494,25485,27071,31985,31952,1826,4094,2547,6458
"3430","Merton 009B","E01003356","E02000697","Merton 009","E09000024","Merton","E12000007","London",1757,1757,0,38.3,696,2.5,"00BA","Merton",NA,27138,21739,28141,30583,27923,24839,29197,32308,785,3100,1056,1725
"3444","Merton 012A","E01003357","E02000700","Merton 012","E09000024","Merton","E12000007","London",1742,1742,0,52.5,750,2.3,"00BA","Merton",NA,7841,3605,9134,14639,10374,5261,11076,15368,2533,1656,1942,729
"3431","Merton 009C","E01003358","E02000697","Merton 009","E09000024","Merton","E12000007","London",1823,1765,58,118.8,801,2.2,"00BA","Merton",NA,26464,23077,29018,31996,28762,28677,32466,30894,2298,5600,3448,-1102
"3414","Merton 006A","E01003359","E02000694","Merton 006","E09000024","Merton","E12000007","London",1733,1733,0,102.2,816,2.1,"00BA","Merton",NA,15664,13436,23685,19026,14268,12364,21706,23833,-1396,-1072,-1979,4807
"3415","Merton 006B","E01003360","E02000694","Merton 006","E09000024","Merton","E12000007","London",1687,1687,0,122.8,740,2.3,"00BA","Merton",NA,25859,26934,29225,31887,26476,30054,30437,31519,617,3120,1212,-368
"3459","Merton 015A","E01003361","E02000703","Merton 015","E09000024","Merton","E12000007","London",1646,1646,0,78.2,621,2.7,"00BA","Merton",NA,24224,18460,24231,27968,24005,18920,23678,27038,-219,460,-553,-930
"3489","Merton 021A","E01003362","E02000709","Merton 021","E09000024","Merton","E12000007","London",1323,1320,3,31.2,499,2.6,"00BA","Merton",NA,27537,23401,25163,26563,29563,26391,27840,29591,2026,2990,2677,3028
"3490","Merton 021B","E01003363","E02000709","Merton 021","E09000024","Merton","E12000007","London",1638,1638,0,35.4,590,2.8,"00BA","Merton",NA,29454,24781,26618,23982,27735,25926,27136,23461,-1719,1145,518,-521
"3491","Merton 021C","E01003364","E02000709","Merton 021","E09000024","Merton","E12000007","London",1731,1720,11,78.6,648,2.7,"00BA","Merton",NA,29231,25338,27358,23121,30082,28962,27817,29877,851,3624,459,6756
"3492","Merton 021D","E01003365","E02000709","Merton 021","E09000024","Merton","E12000007","London",1409,1403,6,42,497,2.8,"00BA","Merton",NA,30053,25532,29785,29184,28866,25723,30388,27640,-1187,191,603,-1544
"3464","Merton 016A","E01003366","E02000704","Merton 016","E09000024","Merton","E12000007","London",1502,1502,0,26.3,595,2.5,"00BA","Merton",NA,15409,15792,15236,15793,18953,16208,19158,16865,3544,416,3922,1072
"3409","Merton 005A","E01003367","E02000693","Merton 005","E09000024","Merton","E12000007","London",2401,2186,215,51.3,961,2.3,"00BA","Merton",NA,15341,15184,21899,23294,18625,24341,30307,29854,3284,9157,8408,6560
"3424","Merton 008A","E01003368","E02000696","Merton 008","E09000024","Merton","E12000007","London",1586,1586,0,106.9,578,2.7,"00BA","Merton",NA,14585,13118,16907,16000,16251,15721,18738,21846,1666,2603,1831,5846
"3410","Merton 005B","E01003369","E02000693","Merton 005","E09000024","Merton","E12000007","London",1656,1656,0,177.1,768,2.2,"00BA","Merton",NA,20624,18105,23143,27684,19963,19118,24733,23294,-661,1013,1590,-4390
"3411","Merton 005C","E01003370","E02000693","Merton 005","E09000024","Merton","E12000007","London",1979,1979,0,129.4,869,2.3,"00BA","Merton",NA,17021,13062,23857,20423,20658,18649,27317,24855,3637,5587,3460,4432
"3412","Merton 005D","E01003371","E02000693","Merton 005","E09000024","Merton","E12000007","London",1558,1542,16,128.8,626,2.5,"00BA","Merton",NA,21226,16369,21977,27940,21736,20675,23592,23041,510,4306,1615,-4899
"3425","Merton 008B","E01003372","E02000696","Merton 008","E09000024","Merton","E12000007","London",1532,1532,0,120.2,627,2.4,"00BA","Merton",NA,9698,6482,10859,10050,9065,7355,10123,14626,-633,873,-736,4576
"3474","Merton 018A","E01003373","E02000706","Merton 018","E09000024","Merton","E12000007","London",1465,1465,0,85.6,536,2.7,"00BA","Merton",NA,7136,2346,6536,6449,5625,2891,5508,5561,-1511,545,-1028,-888
"3494","Merton 022A","E01003374","E02000710","Merton 022","E09000024","Merton","E12000007","London",1440,1284,156,43.2,546,2.4,"00BA","Merton",NA,9226,7980,13110,12498,6651,4297,5845,12737,-2575,-3683,-7265,239
"3495","Merton 022B","E01003375","E02000710","Merton 022","E09000024","Merton","E12000007","London",1616,1591,25,8.8,654,2.4,"00BA","Merton",NA,19203,17396,16374,22114,16875,17273,19470,16099,-2328,-123,3096,-6015
"3445","Merton 012B","E01003376","E02000700","Merton 012","E09000024","Merton","E12000007","London",1553,1553,0,79.2,588,2.6,"00BA","Merton",NA,10649,7758,8023,9765,10480,7729,10137,9371,-169,-29,2114,-394
"3446","Merton 012C","E01003377","E02000700","Merton 012","E09000024","Merton","E12000007","London",1562,1562,0,142.5,526,3,"00BA","Merton",NA,7495,2613,5776,7817,6316,3964,5530,7630,-1179,1351,-246,-187
"3475","Merton 018B","E01003378","E02000706","Merton 018","E09000024","Merton","E12000007","London",1992,1992,0,88.9,728,2.7,"00BA","Merton",NA,12676,10002,12531,14402,16745,12408,15824,16262,4069,2406,3293,1860
"3476","Merton 018C","E01003379","E02000706","Merton 018","E09000024","Merton","E12000007","London",1846,1846,0,136.4,742,2.5,"00BA","Merton",NA,6333,4617,9476,9413,7003,5382,9740,10813,670,765,264,1400
"3439","Merton 011A","E01003380","E02000699","Merton 011","E09000024","Merton","E12000007","London",1648,1648,0,71.9,680,2.4,"00BA","Merton",NA,27937,27203,30146,27142,29125,28260,31809,32450,1188,1057,1663,5308
"3465","Merton 016B","E01003381","E02000704","Merton 016","E09000024","Merton","E12000007","London",1451,1451,0,93.9,720,2,"00BA","Merton",NA,28322,27178,30412,26912,26718,29427,31295,28121,-1604,2249,883,1209
"3440","Merton 011B","E01003382","E02000699","Merton 011","E09000024","Merton","E12000007","London",1539,1539,0,93.2,676,2.3,"00BA","Merton",NA,23542,21703,28428,30947,27506,27525,31475,30681,3964,5822,3047,-266
"3432","Merton 009D","E01003383","E02000697","Merton 009","E09000024","Merton","E12000007","London",1535,1535,0,61.2,692,2.2,"00BA","Merton",NA,27754,31136,31481,29204,29117,32249,32433,32722,1363,1113,952,3518
"3433","Merton 009E","E01003384","E02000697","Merton 009","E09000024","Merton","E12000007","London",1521,1521,0,99.3,623,2.4,"00BA","Merton",NA,26989,26733,27511,32343,28362,27915,29588,32315,1373,1182,2077,-28
"3441","Merton 011C","E01003385","E02000699","Merton 011","E09000024","Merton","E12000007","London",1581,1581,0,79.7,626,2.5,"00BA","Merton",NA,29943,29382,31286,31857,31652,31622,32122,32828,1709,2240,836,971
"3449","Merton 013A","E01003386","E02000701","Merton 013","E09000024","Merton","E12000007","London",2204,2198,6,138.9,722,3,"00BA","Merton",NA,15153,11664,16063,19831,17251,13175,19169,17584,2098,1511,3106,-2247
"3454","Merton 014A","E01003387","E02000702","Merton 014","E09000024","Merton","E12000007","London",1604,1595,9,69,614,2.6,"00BA","Merton",NA,9606,7645,10545,11754,6756,6137,6844,9709,-2850,-1508,-3701,-2045
"3450","Merton 013B","E01003388","E02000701","Merton 013","E09000024","Merton","E12000007","London",1439,1439,0,98.2,590,2.4,"00BA","Merton",NA,15046,10723,17990,15393,9448,6741,11531,14507,-5598,-3982,-6459,-886
"3451","Merton 013C","E01003389","E02000701","Merton 013","E09000024","Merton","E12000007","London",1764,1764,0,95.7,631,2.8,"00BA","Merton",NA,13217,10683,15688,17253,11270,10840,13115,18155,-1947,157,-2573,902
"3477","Merton 018D","E01003390","E02000706","Merton 018","E09000024","Merton","E12000007","London",1597,1597,0,173.8,623,2.6,"00BA","Merton",NA,5382,2616,6258,9250,6444,4643,7749,9413,1062,2027,1491,163
"3455","Merton 014B","E01003391","E02000702","Merton 014","E09000024","Merton","E12000007","London",1333,1333,0,153.6,544,2.5,"00BA","Merton",NA,6483,3687,3655,13114,6945,4083,5631,12165,462,396,1976,-949
"3452","Merton 013D","E01003392","E02000701","Merton 013","E09000024","Merton","E12000007","London",1299,1299,0,53.7,501,2.6,"00BA","Merton",NA,14610,13639,22646,20989,16269,18374,23312,21371,1659,4735,666,382
"3426","Merton 008C","E01003393","E02000696","Merton 008","E09000024","Merton","E12000007","London",1529,1529,0,198.3,646,2.4,"00BA","Merton",NA,12152,9827,14142,14649,18147,18156,21245,17030,5995,8329,7103,2381
"3419","Merton 007A","E01003394","E02000695","Merton 007","E09000024","Merton","E12000007","London",1931,1924,7,120.5,636,3,"00BA","Merton",NA,16674,10150,17370,20780,17166,14324,18054,18480,492,4174,684,-2300
"3420","Merton 007B","E01003395","E02000695","Merton 007","E09000024","Merton","E12000007","London",1471,1471,0,68.2,503,2.9,"00BA","Merton",NA,21138,15125,20996,21929,19954,16271,21136,21757,-1184,1146,140,-172
"3421","Merton 007C","E01003396","E02000695","Merton 007","E09000024","Merton","E12000007","London",1592,1592,0,167.2,534,3,"00BA","Merton",NA,21073,14297,22976,23158,20786,17383,24482,24249,-287,3086,1506,1091
"3422","Merton 007D","E01003397","E02000695","Merton 007","E09000024","Merton","E12000007","London",1552,1552,0,123.2,557,2.8,"00BA","Merton",NA,19645,14928,17013,20590,18149,14310,16312,24965,-1496,-618,-701,4375
"3423","Merton 007E","E01003398","E02000695","Merton 007","E09000024","Merton","E12000007","London",1741,1730,11,83.2,583,3,"00BA","Merton",NA,16666,12995,16313,21989,16942,14477,18936,20472,276,1482,2623,-1517
"3442","Merton 011D","E01003399","E02000699","Merton 011","E09000024","Merton","E12000007","London",1373,1358,15,105.2,618,2.2,"00BA","Merton",NA,25095,25692,25479,32096,25873,26440,26730,32135,778,748,1251,39
"3399","Merton 003A","E01003400","E02000691","Merton 003","E09000024","Merton","E12000007","London",1486,1484,2,81.6,659,2.3,"00BA","Merton",NA,24554,28159,29679,28483,27596,29367,30950,32216,3042,1208,1271,3733
"3404","Merton 004A","E01003401","E02000692","Merton 004","E09000024","Merton","E12000007","London",1346,1336,10,75,647,2.1,"00BA","Merton",NA,27390,29057,31566,26221,30412,30178,32592,32755,3022,1121,1026,6534
"3405","Merton 004B","E01003402","E02000692","Merton 004","E09000024","Merton","E12000007","London",1552,1552,0,68.3,705,2.2,"00BA","Merton",NA,30478,29759,31452,32105,30517,29936,31393,32529,39,177,-59,424
"3406","Merton 004C","E01003403","E02000692","Merton 004","E09000024","Merton","E12000007","London",1546,1500,46,61.5,710,2.1,"00BA","Merton",NA,29621,29524,31595,29080,28701,30937,32562,30044,-920,1413,967,964
"3407","Merton 004D","E01003404","E02000692","Merton 004","E09000024","Merton","E12000007","London",1674,1647,27,78.3,912,1.8,"00BA","Merton",NA,23840,21741,28267,29767,25029,24153,31247,24964,1189,2412,2980,-4803
"3478","Merton 018E","E01003405","E02000706","Merton 018","E09000024","Merton","E12000007","London",1705,1705,0,60.4,630,2.7,"00BA","Merton",NA,10984,6778,12699,10215,8773,7418,11324,12339,-2211,640,-1375,2124
"3427","Merton 008D","E01003406","E02000696","Merton 008","E09000024","Merton","E12000007","London",1641,1641,0,86.5,566,2.9,"00BA","Merton",NA,11380,5420,15066,12410,9717,6307,12101,12363,-1663,887,-2965,-47
"3428","Merton 008E","E01003407","E02000696","Merton 008","E09000024","Merton","E12000007","London",1784,1784,0,90.1,768,2.3,"00BA","Merton",NA,22763,20016,26685,23291,20541,20527,26247,25739,-2222,511,-438,2448
"3447","Merton 012D","E01003408","E02000700","Merton 012","E09000024","Merton","E12000007","London",1852,1852,0,117.2,873,2.1,"00BA","Merton",NA,15814,15759,21895,21820,21616,19391,24181,25563,5802,3632,2286,3743
"3453","Merton 013E","E01003409","E02000701","Merton 013","E09000024","Merton","E12000007","London",1710,1710,0,76,562,3,"00BA","Merton",NA,9510,4019,11580,10666,10739,8509,11990,11957,1229,4490,410,1291
"3448","Merton 012E","E01003410","E02000700","Merton 012","E09000024","Merton","E12000007","London",1581,1581,0,124.9,630,2.5,"00BA","Merton",NA,10477,6555,10404,11161,11513,8048,11597,10799,1036,1493,1193,-362
"3456","Merton 014C","E01003411","E02000702","Merton 014","E09000024","Merton","E12000007","London",1729,1729,0,82.8,719,2.4,"00BA","Merton",NA,16990,11871,22642,17266,13921,9909,15241,15376,-3069,-1962,-7401,-1890
"3457","Merton 014D","E01003412","E02000702","Merton 014","E09000024","Merton","E12000007","London",1660,1660,0,79.6,597,2.8,"00BA","Merton",NA,11739,7188,14111,8246,11293,10471,11973,11529,-446,3283,-2138,3283
"3469","Merton 017A","E01003413","E02000705","Merton 017","E09000024","Merton","E12000007","London",1900,1900,0,63.1,709,2.7,"00BA","Merton",NA,18631,12490,19373,17925,16375,13878,16249,18476,-2256,1388,-3124,551
"3470","Merton 017B","E01003414","E02000705","Merton 017","E09000024","Merton","E12000007","London",1591,1560,31,71.1,539,2.9,"00BA","Merton",NA,19088,13120,15638,21573,15656,12622,15746,20364,-3432,-498,108,-1209
"3471","Merton 017C","E01003415","E02000705","Merton 017","E09000024","Merton","E12000007","London",1632,1622,10,75,548,3,"00BA","Merton",NA,18101,11164,20512,15304,13805,12543,13461,18531,-4296,1379,-7051,3227
"3472","Merton 017D","E01003416","E02000705","Merton 017","E09000024","Merton","E12000007","London",1512,1512,0,47.1,534,2.8,"00BA","Merton",NA,19648,18851,19350,11728,17245,17025,17765,18984,-2403,-1826,-1585,7256
"3509","Merton 025A","E01003417","E02000713","Merton 025","E09000024","Merton","E12000007","London",1559,1559,0,51.9,608,2.6,"00BA","Merton",NA,21731,20818,19005,16239,25461,23344,25691,18421,3730,2526,6686,2182
"3510","Merton 025B","E01003418","E02000713","Merton 025","E09000024","Merton","E12000007","London",1471,1471,0,97.5,531,2.8,"00BA","Merton",NA,28373,26771,26925,15527,28245,27624,28422,15620,-128,853,1497,93
"3511","Merton 025C","E01003419","E02000713","Merton 025","E09000024","Merton","E12000007","London",1703,1703,0,28.2,642,2.7,"00BA","Merton",NA,23239,19745,22449,17667,22561,19787,23210,15962,-678,42,761,-1705
"3512","Merton 025D","E01003420","E02000713","Merton 025","E09000024","Merton","E12000007","London",1380,1380,0,72.2,506,2.7,"00BA","Merton",NA,25130,21788,24388,16495,23848,20599,29090,17285,-1282,-1189,4702,790
"3493","Merton 021E","E01003421","E02000709","Merton 021","E09000024","Merton","E12000007","London",1600,1600,0,58.5,640,2.5,"00BA","Merton",NA,20364,18497,17820,21827,24350,20388,19782,24497,3986,1891,1962,2670
"3513","Merton 025E","E01003422","E02000713","Merton 025","E09000024","Merton","E12000007","London",1377,1341,36,47.9,513,2.6,"00BA","Merton",NA,26112,20906,27916,18199,23919,21704,23268,18657,-2193,798,-4648,458
"3443","Merton 011E","E01003423","E02000699","Merton 011","E09000024","Merton","E12000007","London",1548,1540,8,74.6,605,2.5,"00BA","Merton",NA,26871,25706,28839,31124,28825,28116,28817,32079,1954,2410,-22,955
"3460","Merton 015B","E01003424","E02000703","Merton 015","E09000024","Merton","E12000007","London",1533,1533,0,51.5,574,2.7,"00BA","Merton",NA,31743,30647,30672,32365,31677,31273,32350,32751,-66,626,1678,386
"3461","Merton 015C","E01003425","E02000703","Merton 015","E09000024","Merton","E12000007","London",1440,1440,0,53.1,508,2.8,"00BA","Merton",NA,31224,31738,29861,31991,31490,31420,31591,32321,266,-318,1730,330
"3462","Merton 015D","E01003426","E02000703","Merton 015","E09000024","Merton","E12000007","London",1749,1749,0,44.4,609,2.9,"00BA","Merton",NA,27073,20615,25721,29467,23255,22825,27398,30989,-3818,2210,1677,1522
"3499","Merton 023A","E01003427","E02000711","Merton 023","E09000024","Merton","E12000007","London",1758,1749,9,50.9,706,2.5,"00BA","Merton",NA,16504,14558,20397,20764,19498,17427,22401,24878,2994,2869,2004,4114
"3463","Merton 015E","E01003428","E02000703","Merton 015","E09000024","Merton","E12000007","London",1457,1457,0,48.2,649,2.2,"00BA","Merton",NA,26921,22901,29784,29141,26132,20945,29057,32134,-789,-1956,-727,2993
"3479","Merton 019A","E01003429","E02000707","Merton 019","E09000024","Merton","E12000007","London",1456,1456,0,95.2,507,2.9,"00BA","Merton",NA,20753,16772,19370,13164,17590,13477,16561,19268,-3163,-3295,-2809,6104
"3480","Merton 019B","E01003430","E02000707","Merton 019","E09000024","Merton","E12000007","London",1443,1443,0,119.6,545,2.6,"00BA","Merton",NA,11586,6908,9752,9343,7795,4391,6958,17006,-3791,-2517,-2794,7663
"3481","Merton 019C","E01003431","E02000707","Merton 019","E09000024","Merton","E12000007","London",1506,1506,0,119.5,545,2.8,"00BA","Merton",NA,9541,5581,9281,7212,7591,4803,7530,11096,-1950,-778,-1751,3884
"3482","Merton 019D","E01003432","E02000707","Merton 019","E09000024","Merton","E12000007","London",1556,1556,0,32,508,3.1,"00BA","Merton",NA,7605,2212,8825,6543,4546,2245,4869,8654,-3059,33,-3956,2111
"3483","Merton 019E","E01003433","E02000707","Merton 019","E09000024","Merton","E12000007","London",1525,1521,4,55.6,578,2.6,"00BA","Merton",NA,13663,10245,13948,14036,14660,11966,14768,17833,997,1721,820,3797
"3473","Merton 017E","E01003434","E02000705","Merton 017","E09000024","Merton","E12000007","London",1489,1489,0,83.8,506,2.9,"00BA","Merton",NA,22123,15535,21987,17950,19434,17773,19698,19720,-2689,2238,-2289,1770
"3458","Merton 014E","E01003435","E02000702","Merton 014","E09000024","Merton","E12000007","London",1312,1309,3,16,490,2.7,"00BA","Merton",NA,19461,17370,18076,17402,13317,12374,13480,17906,-6144,-4996,-4596,504
"3500","Merton 023B","E01003436","E02000711","Merton 023","E09000024","Merton","E12000007","London",1565,1559,6,72.3,588,2.7,"00BA","Merton",NA,11037,8672,10444,13454,11292,9291,12095,11440,255,619,1651,-2014
"3496","Merton 022C","E01003437","E02000710","Merton 022","E09000024","Merton","E12000007","London",1879,1873,6,48.1,764,2.5,"00BA","Merton",NA,17460,15974,16973,21524,17832,17259,20621,20594,372,1285,3648,-930
"3504","Merton 024A","E01003438","E02000712","Merton 024","E09000024","Merton","E12000007","London",1691,1691,0,87.3,650,2.6,"00BA","Merton",NA,8830,5336,7964,9408,8822,6608,8285,9691,-8,1272,321,283
"3501","Merton 023C","E01003439","E02000711","Merton 023","E09000024","Merton","E12000007","London",1439,1439,0,39.6,548,2.6,"00BA","Merton",NA,9321,8194,13764,11596,9000,9683,13593,12283,-321,1489,-171,687
"3497","Merton 022D","E01003440","E02000710","Merton 022","E09000024","Merton","E12000007","London",1536,1536,0,33.7,627,2.4,"00BA","Merton",NA,10045,6675,12768,10861,11496,7583,12680,15084,1451,908,-88,4223
"3498","Merton 022E","E01003441","E02000710","Merton 022","E09000024","Merton","E12000007","London",1858,1778,80,84.8,617,2.9,"00BA","Merton",NA,10251,6296,11458,9920,11938,8442,10815,14287,1687,2146,-643,4367
"3434","Merton 010A","E01003442","E02000698","Merton 010","E09000024","Merton","E12000007","London",1691,1574,117,67.6,701,2.2,"00BA","Merton",NA,28781,27029,31341,30548,29127,30984,32445,32666,346,3955,1104,2118
"3435","Merton 010B","E01003443","E02000698","Merton 010","E09000024","Merton","E12000007","London",1564,1564,0,70.6,633,2.5,"00BA","Merton",NA,31552,31318,31174,32373,31605,31739,31571,32778,53,421,397,405
"3436","Merton 010C","E01003444","E02000698","Merton 010","E09000024","Merton","E12000007","London",1557,1557,0,59.1,695,2.2,"00BA","Merton",NA,26391,25994,29965,30248,27788,28566,31488,31817,1397,2572,1523,1569
"3437","Merton 010D","E01003445","E02000698","Merton 010","E09000024","Merton","E12000007","London",1713,1713,0,36,658,2.6,"00BA","Merton",NA,28022,23417,27176,28534,25680,23785,28574,30330,-2342,368,1398,1796
"3466","Merton 016C","E01003446","E02000704","Merton 016","E09000024","Merton","E12000007","London",1668,1668,0,69.8,799,2.1,"00BA","Merton",NA,21742,20161,23925,28455,23375,23387,26022,30985,1633,3226,2097,2530
"3467","Merton 016D","E01003447","E02000704","Merton 016","E09000024","Merton","E12000007","London",1545,1501,44,38.4,691,2.2,"00BA","Merton",NA,11348,8304,12075,14696,11247,10572,12137,19004,-101,2268,62,4308
"3502","Merton 023D","E01003448","E02000711","Merton 023","E09000024","Merton","E12000007","London",1701,1701,0,85.1,648,2.6,"00BA","Merton",NA,8692,6772,9192,7248,10514,9057,12110,11705,1822,2285,2918,4457
"3505","Merton 024B","E01003449","E02000712","Merton 024","E09000024","Merton","E12000007","London",1759,1759,0,58.7,677,2.6,"00BA","Merton",NA,11205,8055,11174,16741,18115,14155,19132,18360,6910,6100,7958,1619
"3506","Merton 024C","E01003450","E02000712","Merton 024","E09000024","Merton","E12000007","London",1611,1605,6,71.4,597,2.7,"00BA","Merton",NA,9525,7899,12359,9611,10491,8743,11080,10328,966,844,-1279,717
"3507","Merton 024D","E01003451","E02000712","Merton 024","E09000024","Merton","E12000007","London",1666,1644,22,29.1,598,2.7,"00BA","Merton",NA,24804,23844,27544,17387,21468,22451,24918,18081,-3336,-1393,-2626,694
"3508","Merton 024E","E01003452","E02000712","Merton 024","E09000024","Merton","E12000007","London",1982,1982,0,58.5,806,2.5,"00BA","Merton",NA,7933,6749,9395,7502,10290,8205,8752,14149,2357,1456,-643,6647
"3503","Merton 023E","E01003453","E02000711","Merton 023","E09000024","Merton","E12000007","London",1695,1685,10,82.4,650,2.6,"00BA","Merton",NA,11211,8620,11885,11498,11355,10463,12311,12531,144,1843,426,1033
"3400","Merton 003B","E01003454","E02000691","Merton 003","E09000024","Merton","E12000007","London",1362,1314,48,86.8,587,2.2,"00BA","Merton",NA,27148,26046,26280,29721,31211,30416,30036,32759,4063,4370,3756,3038
"3413","Merton 005E","E01003455","E02000693","Merton 005","E09000024","Merton","E12000007","London",1579,1572,7,74.4,749,2.1,"00BA","Merton",NA,23626,19243,23382,21985,23454,22189,27396,19753,-172,2946,4014,-2232
"3401","Merton 003C","E01003456","E02000691","Merton 003","E09000024","Merton","E12000007","London",1547,1465,82,64.9,667,2.2,"00BA","Merton",NA,17837,20039,14666,32372,20640,20880,19494,31767,2803,841,4828,-605
"3416","Merton 006C","E01003457","E02000694","Merton 006","E09000024","Merton","E12000007","London",1622,1622,0,115.2,623,2.6,"00BA","Merton",NA,30964,28702,32085,30099,29450,32100,32377,30771,-1514,3398,292,672
"3417","Merton 006D","E01003458","E02000694","Merton 006","E09000024","Merton","E12000007","London",1601,1601,0,117,693,2.3,"00BA","Merton",NA,28091,24945,30111,32127,28790,27535,31525,30562,699,2590,1414,-1565
"3418","Merton 006E","E01003459","E02000694","Merton 006","E09000024","Merton","E12000007","London",2087,2071,16,110.2,956,2.2,"00BA","Merton",NA,15857,9690,15474,20334,17313,10217,18099,23826,1456,527,2625,3492
"3395","Merton 002A","E01003460","E02000690","Merton 002","E09000024","Merton","E12000007","London",1499,1459,40,4.2,679,2.1,"00BA","Merton",NA,22973,23543,23336,30377,24496,21891,28802,31320,1523,-1652,5466,943
"3408","Merton 004E","E01003461","E02000692","Merton 004","E09000024","Merton","E12000007","London",1544,1532,12,56.7,712,2.2,"00BA","Merton",NA,30299,31691,32275,31308,30567,32706,32632,31865,268,1015,357,557
"3396","Merton 002B","E01003462","E02000690","Merton 002","E09000024","Merton","E12000007","London",1464,1464,0,33.1,599,2.4,"00BA","Merton",NA,27499,29222,31551,32317,29188,29678,31648,30077,1689,456,97,-2240
"3438","Merton 010E","E01003463","E02000698","Merton 010","E09000024","Merton","E12000007","London",1291,1291,0,23.8,459,2.8,"00BA","Merton",NA,32352,32125,31734,31036,32296,32103,32802,32480,-56,-22,1068,1444
"3397","Merton 002C","E01003464","E02000690","Merton 002","E09000024","Merton","E12000007","London",1393,1328,65,17.6,550,2.4,"00BA","Merton",NA,28658,32065,31941,31576,30146,31307,30102,32498,1488,-758,-1839,922
"3398","Merton 002D","E01003465","E02000690","Merton 002","E09000024","Merton","E12000007","London",1300,1276,24,21,472,2.7,"00BA","Merton",NA,28777,32300,32366,31905,30792,32828,32817,32795,2015,528,451,890
"3484","Merton 020A","E01003466","E02000708","Merton 020","E09000024","Merton","E12000007","London",1592,1592,0,67.2,599,2.7,"00BA","Merton",NA,29884,22515,27205,30679,29430,26106,26013,32025,-454,3591,-1192,1346
"3485","Merton 020B","E01003467","E02000708","Merton 020","E09000024","Merton","E12000007","London",1618,1612,6,41.2,601,2.7,"00BA","Merton",NA,29014,21928,27362,30005,27893,23097,25069,30568,-1121,1169,-2293,563
"3486","Merton 020C","E01003468","E02000708","Merton 020","E09000024","Merton","E12000007","London",1699,1699,0,36.5,630,2.7,"00BA","Merton",NA,30444,25636,28636,30045,31508,30097,29602,30268,1064,4461,966,223
"3487","Merton 020D","E01003469","E02000708","Merton 020","E09000024","Merton","E12000007","London",1620,1620,0,55,574,2.8,"00BA","Merton",NA,20112,13464,26851,23904,17798,13743,19884,22393,-2314,279,-6967,-1511
"3488","Merton 020E","E01003470","E02000708","Merton 020","E09000024","Merton","E12000007","London",1757,1739,18,68.8,607,2.9,"00BA","Merton",NA,27525,22434,25770,26949,26036,21281,27068,29338,-1489,-1153,1298,2389
"3468","Merton 016E","E01003471","E02000704","Merton 016","E09000024","Merton","E12000007","London",1576,1511,65,51.6,604,2.5,"00BA","Merton",NA,24098,17546,29416,28675,24546,19926,26395,30049,448,2380,-3021,1374
"3390","Merton 001A","E01003472","E02000689","Merton 001","E09000024","Merton","E12000007","London",1344,1344,0,148,481,2.8,"00BA","Merton",NA,32115,32141,32279,32447,32033,32037,32280,32819,-82,-104,1,372
"3391","Merton 001B","E01003473","E02000689","Merton 001","E09000024","Merton","E12000007","London",1353,1334,19,65.9,505,2.6,"00BA","Merton",NA,30549,27278,30793,32371,29279,31894,31490,32676,-1270,4616,697,305
"3392","Merton 001C","E01003474","E02000689","Merton 001","E09000024","Merton","E12000007","London",1411,1411,0,23.4,480,2.9,"00BA","Merton",NA,30800,32026,32046,32466,30140,32469,32736,32844,-660,443,690,378
"3393","Merton 001D","E01003475","E02000689","Merton 001","E09000024","Merton","E12000007","London",2511,2511,0,35.1,1162,2.2,"00BA","Merton",NA,18107,17811,23627,27528,19915,14860,25280,29590,1808,-2951,1653,2062
"3402","Merton 003D","E01003476","E02000691","Merton 003","E09000024","Merton","E12000007","London",1404,1389,15,83.2,482,2.9,"00BA","Merton",NA,20043,11802,20715,24712,22699,18241,23011,28206,2656,6439,2296,3494
"3403","Merton 003E","E01003477","E02000691","Merton 003","E09000024","Merton","E12000007","London",1535,1516,19,84.3,573,2.6,"00BA","Merton",NA,26373,24515,28656,29803,27138,23578,26958,32483,765,-937,-1698,2680
"3394","Merton 001E","E01003478","E02000689","Merton 001","E09000024","Merton","E12000007","London",1639,1639,0,48.9,602,2.7,"00BA","Merton",NA,26736,25017,26642,28298,29376,27009,29718,31842,2640,1992,3076,3544
"3663","Newham 035A","E01003479","E02000748","Newham 035","E09000025","Newham","E12000007","London",1505,1505,0,49.8,612,2.5,"00BB","Newham",NA,6702,7439,12811,14762,6522,9106,10634,15057,-180,1667,-2177,295
"3652","Newham 033A","E01003480","E02000746","Newham 033","E09000025","Newham","E12000007","London",2172,1768,404,76.3,662,2.7,"00BB","Newham",NA,4717,3481,8268,11262,13193,12493,17796,14966,8476,9012,9528,3704
"3664","Newham 035B","E01003481","E02000748","Newham 035","E09000025","Newham","E12000007","London",1574,1288,286,30.3,500,2.6,"00BB","Newham",NA,6555,7835,11184,12650,7495,8207,11975,12617,940,372,791,-33
"3653","Newham 033B","E01003482","E02000746","Newham 033","E09000025","Newham","E12000007","London",2634,2629,5,7.3,1033,2.5,"00BB","Newham",NA,5317,5044,13703,16064,10586,11080,17306,20955,5269,6036,3603,4891
"3647","Newham 032A","E01003483","E02000745","Newham 032","E09000025","Newham","E12000007","London",1486,1486,0,60.7,492,3,"00BB","Newham",NA,3030,1397,9195,11853,4458,3929,5443,7787,1428,2532,-3752,-4066
"3648","Newham 032B","E01003484","E02000745","Newham 032","E09000025","Newham","E12000007","London",1621,1615,6,160.2,566,2.9,"00BB","Newham",NA,8709,8156,16819,19493,13316,12281,19135,19897,4607,4125,2316,404
"3665","Newham 035C","E01003485","E02000748","Newham 035","E09000025","Newham","E12000007","London",1573,1573,0,103.8,560,2.8,"00BB","Newham",NA,8771,7714,17230,20360,9407,10252,15041,16622,636,2538,-2189,-3738
"3654","Newham 033C","E01003486","E02000746","Newham 033","E09000025","Newham","E12000007","London",1205,1195,10,55.1,455,2.6,"00BB","Newham",NA,1203,181,4480,10882,1218,629,2194,10049,15,448,-2286,-833
"3655","Newham 033D","E01003487","E02000746","Newham 033","E09000025","Newham","E12000007","London",1371,1316,55,110.3,424,3.1,"00BB","Newham",NA,1893,936,3406,10914,3216,2258,3241,8857,1323,1322,-165,-2057
"3592","Newham 019A","E01003488","E02000732","Newham 019","E09000025","Newham","E12000007","London",1874,1874,0,144.2,669,2.8,"00BB","Newham",NA,748,309,2233,11667,2289,1678,3494,7670,1541,1369,1261,-3997
"3593","Newham 019B","E01003489","E02000732","Newham 019","E09000025","Newham","E12000007","London",1807,1806,1,147.4,520,3.5,"00BB","Newham",NA,1744,880,9242,8835,4950,4190,9013,8459,3206,3310,-229,-376
"3594","Newham 019C","E01003490","E02000732","Newham 019","E09000025","Newham","E12000007","London",1857,1857,0,184.6,539,3.4,"00BB","Newham",NA,4111,2348,7965,14718,5939,6171,10459,10365,1828,3823,2494,-4353
"3605","Newham 022A","E01003491","E02000735","Newham 022","E09000025","Newham","E12000007","London",1977,1977,0,190.8,637,3.1,"00BB","Newham",NA,2463,656,6599,14896,7821,7816,14851,14643,5358,7160,8252,-253
"3619","Newham 025A","E01003492","E02000738","Newham 025","E09000025","Newham","E12000007","London",2010,2010,0,212,536,3.8,"00BB","Newham",NA,5082,2848,9782,15162,9965,11101,17523,15022,4883,8253,7741,-140
"3620","Newham 025B","E01003493","E02000738","Newham 025","E09000025","Newham","E12000007","London",2299,2298,1,164,732,3.1,"00BB","Newham",NA,4153,4008,7360,16406,8540,9741,13754,12818,4387,5733,6394,-3588
"3621","Newham 025C","E01003494","E02000738","Newham 025","E09000025","Newham","E12000007","London",2048,2048,0,193.8,645,3.2,"00BB","Newham",NA,7068,4978,13427,18039,11048,11850,18177,13860,3980,6872,4750,-4179
"3622","Newham 025D","E01003495","E02000738","Newham 025","E09000025","Newham","E12000007","London",2110,2110,0,177.8,650,3.2,"00BB","Newham",NA,9363,8622,14994,17999,13928,13953,19743,17290,4565,5331,4749,-709
"3627","Newham 027A","E01003496","E02000740","Newham 027","E09000025","Newham","E12000007","London",1445,1445,0,76.3,591,2.4,"00BB","Newham",NA,3104,2040,5478,10878,7049,7403,7490,16071,3945,5363,2012,5193
"3656","Newham 034A","E01003497","E02000747","Newham 034","E09000025","Newham","E12000007","London",1715,1715,0,25.2,622,2.8,"00BB","Newham",NA,2498,2623,5712,8583,4474,4237,6172,7946,1976,1614,460,-637
"3628","Newham 027B","E01003498","E02000740","Newham 027","E09000025","Newham","E12000007","London",1741,1741,0,74.7,674,2.6,"00BB","Newham",NA,3270,2528,6835,14333,5685,5322,7284,11707,2415,2794,449,-2626
"3639","Newham 030A","E01003499","E02000743","Newham 030","E09000025","Newham","E12000007","London",2280,2280,0,133.8,862,2.6,"00BB","Newham",NA,1129,944,1536,10027,3343,3603,5716,9911,2214,2659,4180,-116
"3629","Newham 027C","E01003500","E02000740","Newham 027","E09000025","Newham","E12000007","London",2043,2043,0,27.9,732,2.8,"00BB","Newham",NA,1458,902,2817,9327,4267,5013,6918,12073,2809,4111,4101,2746
"3640","Newham 030B","E01003501","E02000743","Newham 030","E09000025","Newham","E12000007","London",2040,2031,9,128.7,715,2.8,"00BB","Newham",NA,2427,2281,5148,8873,4584,3571,6043,9391,2157,1290,895,518
"3641","Newham 030C","E01003502","E02000743","Newham 030","E09000025","Newham","E12000007","London",1836,1836,0,121.8,669,2.7,"00BB","Newham",NA,1190,975,3749,10212,4043,3805,9037,10564,2853,2830,5288,352
"3642","Newham 030D","E01003503","E02000743","Newham 030","E09000025","Newham","E12000007","London",1710,1683,27,115.9,647,2.6,"00BB","Newham",NA,504,928,1403,7854,1295,1581,1759,10830,791,653,356,2976
"3657","Newham 034D","E01003506","E02000747","Newham 034","E09000025","Newham","E12000007","London",1480,1464,16,139.4,489,3,"00BB","Newham",NA,3467,2532,5635,10620,3545,3149,4418,10778,78,617,-1217,158
"3643","Newham 031A","E01003507","E02000744","Newham 031","E09000025","Newham","E12000007","London",2113,2113,0,148.8,807,2.6,"00BB","Newham",NA,2824,2768,6284,13890,5877,6930,8526,12305,3053,4162,2242,-1585
"3644","Newham 031B","E01003508","E02000744","Newham 031","E09000025","Newham","E12000007","London",1605,1605,0,122.7,555,2.9,"00BB","Newham",NA,1932,2439,5795,13298,4034,4377,8873,9431,2102,1938,3078,-3867
"3645","Newham 031C","E01003509","E02000744","Newham 031","E09000025","Newham","E12000007","London",1953,1953,0,187.2,795,2.5,"00BB","Newham",NA,2366,3194,5467,10590,4623,4945,8115,9859,2257,1751,2648,-731
"3667","Newham 036A","E01003511","E02000749","Newham 036","E09000025","Newham","E12000007","London",1394,1394,0,152,452,3.1,"00BB","Newham",NA,830,376,2731,4880,3148,2270,6238,7769,2318,1894,3507,2889
"3668","Newham 036B","E01003512","E02000749","Newham 036","E09000025","Newham","E12000007","London",1805,1805,0,139.9,678,2.7,"00BB","Newham",NA,2635,2058,3421,7598,3986,4987,5890,8695,1351,2929,2469,1097
"3666","Newham 035D","E01003513","E02000748","Newham 035","E09000025","Newham","E12000007","London",1588,1588,0,44.4,558,2.8,"00BB","Newham",NA,9108,7546,18347,21455,10961,13416,18050,17398,1853,5870,-297,-4057
"3669","Newham 036C","E01003514","E02000749","Newham 036","E09000025","Newham","E12000007","London",1512,1512,0,85,532,2.8,"00BB","Newham",NA,4104,2494,9193,9560,3462,4993,5008,10072,-642,2499,-4185,512
"3670","Newham 036D","E01003515","E02000749","Newham 036","E09000025","Newham","E12000007","London",1798,1798,0,24.1,755,2.4,"00BB","Newham",NA,1757,1748,3925,12067,1677,1394,4107,10315,-80,-354,182,-1752
"3649","Newham 032C","E01003516","E02000745","Newham 032","E09000025","Newham","E12000007","London",1859,1859,0,137.9,652,2.9,"00BB","Newham",NA,1035,851,2346,10039,2986,2417,4684,8530,1951,1566,2338,-1509
"3671","Newham 036E","E01003517","E02000749","Newham 036","E09000025","Newham","E12000007","London",1674,1674,0,61,605,2.8,"00BB","Newham",NA,1427,784,4268,12823,2068,1453,4854,11564,641,669,586,-1259
"3650","Newham 032D","E01003518","E02000745","Newham 032","E09000025","Newham","E12000007","London",1595,1595,0,88.3,588,2.7,"00BB","Newham",NA,6885,8767,14187,16978,11341,11732,17028,17198,4456,2965,2841,220
"3651","Newham 032E","E01003519","E02000745","Newham 032","E09000025","Newham","E12000007","London",1580,1580,0,253.6,484,3.3,"00BB","Newham",NA,7354,7413,9504,18962,6802,9028,10378,10736,-552,1615,874,-8226
"3587","Newham 018A","E01003520","E02000731","Newham 018","E09000025","Newham","E12000007","London",2001,2001,0,153.7,583,3.4,"00BB","Newham",NA,4745,4191,10931,17127,7944,9867,19387,13883,3199,5676,8456,-3244
"3588","Newham 018B","E01003521","E02000731","Newham 018","E09000025","Newham","E12000007","London",2259,2259,0,165.9,623,3.6,"00BB","Newham",NA,5102,5518,11602,16762,6695,14606,20585,12032,1593,9088,8983,-4730
"3589","Newham 018C","E01003522","E02000731","Newham 018","E09000025","Newham","E12000007","London",1908,1908,0,244,550,3.5,"00BB","Newham",NA,3961,2607,9027,17211,7717,8757,12628,13859,3756,6150,3601,-3352
"3614","Newham 024A","E01003523","E02000737","Newham 024","E09000025","Newham","E12000007","London",2043,2043,0,99.4,669,3.1,"00BB","Newham",NA,3446,2705,6098,12545,6062,6471,9378,12670,2616,3766,3280,125
"3595","Newham 019D","E01003524","E02000732","Newham 019","E09000025","Newham","E12000007","London",2028,2023,5,229.9,598,3.4,"00BB","Newham",NA,3692,2406,6611,15363,6885,8184,13600,9067,3193,5778,6989,-6296
"3590","Newham 018D","E01003525","E02000731","Newham 018","E09000025","Newham","E12000007","London",1978,1978,0,153.2,519,3.8,"00BB","Newham",NA,4271,3383,10812,13230,7455,9664,20294,13508,3184,6281,9482,278
"3591","Newham 018E","E01003526","E02000731","Newham 018","E09000025","Newham","E12000007","London",1927,1927,0,179.9,550,3.5,"00BB","Newham",NA,5043,3200,9935,16299,7515,9202,12038,13124,2472,6002,2103,-3175
"3615","Newham 024B","E01003527","E02000737","Newham 024","E09000025","Newham","E12000007","London",1773,1773,0,107.9,570,3.1,"00BB","Newham",NA,8368,8482,12996,17440,10633,13789,16590,15702,2265,5307,3594,-1738
"3530","Newham 005A","E01003528","E02000718","Newham 005","E09000025","Newham","E12000007","London",1386,1386,0,174.3,431,3.2,"00BB","Newham",NA,2392,889,6457,13383,6033,4625,8925,12606,3641,3736,2468,-777
"3551","Newham 010A","E01003529","E02000723","Newham 010","E09000025","Newham","E12000007","London",2379,2376,3,201.8,597,4,"00BB","Newham",NA,3921,2137,9183,18587,10702,11238,18580,14986,6781,9101,9397,-3601
"3552","Newham 010B","E01003530","E02000723","Newham 010","E09000025","Newham","E12000007","London",1827,1827,0,151.4,468,3.9,"00BB","Newham",NA,5052,2056,11651,15810,11662,10656,17170,17082,6610,8600,5519,1272
"3553","Newham 010C","E01003531","E02000723","Newham 010","E09000025","Newham","E12000007","London",1997,1991,6,89.8,516,3.9,"00BB","Newham",NA,2042,1028,6855,14083,7635,8154,14285,17361,5593,7126,7430,3278
"3554","Newham 010D","E01003532","E02000723","Newham 010","E09000025","Newham","E12000007","London",2002,2002,0,178.9,513,3.9,"00BB","Newham",NA,3565,2380,7782,21167,8863,10048,15998,16833,5298,7668,8216,-4334
"3556","Newham 011A","E01003533","E02000724","Newham 011","E09000025","Newham","E12000007","London",1880,1845,35,164.3,482,3.8,"00BB","Newham",NA,3538,1542,9394,14976,8337,7642,12202,14965,4799,6100,2808,-11
"3555","Newham 010E","E01003534","E02000723","Newham 010","E09000025","Newham","E12000007","London",2395,2395,0,174.6,643,3.7,"00BB","Newham",NA,4366,2164,9679,9813,8084,8334,12286,13029,3718,6170,2607,3216
"3609","Newham 023A","E01003535","E02000736","Newham 023","E09000025","Newham","E12000007","London",1691,1654,37,33.9,548,3,"00BB","Newham",NA,2702,2099,4656,8848,2432,2432,4254,4754,-270,333,-402,-4094
"3610","Newham 023B","E01003536","E02000736","Newham 023","E09000025","Newham","E12000007","London",1843,1843,0,105.4,598,3.1,"00BB","Newham",NA,5200,4718,12081,12558,7767,7236,14154,11207,2567,2518,2073,-1351
"3616","Newham 024C","E01003537","E02000737","Newham 024","E09000025","Newham","E12000007","London",2062,2062,0,106.3,668,3.1,"00BB","Newham",NA,7413,6796,12256,15220,9719,9713,14935,15563,2306,2917,2679,343
"3635","Newham 029A","E01003538","E02000742","Newham 029","E09000025","Newham","E12000007","London",2084,2035,49,119.8,652,3.1,"00BB","Newham",NA,3624,2263,9342,13483,5794,4926,8694,11018,2170,2663,-648,-2465
"3636","Newham 029B","E01003539","E02000742","Newham 029","E09000025","Newham","E12000007","London",2217,2217,0,89.3,681,3.3,"00BB","Newham",NA,5987,3562,9948,14310,8551,7579,13602,12584,2564,4017,3654,-1726
"3637","Newham 029C","E01003540","E02000742","Newham 029","E09000025","Newham","E12000007","London",1833,1833,0,88.3,595,3.1,"00BB","Newham",NA,1827,2401,5986,10338,3865,5388,7301,8235,2038,2987,1315,-2103
"3638","Newham 029D","E01003541","E02000742","Newham 029","E09000025","Newham","E12000007","London",1871,1867,4,116.1,570,3.3,"00BB","Newham",NA,5728,4993,10342,11559,10102,8905,15377,12946,4374,3912,5035,1387
"3617","Newham 024D","E01003542","E02000737","Newham 024","E09000025","Newham","E12000007","London",1974,1974,0,147.1,668,3,"00BB","Newham",NA,3383,1917,5789,14381,4467,4457,6280,8245,1084,2540,491,-6136
"3514","Newham 001A","E01003543","E02000714","Newham 001","E09000025","Newham","E12000007","London",2475,2475,0,149.5,850,2.9,"00BB","Newham",NA,4834,3348,7794,23551,12005,10710,14358,19984,7171,7362,6564,-3567
"3515","Newham 001B","E01003544","E02000714","Newham 001","E09000025","Newham","E12000007","London",1938,1938,0,127.8,664,2.9,"00BB","Newham",NA,6201,4994,13111,15759,6743,7925,12041,11090,542,2931,-1070,-4669
"3534","Newham 006A","E01003545","E02000719","Newham 006","E09000025","Newham","E12000007","London",1727,1727,0,101.8,644,2.7,"00BB","Newham",NA,4951,3228,6642,15716,5944,7190,9354,11107,993,3962,2712,-4609
"3516","Newham 001C","E01003546","E02000714","Newham 001","E09000025","Newham","E12000007","London",1940,1940,0,166.8,588,3.3,"00BB","Newham",NA,4924,2700,10371,15090,6353,5942,9161,14994,1429,3242,-1210,-96
"3538","Newham 007A","E01003547","E02000720","Newham 007","E09000025","Newham","E12000007","London",1939,1925,14,108.7,699,2.8,"00BB","Newham",NA,6900,5830,8356,26712,13613,14164,13542,21894,6713,8334,5186,-4818
"3535","Newham 006B","E01003548","E02000719","Newham 006","E09000025","Newham","E12000007","London",2353,2351,2,102.3,852,2.8,"00BB","Newham",NA,5457,3732,10647,17245,8566,10423,15712,13114,3109,6691,5065,-4131
"3536","Newham 006C","E01003549","E02000719","Newham 006","E09000025","Newham","E12000007","London",2105,2105,0,177.8,790,2.7,"00BB","Newham",NA,3669,4234,6426,16262,7730,10925,13558,16347,4061,6691,7132,85
"3517","Newham 001D","E01003550","E02000714","Newham 001","E09000025","Newham","E12000007","London",1780,1778,2,153.7,631,2.8,"00BB","Newham",NA,5158,4014,8786,18800,8578,7619,11323,14638,3420,3605,2537,-4162
"3547","Newham 009A","E01003551","E02000722","Newham 009","E09000025","Newham","E12000007","London",1833,1713,120,192.1,586,2.9,"00BB","Newham",NA,3496,2701,4998,20911,6014,7597,10005,15072,2518,4896,5007,-5839
"3579","Newham 016A","E01003552","E02000729","Newham 016","E09000025","Newham","E12000007","London",1719,1708,11,161.6,544,3.1,"00BB","Newham",NA,5243,5019,7211,17134,7809,7247,10208,16214,2566,2228,2997,-920
"3548","Newham 009B","E01003553","E02000722","Newham 009","E09000025","Newham","E12000007","London",1927,1926,1,185.1,733,2.6,"00BB","Newham",NA,3449,3093,6218,17261,4814,4959,7543,17209,1365,1866,1325,-52
"3549","Newham 009C","E01003554","E02000722","Newham 009","E09000025","Newham","E12000007","London",1861,1861,0,190.3,623,3,"00BB","Newham",NA,6373,6603,10610,19345,11429,12365,15397,19823,5056,5762,4787,478
"3539","Newham 007B","E01003555","E02000720","Newham 007","E09000025","Newham","E12000007","London",1842,1842,0,109.3,500,3.7,"00BB","Newham",NA,4415,4628,8295,20498,9473,11031,14377,17144,5058,6403,6082,-3354
"3542","Newham 008A","E01003556","E02000721","Newham 008","E09000025","Newham","E12000007","London",1913,1741,172,138.7,629,2.8,"00BB","Newham",NA,2715,4420,6985,16680,3902,7685,9822,10510,1187,3265,2837,-6170
"3537","Newham 006D","E01003557","E02000719","Newham 006","E09000025","Newham","E12000007","London",2031,1958,73,115.2,651,3,"00BB","Newham",NA,2552,2303,5089,16786,4482,6595,7473,16157,1930,4292,2384,-629
"3543","Newham 008B","E01003558","E02000721","Newham 008","E09000025","Newham","E12000007","London",1631,1572,59,108.4,491,3.2,"00BB","Newham",NA,2462,1559,7933,12705,3798,5697,6514,11110,1336,4138,-1419,-1595
"3550","Newham 009D","E01003559","E02000722","Newham 009","E09000025","Newham","E12000007","London",2605,2585,20,168.1,1001,2.6,"00BB","Newham",NA,5476,6698,12423,19165,11687,13688,18818,20730,6211,6990,6395,1565
"3557","Newham 011B","E01003560","E02000724","Newham 011","E09000025","Newham","E12000007","London",1842,1818,24,231.7,448,4.1,"00BB","Newham",NA,4055,1724,8604,15561,9944,10262,13170,12289,5889,8538,4566,-3272
"3540","Newham 007C","E01003561","E02000720","Newham 007","E09000025","Newham","E12000007","London",1880,1880,0,236.2,481,3.9,"00BB","Newham",NA,5334,2879,9788,17054,10529,11651,16877,14082,5195,8772,7089,-2972
"3570","Newham 014A","E01003562","E02000727","Newham 014","E09000025","Newham","E12000007","London",2200,2200,0,223.8,576,3.8,"00BB","Newham",NA,4451,3583,10081,12344,9043,9981,13428,14726,4592,6398,3347,2382
"3558","Newham 011C","E01003563","E02000724","Newham 011","E09000025","Newham","E12000007","London",2036,2030,6,223.7,538,3.8,"00BB","Newham",NA,5590,3865,10639,13143,8597,8741,13224,10082,3007,4876,2585,-3061
"3571","Newham 014B","E01003564","E02000727","Newham 014","E09000025","Newham","E12000007","London",2460,2460,0,225.9,672,3.7,"00BB","Newham",NA,4359,3030,8891,12988,7485,8190,11824,13819,3126,5160,2933,831
"3572","Newham 014C","E01003565","E02000727","Newham 014","E09000025","Newham","E12000007","London",1853,1849,4,205.4,496,3.7,"00BB","Newham",NA,4914,3744,10213,13603,9086,9526,17118,14919,4172,5782,6905,1316
"3573","Newham 014D","E01003566","E02000727","Newham 014","E09000025","Newham","E12000007","London",1792,1792,0,184.2,507,3.5,"00BB","Newham",NA,3573,2602,7769,13977,5913,7927,11559,10832,2340,5325,3790,-3145
"3541","Newham 007D","E01003567","E02000720","Newham 007","E09000025","Newham","E12000007","London",1822,1822,0,185.5,540,3.4,"00BB","Newham",NA,3593,2210,12704,13926,7085,5456,11284,11627,3492,3246,-1420,-2299
"3583","Newham 017A","E01003568","E02000730","Newham 017","E09000025","Newham","E12000007","London",2302,2302,0,209.7,594,3.9,"00BB","Newham",NA,5806,3370,12222,13061,10184,9133,15597,15546,4378,5763,3375,2485
"3584","Newham 017B","E01003569","E02000730","Newham 017","E09000025","Newham","E12000007","London",1899,1899,0,181.2,509,3.7,"00BB","Newham",NA,4315,3108,7466,15648,7223,8501,16009,14161,2908,5393,8543,-1487
"3544","Newham 008C","E01003570","E02000721","Newham 008","E09000025","Newham","E12000007","London",2065,2050,15,201.3,585,3.5,"00BB","Newham",NA,2023,1301,7123,9553,7061,6484,11118,11024,5038,5183,3995,1471
"3545","Newham 008D","E01003571","E02000721","Newham 008","E09000025","Newham","E12000007","London",2277,2270,7,216.9,586,3.9,"00BB","Newham",NA,4753,3190,10625,12758,8434,7885,12256,13110,3681,4695,1631,352
"3546","Newham 008E","E01003572","E02000721","Newham 008","E09000025","Newham","E12000007","London",1779,1765,14,189.7,446,4,"00BB","Newham",NA,3194,1081,7191,9199,7991,6936,10303,13797,4797,5855,3112,4598
"3585","Newham 017C","E01003573","E02000730","Newham 017","E09000025","Newham","E12000007","London",2154,2142,12,216.3,542,4,"00BB","Newham",NA,4189,2939,9220,13108,10111,9927,15323,12752,5922,6988,6103,-356
"3586","Newham 017D","E01003574","E02000730","Newham 017","E09000025","Newham","E12000007","London",2637,2613,24,139.4,798,3.3,"00BB","Newham",NA,5079,2658,9201,15510,8682,8781,14082,15462,3603,6123,4881,-48
"3531","Newham 005B","E01003575","E02000718","Newham 005","E09000025","Newham","E12000007","London",1702,1698,4,115.5,491,3.5,"00BB","Newham",NA,3073,1310,7553,17342,7295,6631,11347,9373,4222,5321,3794,-7969
"3518","Newham 002A","E01003576","E02000715","Newham 002","E09000025","Newham","E12000007","London",1954,1940,14,138,710,2.7,"00BB","Newham",NA,1401,1593,4610,11657,3604,4724,5701,12166,2203,3131,1091,509
"3532","Newham 005C","E01003577","E02000718","Newham 005","E09000025","Newham","E12000007","London",1920,1920,0,109.8,673,2.9,"00BB","Newham",NA,1404,400,4188,8666,1629,966,2893,10955,225,566,-1295,2289
"3522","Newham 003A","E01003578","E02000716","Newham 003","E09000025","Newham","E12000007","London",1944,1943,1,23.5,601,3.2,"00BB","Newham",NA,2372,1831,8421,11905,6344,7710,14592,9741,3972,5879,6171,-2164
"3526","Newham 004A","E01003579","E02000717","Newham 004","E09000025","Newham","E12000007","London",1850,1850,0,188.2,499,3.7,"00BB","Newham",NA,2783,1325,6978,11693,7508,7712,11390,8995,4725,6387,4412,-2698
"3533","Newham 005D","E01003580","E02000718","Newham 005","E09000025","Newham","E12000007","London",1836,1836,0,82.2,615,3,"00BB","Newham",NA,3458,2032,6563,11333,5210,5499,8117,9910,1752,3467,1554,-1423
"3519","Newham 002B","E01003581","E02000715","Newham 002","E09000025","Newham","E12000007","London",1848,1845,3,181.9,486,3.8,"00BB","Newham",NA,4119,1922,8538,16645,7237,8177,13079,10807,3118,6255,4541,-5838
"3520","Newham 002C","E01003582","E02000715","Newham 002","E09000025","Newham","E12000007","London",1613,1613,0,188.2,499,3.2,"00BB","Newham",NA,4328,1623,9137,11375,5904,5454,8569,9143,1576,3831,-568,-2232
"3521","Newham 002D","E01003583","E02000715","Newham 002","E09000025","Newham","E12000007","London",1966,1913,53,200.4,539,3.5,"00BB","Newham",NA,3996,1633,8890,12214,7709,8181,12260,13448,3713,6548,3370,1234
"3523","Newham 003B","E01003584","E02000716","Newham 003","E09000025","Newham","E12000007","London",2073,2057,16,62.8,638,3.2,"00BB","Newham",NA,8131,6033,14032,22303,8201,8333,10419,17851,70,2300,-3613,-4452
"3527","Newham 004B","E01003585","E02000717","Newham 004","E09000025","Newham","E12000007","London",1649,1649,0,226.2,407,4.1,"00BB","Newham",NA,3198,1183,9680,9421,7260,6133,11366,8486,4062,4950,1686,-935
"3524","Newham 003C","E01003586","E02000716","Newham 003","E09000025","Newham","E12000007","London",1751,1751,0,117.4,509,3.4,"00BB","Newham",NA,3535,2731,8594,12451,8372,8810,12185,11403,4837,6079,3591,-1048
"3528","Newham 004C","E01003587","E02000717","Newham 004","E09000025","Newham","E12000007","London",2436,2436,0,149.5,823,3,"00BB","Newham",NA,3850,1536,10058,15331,7775,7068,12761,16642,3925,5532,2703,1311
"3559","Newham 011D","E01003588","E02000724","Newham 011","E09000025","Newham","E12000007","London",1786,1785,1,239.4,454,3.9,"00BB","Newham",NA,3366,1881,9216,10157,8412,7543,13065,13723,5046,5662,3849,3566
"3560","Newham 011E","E01003589","E02000724","Newham 011","E09000025","Newham","E12000007","London",1871,1871,0,136.1,512,3.7,"00BB","Newham",NA,5068,2450,12339,16530,9290,7292,15185,14959,4222,4842,2846,-1571
"3525","Newham 003D","E01003590","E02000716","Newham 003","E09000025","Newham","E12000007","London",1586,1488,98,61.5,572,2.6,"00BB","Newham",NA,3398,3591,6256,16736,2570,3097,5076,11392,-828,-494,-1180,-5344
"3529","Newham 004D","E01003591","E02000717","Newham 004","E09000025","Newham","E12000007","London",2166,2166,0,131.6,671,3.2,"00BB","Newham",NA,1436,1270,4952,10405,5317,6009,9829,10503,3881,4739,4877,98
"3606","Newham 022B","E01003592","E02000735","Newham 022","E09000025","Newham","E12000007","London",1842,1829,13,125.9,555,3.3,"00BB","Newham",NA,5114,4443,8490,15531,7075,8107,13005,12981,1961,3664,4515,-2550
"3630","Newham 027D","E01003593","E02000740","Newham 027","E09000025","Newham","E12000007","London",1550,1539,11,142.5,559,2.8,"00BB","Newham",NA,3531,2381,6746,14588,5871,4147,5693,15144,2340,1766,-1053,556
"3623","Newham 026A","E01003594","E02000739","Newham 026","E09000025","Newham","E12000007","London",1729,1721,8,149.1,540,3.2,"00BB","Newham",NA,5837,4819,9839,14164,5924,5844,7816,14833,87,1025,-2023,669
"3624","Newham 026B","E01003595","E02000739","Newham 026","E09000025","Newham","E12000007","London",1532,1526,6,165.6,581,2.6,"00BB","Newham",NA,4773,2898,9396,15231,5481,5285,9012,13567,708,2387,-384,-1664
"3580","Newham 016B","E01003596","E02000729","Newham 016","E09000025","Newham","E12000007","London",1777,1770,7,159.1,577,3.1,"00BB","Newham",NA,4775,4465,8701,17545,8325,8186,13913,16044,3550,3721,5212,-1501
"3581","Newham 016C","E01003597","E02000729","Newham 016","E09000025","Newham","E12000007","London",1639,1639,0,182.5,475,3.5,"00BB","Newham",NA,5523,3106,9693,18042,9568,9817,12458,15564,4045,6711,2765,-2478
"3601","Newham 021A","E01003598","E02000734","Newham 021","E09000025","Newham","E12000007","London",1897,1897,0,264.2,658,2.9,"00BB","Newham",NA,3238,1923,4427,16791,5065,3080,6179,14199,1827,1157,1752,-2592
"3607","Newham 022C","E01003599","E02000735","Newham 022","E09000025","Newham","E12000007","London",1611,1611,0,120.2,488,3.3,"00BB","Newham",NA,3110,1458,7021,15103,5938,5774,10212,11891,2828,4316,3191,-3212
"3602","Newham 021B","E01003600","E02000734","Newham 021","E09000025","Newham","E12000007","London",1893,1893,0,171.9,690,2.7,"00BB","Newham",NA,3524,2567,6001,12011,4549,3857,6864,9882,1025,1290,863,-2129
"3631","Newham 028A","E01003601","E02000741","Newham 028","E09000025","Newham","E12000007","London",2130,2118,12,60.2,705,3,"00BB","Newham",NA,1856,1515,7034,10044,4620,4093,6461,10396,2764,2578,-573,352
"3625","Newham 026C","E01003602","E02000739","Newham 026","E09000025","Newham","E12000007","London",1985,1985,0,166.5,605,3.3,"00BB","Newham",NA,4503,4056,8696,17737,9769,10542,14348,13857,5266,6486,5652,-3880
"3632","Newham 028B","E01003603","E02000741","Newham 028","E09000025","Newham","E12000007","London",1947,1921,26,96,624,3.1,"00BB","Newham",NA,6498,5455,13051,20584,9284,7651,14089,12320,2786,2196,1038,-8264
"3646","Newham 031D","E01003604","E02000744","Newham 031","E09000025","Newham","E12000007","London",2358,2354,4,106.6,785,3,"00BB","Newham",NA,2726,1835,6925,11273,6131,6279,10315,10121,3405,4444,3390,-1152
"3633","Newham 028C","E01003605","E02000741","Newham 028","E09000025","Newham","E12000007","London",2112,2112,0,199.1,724,2.9,"00BB","Newham",NA,2737,1150,6137,14927,8108,6965,12274,10963,5371,5815,6137,-3964
"3608","Newham 022D","E01003606","E02000735","Newham 022","E09000025","Newham","E12000007","London",2152,2130,22,130.8,675,3.2,"00BB","Newham",NA,4287,2761,9682,18566,7041,8684,13223,9525,2754,5923,3541,-9041
"3626","Newham 026D","E01003607","E02000739","Newham 026","E09000025","Newham","E12000007","London",1648,1648,0,131.1,560,2.9,"00BB","Newham",NA,3489,2144,9168,15768,5604,5486,9560,16022,2115,3342,392,254
"3634","Newham 028D","E01003608","E02000741","Newham 028","E09000025","Newham","E12000007","London",2072,2072,0,222.8,714,2.9,"00BB","Newham",NA,9303,8432,17279,16126,10877,13593,17595,19472,1574,5161,316,3346
"3672","Newham 037A","E01003609","E02000750","Newham 037","E09000025","Newham","E12000007","London",2702,2693,9,28.8,1058,2.5,"00BB","Newham",NA,1055,930,2951,8199,8710,5862,10600,19096,7655,4932,7649,10897
"3673","Newham 037C","E01003611","E02000750","Newham 037","E09000025","Newham","E12000007","London",1803,1803,0,120.3,700,2.6,"00BB","Newham",NA,2283,1076,4377,12088,4901,2425,5396,13472,2618,1349,1019,1384
"3565","Newham 013C","E01003615","E02000726","Newham 013","E09000025","Newham","E12000007","London",1835,1835,0,170.1,643,2.9,"00BB","Newham",NA,3688,2046,6862,19351,8775,8278,13216,16743,5087,6232,6354,-2608
"3561","Newham 012A","E01003616","E02000725","Newham 012","E09000025","Newham","E12000007","London",1650,1650,0,113.4,658,2.5,"00BB","Newham",NA,5100,3217,11004,18536,7119,8939,12173,17316,2019,5722,1169,-1220
"3562","Newham 012B","E01003617","E02000725","Newham 012","E09000025","Newham","E12000007","London",2769,2769,0,119,1103,2.5,"00BB","Newham",NA,2016,1968,6820,10745,7316,10804,15368,19771,5300,8836,8548,9026
"3563","Newham 012C","E01003618","E02000725","Newham 012","E09000025","Newham","E12000007","London",2193,2159,34,136.7,823,2.6,"00BB","Newham",NA,5254,5570,14973,18680,9372,12343,19814,22030,4118,6773,4841,3350
"3564","Newham 012D","E01003619","E02000725","Newham 012","E09000025","Newham","E12000007","London",2264,2195,69,88.9,1087,2,"00BB","Newham",NA,1685,2216,4001,15943,4221,5480,8312,19567,2536,3264,4311,3624
"3611","Newham 023C","E01003621","E02000736","Newham 023","E09000025","Newham","E12000007","London",1667,1664,3,248.8,442,3.8,"00BB","Newham",NA,6248,3013,13416,14566,10921,11397,19525,10339,4673,8384,6109,-4227
"3612","Newham 023D","E01003622","E02000736","Newham 023","E09000025","Newham","E12000007","London",1613,1613,0,66.7,496,3.3,"00BB","Newham",NA,3361,3109,7254,14308,4962,7752,7648,8108,1601,4643,394,-6200
"3613","Newham 023E","E01003623","E02000736","Newham 023","E09000025","Newham","E12000007","London",1757,1757,0,64.6,490,3.6,"00BB","Newham",NA,3426,1548,8159,7794,4603,3967,7604,8176,1177,2419,-555,382
"3618","Newham 024E","E01003624","E02000737","Newham 024","E09000025","Newham","E12000007","London",1582,1582,0,110.7,493,3.2,"00BB","Newham",NA,4591,2730,8710,13628,5790,4525,7696,10501,1199,1795,-1014,-3127
"3574","Newham 015A","E01003625","E02000728","Newham 015","E09000025","Newham","E12000007","London",1697,1697,0,53.2,484,3.5,"00BB","Newham",NA,6568,5068,14122,17893,7012,9861,12382,12005,444,4793,-1740,-5888
"3575","Newham 015B","E01003626","E02000728","Newham 015","E09000025","Newham","E12000007","London",1590,1590,0,155.1,420,3.8,"00BB","Newham",NA,7582,6820,17451,13044,11125,12887,17161,17835,3543,6067,-290,4791
"3576","Newham 015C","E01003627","E02000728","Newham 015","E09000025","Newham","E12000007","London",1603,1603,0,210.1,432,3.7,"00BB","Newham",NA,7509,3735,14580,20660,9363,8074,15338,10606,1854,4339,758,-10054
"3577","Newham 015D","E01003628","E02000728","Newham 015","E09000025","Newham","E12000007","London",1665,1665,0,179.2,420,4,"00BB","Newham",NA,9073,6051,18879,20630,12170,12483,19058,19012,3097,6432,179,-1618
"3578","Newham 015E","E01003629","E02000728","Newham 015","E09000025","Newham","E12000007","London",1672,1672,0,256.8,481,3.5,"00BB","Newham",NA,7323,6700,14815,14278,7868,8141,15358,12906,545,1441,543,-1372
"3603","Newham 021C","E01003630","E02000734","Newham 021","E09000025","Newham","E12000007","London",2011,2011,0,192.6,731,2.8,"00BB","Newham",NA,3928,3414,6861,17543,6678,5954,10823,13655,2750,2540,3962,-3888
"3596","Newham 020A","E01003631","E02000733","Newham 020","E09000025","Newham","E12000007","London",1832,1832,0,110.6,727,2.5,"00BB","Newham",NA,5343,4765,9521,16582,7667,6940,12266,17126,2324,2175,2745,544
"3597","Newham 020B","E01003632","E02000733","Newham 020","E09000025","Newham","E12000007","London",2268,2268,0,165.7,749,3,"00BB","Newham",NA,7579,5673,15454,21845,11388,10446,13878,14090,3809,4773,-1576,-7755
"3598","Newham 020C","E01003633","E02000733","Newham 020","E09000025","Newham","E12000007","London",1871,1871,0,194.5,685,2.7,"00BB","Newham",NA,1784,644,3790,11753,3386,2530,3330,9726,1602,1886,-460,-2027
"3599","Newham 020D","E01003634","E02000733","Newham 020","E09000025","Newham","E12000007","London",1805,1805,0,124.3,602,3,"00BB","Newham",NA,2096,1080,4594,7921,5486,4284,7016,11692,3390,3204,2422,3771
"3582","Newham 016D","E01003635","E02000729","Newham 016","E09000025","Newham","E12000007","London",1945,1945,0,49.1,611,3.2,"00BB","Newham",NA,5611,5769,10123,21647,9493,12587,13710,18652,3882,6818,3587,-2995
"3600","Newham 020E","E01003636","E02000733","Newham 020","E09000025","Newham","E12000007","London",1978,1976,2,100.9,702,2.8,"00BB","Newham",NA,1468,957,4040,13441,4862,3751,8657,13159,3394,2794,4617,-282
"3604","Newham 021D","E01003637","E02000734","Newham 021","E09000025","Newham","E12000007","London",1841,1839,2,195.6,593,3.1,"00BB","Newham",NA,5123,3208,8569,19478,9820,9837,15148,19601,4697,6629,6579,123
"3748","Redbridge 017A","E01003638","E02000767","Redbridge 017","E09000026","Redbridge","E12000007","London",1611,1611,0,60.2,590,2.7,"00BC","Redbridge",NA,15238,9825,12535,20129,15454,12574,13417,18932,216,2749,882,-1197
"3733","Redbridge 013A","E01003639","E02000763","Redbridge 013","E09000026","Redbridge","E12000007","London",1758,1758,0,16.9,665,2.6,"00BC","Redbridge",NA,9041,7577,9155,16220,9787,8968,11362,15172,746,1391,2207,-1048
"3734","Redbridge 013B","E01003640","E02000763","Redbridge 013","E09000026","Redbridge","E12000007","London",1771,1771,0,2.9,648,2.7,"00BC","Redbridge",NA,13946,14179,18762,24691,14308,16463,17839,21675,362,2284,-923,-3016
"3735","Redbridge 013C","E01003641","E02000763","Redbridge 013","E09000026","Redbridge","E12000007","London",1704,1692,12,64.3,530,3.2,"00BC","Redbridge",NA,17128,12256,18157,24555,18656,15188,19728,24455,1528,2932,1571,-100
"3736","Redbridge 013D","E01003642","E02000763","Redbridge 013","E09000026","Redbridge","E12000007","London",1695,1689,6,55.6,542,3.1,"00BC","Redbridge",NA,11857,6793,13175,22919,13965,10229,12844,21440,2108,3436,-331,-1479
"3749","Redbridge 017B","E01003643","E02000767","Redbridge 017","E09000026","Redbridge","E12000007","London",1833,1796,37,91.6,622,2.9,"00BC","Redbridge",NA,20701,13333,20882,25624,20220,18380,20907,23546,-481,5047,25,-2078
"3750","Redbridge 017C","E01003644","E02000767","Redbridge 017","E09000026","Redbridge","E12000007","London",1562,1562,0,99.9,498,3.1,"00BC","Redbridge",NA,16381,13937,16312,23640,19382,15967,18949,23961,3001,2030,2637,321
"3751","Redbridge 017D","E01003645","E02000767","Redbridge 017","E09000026","Redbridge","E12000007","London",2610,2506,104,103.2,910,2.8,"00BC","Redbridge",NA,12190,6927,14897,25055,12174,13952,21457,20081,-16,7025,6560,-4974
"3729","Redbridge 012A","E01003646","E02000762","Redbridge 012","E09000026","Redbridge","E12000007","London",1749,1742,7,85.4,572,3,"00BC","Redbridge",NA,13549,11451,16445,27594,18267,15104,20778,26301,4718,3653,4333,-1293
"3744","Redbridge 015A","E01003647","E02000765","Redbridge 015","E09000026","Redbridge","E12000007","London",1786,1786,0,112.1,612,2.9,"00BC","Redbridge",NA,17544,13181,20308,26961,19441,19775,23645,26925,1897,6594,3337,-36
"3730","Redbridge 012B","E01003648","E02000762","Redbridge 012","E09000026","Redbridge","E12000007","London",1437,1437,0,66.2,528,2.7,"00BC","Redbridge",NA,23224,22928,24233,23447,27033,23407,23552,24655,3809,479,-681,1208
"3731","Redbridge 012C","E01003649","E02000762","Redbridge 012","E09000026","Redbridge","E12000007","London",1633,1627,6,88.3,521,3.1,"00BC","Redbridge",NA,19354,18109,14920,27207,23813,18391,23264,27269,4459,282,8344,62
"3745","Redbridge 015B","E01003650","E02000765","Redbridge 015","E09000026","Redbridge","E12000007","London",1513,1513,0,78.1,580,2.6,"00BC","Redbridge",NA,15612,10941,13475,22787,16398,11547,15923,24335,786,606,2448,1548
"3732","Redbridge 012D","E01003651","E02000762","Redbridge 012","E09000026","Redbridge","E12000007","London",1471,1467,4,76.3,466,3.1,"00BC","Redbridge",NA,22534,17827,24862,28668,19867,16364,20968,30150,-2667,-1463,-3894,1482
"3746","Redbridge 015C","E01003652","E02000765","Redbridge 015","E09000026","Redbridge","E12000007","London",1549,1543,6,91.5,482,3.2,"00BC","Redbridge",NA,23418,19768,20918,28212,23631,16037,21461,27665,213,-3731,543,-547
"3747","Redbridge 015D","E01003653","E02000765","Redbridge 015","E09000026","Redbridge","E12000007","London",1471,1471,0,71.8,516,2.9,"00BC","Redbridge",NA,12679,10863,11900,24310,18578,18357,22233,23714,5899,7494,10333,-596
"3693","Redbridge 004A","E01003654","E02000754","Redbridge 004","E09000026","Redbridge","E12000007","London",1563,1563,0,66.7,603,2.6,"00BC","Redbridge",NA,14712,12151,13289,17770,12851,11981,14602,22261,-1861,-170,1313,4491
"3694","Redbridge 004B","E01003655","E02000754","Redbridge 004","E09000026","Redbridge","E12000007","London",1510,1510,0,67.3,642,2.4,"00BC","Redbridge",NA,22877,21958,24893,21804,22686,20764,23301,25199,-191,-1194,-1592,3395
"3697","Redbridge 005A","E01003656","E02000755","Redbridge 005","E09000026","Redbridge","E12000007","London",1489,1489,0,27.5,643,2.3,"00BC","Redbridge",NA,9601,7417,7908,14199,8210,7946,7654,10289,-1391,529,-254,-3910
"3698","Redbridge 005B","E01003657","E02000755","Redbridge 005","E09000026","Redbridge","E12000007","London",2089,2082,7,48.3,870,2.4,"00BC","Redbridge",NA,18201,15172,17742,20715,19198,17516,16315,16781,997,2344,-1427,-3934
"3695","Redbridge 004C","E01003658","E02000754","Redbridge 004","E09000026","Redbridge","E12000007","London",1649,1649,0,70.8,699,2.4,"00BC","Redbridge",NA,9694,4783,10710,17268,10119,6916,9519,11631,425,2133,-1191,-5637
"3699","Redbridge 005C","E01003659","E02000755","Redbridge 005","E09000026","Redbridge","E12000007","London",1640,1640,0,44.2,638,2.6,"00BC","Redbridge",NA,18981,16786,19531,19672,21023,20734,22198,22337,2042,3948,2667,2665
"3696","Redbridge 004D","E01003660","E02000754","Redbridge 004","E09000026","Redbridge","E12000007","London",1718,1718,0,31.7,663,2.6,"00BC","Redbridge",NA,26718,22422,24493,25399,26133,25584,27893,21671,-585,3162,3400,-3728
"3756","Redbridge 019A","E01003661","E02000769","Redbridge 019","E09000026","Redbridge","E12000007","London",1935,1902,33,92.9,651,2.9,"00BC","Redbridge",NA,15990,9211,17940,17419,12690,9725,12214,21271,-3300,514,-5726,3852
"3757","Redbridge 019B","E01003662","E02000769","Redbridge 019","E09000026","Redbridge","E12000007","London",1859,1859,0,101.7,741,2.5,"00BC","Redbridge",NA,10211,8442,10858,19712,11475,11871,12135,21394,1264,3429,1277,1682
"3758","Redbridge 019C","E01003663","E02000769","Redbridge 019","E09000026","Redbridge","E12000007","London",1822,1757,65,57.7,662,2.7,"00BC","Redbridge",NA,15123,12105,14945,16906,14746,12370,17393,20961,-377,265,2448,4055
"3759","Redbridge 019D","E01003664","E02000769","Redbridge 019","E09000026","Redbridge","E12000007","London",1776,1776,0,106.3,575,3.1,"00BC","Redbridge",NA,20288,16585,18712,23003,16108,11693,15783,21000,-4180,-4892,-2929,-2003
"3760","Redbridge 019E","E01003665","E02000769","Redbridge 019","E09000026","Redbridge","E12000007","London",1648,1648,0,96.1,529,3.1,"00BC","Redbridge",NA,23975,18399,24747,18661,19539,15863,21174,18569,-4436,-2536,-3573,-92
"3761","Redbridge 019F","E01003666","E02000769","Redbridge 019","E09000026","Redbridge","E12000007","London",2198,2198,0,99.6,935,2.4,"00BC","Redbridge",NA,13208,8429,14488,21682,11077,7258,11476,19236,-2131,-1171,-3012,-2446
"3707","Redbridge 007A","E01003668","E02000757","Redbridge 007","E09000026","Redbridge","E12000007","London",1622,1610,12,73.7,755,2.1,"00BC","Redbridge",NA,20095,21245,21762,31006,24309,22418,26745,31379,4214,1173,4983,373
"3708","Redbridge 007B","E01003669","E02000757","Redbridge 007","E09000026","Redbridge","E12000007","London",1528,1528,0,86,606,2.5,"00BC","Redbridge",NA,24232,27154,24486,31146,26137,30873,29161,31906,1905,3719,4675,760
"3709","Redbridge 007C","E01003670","E02000757","Redbridge 007","E09000026","Redbridge","E12000007","London",1496,1496,0,61.4,577,2.6,"00BC","Redbridge",NA,19941,19331,19647,26554,23201,22239,22802,29143,3260,2908,3155,2589
"3710","Redbridge 007D","E01003671","E02000757","Redbridge 007","E09000026","Redbridge","E12000007","London",1533,1533,0,75.9,552,2.8,"00BC","Redbridge",NA,29545,29620,29480,30728,31592,30919,30653,31334,2047,1299,1173,606
"3711","Redbridge 007E","E01003672","E02000757","Redbridge 007","E09000026","Redbridge","E12000007","London",1430,1430,0,78.1,690,2.1,"00BC","Redbridge",NA,12956,9767,15008,29944,13129,10119,15561,22883,173,352,553,-7061
"3712","Redbridge 007F","E01003673","E02000757","Redbridge 007","E09000026","Redbridge","E12000007","London",1778,1778,0,90.1,789,2.3,"00BC","Redbridge",NA,17947,20233,23077,29188,21308,28356,29281,27558,3361,8123,6204,-1630
"3713","Redbridge 007G","E01003674","E02000757","Redbridge 007","E09000026","Redbridge","E12000007","London",2129,2099,30,79.6,1000,2.1,"00BC","Redbridge",NA,15528,13266,19609,30821,23430,23775,29770,30541,7902,10509,10161,-280
"3831","Redbridge 036A","E01003675","E02006925","Redbridge 036","E09000026","Redbridge","E12000007","London",1619,1619,0,70.2,490,3.3,"00BC","Redbridge",NA,17024,14239,21634,28091,20997,19003,23886,28231,3973,4764,2252,140
"3832","Redbridge 036B","E01003676","E02006925","Redbridge 036","E09000026","Redbridge","E12000007","London",1690,1690,0,89.1,495,3.4,"00BC","Redbridge",NA,17231,12451,16693,28811,19666,15354,16370,28309,2435,2903,-323,-502
"3833","Redbridge 036C","E01003677","E02006925","Redbridge 036","E09000026","Redbridge","E12000007","London",1547,1547,0,25.3,494,3.1,"00BC","Redbridge",NA,23143,16864,24260,27799,22773,18254,22502,26289,-370,1390,-1758,-1510
"3834","Redbridge 036D","E01003678","E02006925","Redbridge 036","E09000026","Redbridge","E12000007","London",1605,1605,0,59.9,479,3.4,"00BC","Redbridge",NA,20820,15881,22490,23496,23233,20405,26076,29739,2413,4524,3586,6243
"3835","Redbridge 036E","E01003679","E02006925","Redbridge 036","E09000026","Redbridge","E12000007","London",1621,1621,0,72.3,493,3.3,"00BC","Redbridge",NA,22841,18686,23260,25564,22996,20845,22263,26788,155,2159,-997,1224
"3836","Redbridge 036F","E01003680","E02006925","Redbridge 036","E09000026","Redbridge","E12000007","London",1619,1619,0,78.8,475,3.4,"00BC","Redbridge",NA,24589,18572,26278,26185,26418,26124,25078,23995,1829,7552,-1200,-2190
"3837","Redbridge 036G","E01003681","E02006925","Redbridge 036","E09000026","Redbridge","E12000007","London",1844,1844,0,38.1,683,2.7,"00BC","Redbridge",NA,14903,12085,21423,26544,16119,11781,19646,24281,1216,-304,-1777,-2263
"3838","Redbridge 036H","E01003682","E02006925","Redbridge 036","E09000026","Redbridge","E12000007","London",1696,1696,0,61,493,3.4,"00BC","Redbridge",NA,21400,20802,21016,27640,22963,19863,24349,27913,1563,-939,3333,273
"3792","Redbridge 030A","E01003683","E02000780","Redbridge 030","E09000026","Redbridge","E12000007","London",2144,2144,0,178.2,576,3.7,"00BC","Redbridge",NA,9486,3458,10468,14804,11384,7599,13658,13288,1898,4141,3190,-1516
"3793","Redbridge 030B","E01003684","E02000780","Redbridge 030","E09000026","Redbridge","E12000007","London",1780,1780,0,158.1,496,3.6,"00BC","Redbridge",NA,10612,4254,10969,21739,13007,8485,14054,18120,2395,4231,3085,-3619
"3794","Redbridge 030C","E01003685","E02000780","Redbridge 030","E09000026","Redbridge","E12000007","London",1822,1822,0,159.5,508,3.6,"00BC","Redbridge",NA,9685,4369,12405,13291,9910,6995,13035,17058,225,2626,630,3767
"3795","Redbridge 030D","E01003686","E02000780","Redbridge 030","E09000026","Redbridge","E12000007","London",1952,1952,0,118,533,3.7,"00BC","Redbridge",NA,6145,4022,6864,15712,7771,7426,9426,14463,1626,3404,2562,-1249
"3796","Redbridge 030F","E01003688","E02000780","Redbridge 030","E09000026","Redbridge","E12000007","London",1804,1791,13,134.5,532,3.4,"00BC","Redbridge",NA,8366,6027,8856,16663,9074,9540,13620,12012,708,3513,4764,-4651
"3797","Redbridge 030G","E01003689","E02000780","Redbridge 030","E09000026","Redbridge","E12000007","London",1580,1580,0,63.6,508,3.1,"00BC","Redbridge",NA,6173,4591,7921,16514,4619,6210,10090,14115,-1554,1619,2169,-2399
"3823","Redbridge 035A","E01003690","E02006924","Redbridge 035","E09000026","Redbridge","E12000007","London",1711,1596,115,22,608,2.6,"00BC","Redbridge",NA,10048,9938,13339,27005,12350,12498,20855,24444,2302,2560,7516,-2561
"3824","Redbridge 035B","E01003691","E02006924","Redbridge 035","E09000026","Redbridge","E12000007","London",1434,1434,0,62.8,413,3.5,"00BC","Redbridge",NA,16745,12623,16191,27282,14988,10992,16843,20098,-1757,-1631,652,-7184
"3825","Redbridge 035C","E01003692","E02006924","Redbridge 035","E09000026","Redbridge","E12000007","London",1592,1585,7,105,501,3.2,"00BC","Redbridge",NA,17459,12038,17136,27261,15474,11154,17189,24403,-1985,-884,53,-2858
"3826","Redbridge 035D","E01003693","E02006924","Redbridge 035","E09000026","Redbridge","E12000007","London",1541,1541,0,34.7,431,3.6,"00BC","Redbridge",NA,19655,16447,18683,29621,18043,16031,18982,22516,-1612,-416,299,-7105
"3827","Redbridge 035E","E01003694","E02006924","Redbridge 035","E09000026","Redbridge","E12000007","London",1462,1451,11,68.5,448,3.2,"00BC","Redbridge",NA,16971,10720,18224,23944,16546,15318,19438,24040,-425,4598,1214,96
"3828","Redbridge 035F","E01003695","E02006924","Redbridge 035","E09000026","Redbridge","E12000007","London",1533,1518,15,120.8,534,2.8,"00BC","Redbridge",NA,12773,9769,10284,26526,10452,9194,8943,23038,-2321,-575,-1341,-3488
"3829","Redbridge 035G","E01003696","E02006924","Redbridge 035","E09000026","Redbridge","E12000007","London",1877,1877,0,97.7,593,3.2,"00BC","Redbridge",NA,15208,9776,13296,28418,21683,15581,25004,29060,6475,5805,11708,642
"3830","Redbridge 035H","E01003697","E02006924","Redbridge 035","E09000026","Redbridge","E12000007","London",1630,1621,9,59.8,492,3.3,"00BC","Redbridge",NA,15640,13217,17188,26164,15757,12139,17350,26623,117,-1078,162,459
"3700","Redbridge 006A","E01003698","E02000756","Redbridge 006","E09000026","Redbridge","E12000007","London",1385,1385,0,74.6,519,2.7,"00BC","Redbridge",NA,22370,19098,23436,22137,17537,18193,22623,13329,-4833,-905,-813,-8808
"3701","Redbridge 006B","E01003699","E02000756","Redbridge 006","E09000026","Redbridge","E12000007","London",1415,1415,0,16.5,594,2.4,"00BC","Redbridge",NA,19832,16804,19162,19716,18843,17820,22488,14252,-989,1016,3326,-5464
"3702","Redbridge 006C","E01003700","E02000756","Redbridge 006","E09000026","Redbridge","E12000007","London",2240,2235,5,34,849,2.6,"00BC","Redbridge",NA,12515,9481,11162,16898,13209,12444,14101,16068,694,2963,2939,-830
"3703","Redbridge 006D","E01003701","E02000756","Redbridge 006","E09000026","Redbridge","E12000007","London",1788,1788,0,60.6,626,2.9,"00BC","Redbridge",NA,17810,12503,17957,20983,14487,15346,18507,19168,-3323,2843,550,-1815
"3704","Redbridge 006E","E01003702","E02000756","Redbridge 006","E09000026","Redbridge","E12000007","London",1620,1620,0,52.3,744,2.2,"00BC","Redbridge",NA,13777,11745,16414,16246,12490,11984,13500,17280,-1287,239,-2914,1034
"3705","Redbridge 006F","E01003703","E02000756","Redbridge 006","E09000026","Redbridge","E12000007","London",2501,2501,0,25.2,968,2.6,"00BC","Redbridge",NA,15737,12535,19759,17317,15934,14854,18819,16152,197,2319,-940,-1165
"3706","Redbridge 006G","E01003704","E02000756","Redbridge 006","E09000026","Redbridge","E12000007","London",1681,1681,0,57.6,666,2.5,"00BC","Redbridge",NA,13263,8780,15705,12372,12324,9798,11821,19113,-939,1018,-3884,6741
"3725","Redbridge 010A","E01003705","E02000760","Redbridge 010","E09000026","Redbridge","E12000007","London",2192,2192,0,70.3,802,2.7,"00BC","Redbridge",NA,16086,11093,15326,20159,16674,14120,19003,18510,588,3027,3677,-1649
"3726","Redbridge 010B","E01003706","E02000760","Redbridge 010","E09000026","Redbridge","E12000007","London",1594,1594,0,82,613,2.6,"00BC","Redbridge",NA,16579,9545,16934,20255,15125,9172,16068,18761,-1454,-373,-866,-1494
"3714","Redbridge 008A","E01003707","E02000758","Redbridge 008","E09000026","Redbridge","E12000007","London",1335,1335,0,53.3,469,2.8,"00BC","Redbridge",NA,19829,19212,17709,17594,18138,14259,16832,22193,-1691,-4953,-877,4599
"3715","Redbridge 008B","E01003708","E02000758","Redbridge 008","E09000026","Redbridge","E12000007","London",1476,1476,0,33.5,613,2.4,"00BC","Redbridge",NA,8122,4564,5927,14256,6593,3287,4993,13318,-1529,-1277,-934,-938
"3716","Redbridge 008C","E01003709","E02000758","Redbridge 008","E09000026","Redbridge","E12000007","London",1627,1627,0,68.8,570,2.9,"00BC","Redbridge",NA,19639,13264,18716,22192,22219,16301,24322,18812,2580,3037,5606,-3380
"3717","Redbridge 008D","E01003710","E02000758","Redbridge 008","E09000026","Redbridge","E12000007","London",1515,1515,0,69.1,507,3,"00BC","Redbridge",NA,20534,17684,18861,20083,23368,20031,21370,20748,2834,2347,2509,665
"3727","Redbridge 010C","E01003711","E02000760","Redbridge 010","E09000026","Redbridge","E12000007","London",1812,1770,42,49.7,662,2.7,"00BC","Redbridge",NA,11247,9766,16751,19523,16750,13954,19224,22297,5503,4188,2473,2774
"3728","Redbridge 010D","E01003712","E02000760","Redbridge 010","E09000026","Redbridge","E12000007","London",1359,1359,0,80.7,536,2.5,"00BC","Redbridge",NA,5873,2709,4842,11964,4821,2419,2972,13032,-1052,-290,-1870,1068
"3816","Redbridge 034A","E01003713","E02006800","Redbridge 034","E09000026","Redbridge","E12000007","London",1744,1740,4,118.1,481,3.6,"00BC","Redbridge",NA,14297,8163,13132,22682,13467,9409,13023,19752,-830,1246,-109,-2930
"3817","Redbridge 034B","E01003714","E02006800","Redbridge 034","E09000026","Redbridge","E12000007","London",2168,2159,9,121.7,642,3.4,"00BC","Redbridge",NA,10490,7334,13576,21993,11776,9069,11982,17878,1286,1735,-1594,-4115
"3818","Redbridge 034C","E01003715","E02006800","Redbridge 034","E09000026","Redbridge","E12000007","London",1988,1970,18,127.5,564,3.5,"00BC","Redbridge",NA,10028,5403,10160,22597,11159,8897,13622,18638,1131,3494,3462,-3959
"3819","Redbridge 034D","E01003716","E02006800","Redbridge 034","E09000026","Redbridge","E12000007","London",1712,1704,8,49.3,521,3.3,"00BC","Redbridge",NA,11525,7568,13259,23007,9582,8372,11223,17148,-1943,804,-2036,-5859
"3820","Redbridge 034E","E01003718","E02006800","Redbridge 034","E09000026","Redbridge","E12000007","London",1847,1847,0,129.3,630,2.9,"00BC","Redbridge",NA,12815,9397,16637,23529,12392,11155,16943,21970,-423,1758,306,-1559
"3821","Redbridge 034F","E01003719","E02006800","Redbridge 034","E09000026","Redbridge","E12000007","London",1958,1942,16,50.9,633,3.1,"00BC","Redbridge",NA,11382,8948,14786,24681,9729,8866,12224,18787,-1653,-82,-2562,-5894
"3685","Redbridge 002A","E01003720","E02000752","Redbridge 002","E09000026","Redbridge","E12000007","London",1777,1777,0,33.7,821,2.2,"00BC","Redbridge",NA,6880,5057,4588,8442,7226,5578,4947,9992,346,521,359,1550
"3689","Redbridge 003A","E01003721","E02000753","Redbridge 003","E09000026","Redbridge","E12000007","London",1659,1609,50,90.8,604,2.7,"00BC","Redbridge",NA,12250,7404,12219,12754,12369,10959,11283,14588,119,3555,-936,1834
"3686","Redbridge 002B","E01003722","E02000752","Redbridge 002","E09000026","Redbridge","E12000007","London",1772,1772,0,64.2,690,2.6,"00BC","Redbridge",NA,7284,5927,5724,7697,10051,7767,8336,10445,2767,1840,2612,2748
"3687","Redbridge 002C","E01003723","E02000752","Redbridge 002","E09000026","Redbridge","E12000007","London",1742,1742,0,59.8,704,2.5,"00BC","Redbridge",NA,7585,6233,5356,6609,7695,7128,6542,5854,110,895,1186,-755
"3690","Redbridge 003B","E01003724","E02000753","Redbridge 003","E09000026","Redbridge","E12000007","London",1381,1381,0,66.2,511,2.7,"00BC","Redbridge",NA,13732,11856,13172,15998,13198,12851,15662,15456,-534,995,2490,-542
"3691","Redbridge 003C","E01003725","E02000753","Redbridge 003","E09000026","Redbridge","E12000007","London",1498,1498,0,99,650,2.3,"00BC","Redbridge",NA,12126,6126,12191,15081,9553,8016,9218,9085,-2573,1890,-2973,-5996
"3688","Redbridge 002D","E01003726","E02000752","Redbridge 002","E09000026","Redbridge","E12000007","London",1524,1524,0,4,649,2.3,"00BC","Redbridge",NA,4883,3903,4198,6986,5553,3965,4599,8428,670,62,401,1442
"3692","Redbridge 003D","E01003727","E02000753","Redbridge 003","E09000026","Redbridge","E12000007","London",1600,1600,0,74.5,655,2.4,"00BC","Redbridge",NA,7639,4307,6741,7195,7417,7072,5395,6592,-222,2765,-1346,-603
"3807","Redbridge 032A","E01003728","E02000782","Redbridge 032","E09000026","Redbridge","E12000007","London",2423,2391,32,88.8,810,3,"00BC","Redbridge",NA,5995,4323,10141,20909,7540,8267,15714,18503,1545,3944,5573,-2406
"3808","Redbridge 032B","E01003729","E02000782","Redbridge 032","E09000026","Redbridge","E12000007","London",1751,1745,6,147.8,526,3.3,"00BC","Redbridge",NA,6816,2370,8602,17799,5663,4740,10539,10613,-1153,2370,1937,-7186
"3809","Redbridge 032C","E01003730","E02000782","Redbridge 032","E09000026","Redbridge","E12000007","London",1693,1693,0,192.2,416,4.1,"00BC","Redbridge",NA,7782,2442,9851,17975,7594,5879,9368,8979,-188,3437,-483,-8996
"3812","Redbridge 033A","E01003731","E02000783","Redbridge 033","E09000026","Redbridge","E12000007","London",1461,1461,0,104.9,447,3.3,"00BC","Redbridge",NA,9061,5198,9598,18945,6205,4332,7639,13181,-2856,-866,-1959,-5764
"3810","Redbridge 032D","E01003732","E02000782","Redbridge 032","E09000026","Redbridge","E12000007","London",1655,1545,110,137.7,592,2.6,"00BC","Redbridge",NA,11052,4286,16272,23639,3542,2840,6063,11744,-7510,-1446,-10209,-11895
"3811","Redbridge 032E","E01003733","E02000782","Redbridge 032","E09000026","Redbridge","E12000007","London",1767,1767,0,180.3,507,3.5,"00BC","Redbridge",NA,10499,5803,13715,18491,8759,7119,12383,14516,-1740,1316,-1332,-3975
"3813","Redbridge 033B","E01003734","E02000783","Redbridge 033","E09000026","Redbridge","E12000007","London",1796,1737,59,143.3,517,3.4,"00BC","Redbridge",NA,9743,5776,14705,17964,8071,6229,10947,14785,-1672,453,-3758,-3179
"3814","Redbridge 033C","E01003735","E02000783","Redbridge 033","E09000026","Redbridge","E12000007","London",2339,2339,0,115.3,811,2.9,"00BC","Redbridge",NA,3302,553,5065,11973,3457,1375,4244,9662,155,822,-821,-2311
"3815","Redbridge 033D","E01003736","E02000783","Redbridge 033","E09000026","Redbridge","E12000007","London",1659,1659,0,167.6,475,3.5,"00BC","Redbridge",NA,12538,6234,14234,22778,9206,6893,11359,14006,-3332,659,-2875,-8772
"3800","Redbridge 031A","E01003737","E02000781","Redbridge 031","E09000026","Redbridge","E12000007","London",1793,1793,0,50.6,575,3.1,"00BC","Redbridge",NA,15108,12935,15172,24453,15275,12394,16992,23728,167,-541,1820,-725
"3801","Redbridge 031B","E01003738","E02000781","Redbridge 031","E09000026","Redbridge","E12000007","London",2108,2108,0,90.7,646,3.3,"00BC","Redbridge",NA,17344,14717,16898,22930,17312,13067,18164,19871,-32,-1650,1266,-3059
"3802","Redbridge 031C","E01003739","E02000781","Redbridge 031","E09000026","Redbridge","E12000007","London",2121,2121,0,73.7,658,3.2,"00BC","Redbridge",NA,12367,7065,13365,18653,12759,9803,13191,21264,392,2738,-174,2611
"3803","Redbridge 031D","E01003740","E02000781","Redbridge 031","E09000026","Redbridge","E12000007","London",2055,2055,0,45.4,621,3.3,"00BC","Redbridge",NA,14380,12078,15063,24374,12013,12965,12555,17528,-2367,887,-2508,-6846
"3804","Redbridge 031E","E01003741","E02000781","Redbridge 031","E09000026","Redbridge","E12000007","London",1737,1737,0,72.8,643,2.7,"00BC","Redbridge",NA,16188,11950,16601,18701,14204,11032,16349,20792,-1984,-918,-252,2091
"3805","Redbridge 031F","E01003742","E02000781","Redbridge 031","E09000026","Redbridge","E12000007","London",2085,2085,0,145.2,618,3.4,"00BC","Redbridge",NA,13879,6791,17894,18329,15672,11045,18851,15892,1793,4254,957,-2437
"3806","Redbridge 031G","E01003743","E02000781","Redbridge 031","E09000026","Redbridge","E12000007","London",1773,1747,26,102,496,3.5,"00BC","Redbridge",NA,10438,4440,12185,18028,10669,8759,12846,13773,231,4319,661,-4255
"3678","Redbridge 001A","E01003744","E02000751","Redbridge 001","E09000026","Redbridge","E12000007","London",1337,1329,8,20.1,592,2.2,"00BC","Redbridge",NA,24584,27542,26501,27860,24672,26999,24693,26322,88,-543,-1808,-1538
"3679","Redbridge 001B","E01003745","E02000751","Redbridge 001","E09000026","Redbridge","E12000007","London",1435,1435,0,29.4,483,3,"00BC","Redbridge",NA,30882,31853,30898,31181,30157,31302,32094,30536,-725,-551,1196,-645
"3680","Redbridge 001C","E01003746","E02000751","Redbridge 001","E09000026","Redbridge","E12000007","London",1486,1462,24,23.2,661,2.2,"00BC","Redbridge",NA,30125,29585,28568,30378,31133,31101,30096,30461,1008,1516,1528,83
"3681","Redbridge 001D","E01003747","E02000751","Redbridge 001","E09000026","Redbridge","E12000007","London",1343,1343,0,45,490,2.7,"00BC","Redbridge",NA,29137,28563,30198,30371,30712,30995,30053,30556,1575,2432,-145,185
"3682","Redbridge 001E","E01003748","E02000751","Redbridge 001","E09000026","Redbridge","E12000007","London",1545,1448,97,38.1,572,2.5,"00BC","Redbridge",NA,29356,29428,26823,31037,28728,31023,28156,29305,-628,1595,1333,-1732
"3683","Redbridge 001F","E01003749","E02000751","Redbridge 001","E09000026","Redbridge","E12000007","London",1605,1597,8,78.4,681,2.3,"00BC","Redbridge",NA,21847,17194,21949,30437,26681,23876,26480,31336,4834,6682,4531,899
"3684","Redbridge 001G","E01003750","E02000751","Redbridge 001","E09000026","Redbridge","E12000007","London",1671,1651,20,44.8,798,2.1,"00BC","Redbridge",NA,10961,15585,16050,29962,19018,17060,21614,28016,8057,1475,5564,-1946
"3764","Redbridge 020A","E01003751","E02000770","Redbridge 020","E09000026","Redbridge","E12000007","London",1954,1954,0,32.7,611,3.2,"00BC","Redbridge",NA,13858,9290,13812,23500,14668,13115,16054,20882,810,3825,2242,-2618
"3772","Redbridge 023A","E01003752","E02000773","Redbridge 023","E09000026","Redbridge","E12000007","London",2492,2492,0,110.7,838,3,"00BC","Redbridge",NA,17483,14406,20874,28911,19301,17135,21797,28733,1818,2729,923,-178
"3765","Redbridge 020B","E01003753","E02000770","Redbridge 020","E09000026","Redbridge","E12000007","London",1976,1976,0,113.6,659,3,"00BC","Redbridge",NA,14938,8798,16455,27776,16467,13146,21353,24842,1529,4348,4898,-2934
"3766","Redbridge 020C","E01003754","E02000770","Redbridge 020","E09000026","Redbridge","E12000007","London",1636,1636,0,98.4,533,3.1,"00BC","Redbridge",NA,16420,11944,18354,25771,18608,15036,21170,26099,2188,3092,2816,328
"3773","Redbridge 023B","E01003755","E02000773","Redbridge 023","E09000026","Redbridge","E12000007","London",2002,2002,0,91.8,571,3.5,"00BC","Redbridge",NA,15866,8872,19390,25927,19623,14536,20972,21767,3757,5664,1582,-4160
"3774","Redbridge 023C","E01003756","E02000773","Redbridge 023","E09000026","Redbridge","E12000007","London",2123,2118,5,83.7,600,3.5,"00BC","Redbridge",NA,12422,7761,13056,24905,16348,12032,14329,22325,3926,4271,1273,-2580
"3767","Redbridge 020D","E01003757","E02000770","Redbridge 020","E09000026","Redbridge","E12000007","London",1996,1976,20,87.7,622,3.2,"00BC","Redbridge",NA,10285,6057,11280,25363,11918,9472,12566,18890,1633,3415,1286,-6473
"3775","Redbridge 023D","E01003758","E02000773","Redbridge 023","E09000026","Redbridge","E12000007","London",2581,2581,0,101.1,810,3.2,"00BC","Redbridge",NA,6364,1664,7907,17880,9867,5904,10279,18311,3503,4240,2372,431
"3718","Redbridge 009A","E01003759","E02000759","Redbridge 009","E09000026","Redbridge","E12000007","London",1459,1459,0,64.5,554,2.6,"00BC","Redbridge",NA,25725,28710,25126,29321,28331,28561,30073,29971,2606,-149,4947,650
"3719","Redbridge 009B","E01003760","E02000759","Redbridge 009","E09000026","Redbridge","E12000007","London",1783,1783,0,58.6,661,2.7,"00BC","Redbridge",NA,10695,10035,12444,19247,14428,16250,20106,19371,3733,6215,7662,124
"3720","Redbridge 009C","E01003761","E02000759","Redbridge 009","E09000026","Redbridge","E12000007","London",1771,1771,0,169.5,698,2.5,"00BC","Redbridge",NA,3288,1627,2838,12152,3189,2446,4509,7160,-99,819,1671,-4992
"3721","Redbridge 009D","E01003762","E02000759","Redbridge 009","E09000026","Redbridge","E12000007","London",1620,1604,16,64.8,656,2.4,"00BC","Redbridge",NA,17843,19537,19622,27241,17610,19639,22790,23023,-233,102,3168,-4218
"3722","Redbridge 009E","E01003763","E02000759","Redbridge 009","E09000026","Redbridge","E12000007","London",1875,1875,0,26.9,657,2.9,"00BC","Redbridge",NA,21980,18695,25920,22365,21405,21894,26543,25215,-575,3199,623,2850
"3723","Redbridge 009F","E01003764","E02000759","Redbridge 009","E09000026","Redbridge","E12000007","London",1962,1954,8,36.9,835,2.3,"00BC","Redbridge",NA,12982,14048,17999,26717,18609,20488,23309,24870,5627,6440,5310,-1847
"3724","Redbridge 009G","E01003765","E02000759","Redbridge 009","E09000026","Redbridge","E12000007","London",1574,1574,0,68,642,2.5,"00BC","Redbridge",NA,25826,22374,28920,29219,24938,24598,30040,27292,-888,2224,1120,-1927
"3776","Redbridge 024A","E01003766","E02000774","Redbridge 024","E09000026","Redbridge","E12000007","London",1900,1900,0,126,548,3.5,"00BC","Redbridge",NA,11828,5647,14152,21227,12596,9248,14196,13337,768,3601,44,-7890
"3777","Redbridge 024B","E01003767","E02000774","Redbridge 024","E09000026","Redbridge","E12000007","London",1864,1864,0,92.6,567,3.3,"00BC","Redbridge",NA,6158,3620,7812,18508,9963,9492,13532,13530,3805,5872,5720,-4978
"3778","Redbridge 024C","E01003768","E02000774","Redbridge 024","E09000026","Redbridge","E12000007","London",1754,1716,38,100.4,569,3,"00BC","Redbridge",NA,9123,6144,9016,22450,6116,5849,8083,16003,-3007,-295,-933,-6447
"3768","Redbridge 022A","E01003769","E02000772","Redbridge 022","E09000026","Redbridge","E12000007","London",1730,1711,19,71.6,557,3.1,"00BC","Redbridge",NA,6581,6265,7291,22745,9017,9417,13493,18111,2436,3152,6202,-4634
"3769","Redbridge 022B","E01003770","E02000772","Redbridge 022","E09000026","Redbridge","E12000007","London",2609,2481,128,37.5,848,2.9,"00BC","Redbridge",NA,14874,13526,10701,25355,12837,11876,16061,22735,-2037,-1650,5360,-2620
"3770","Redbridge 022C","E01003771","E02000772","Redbridge 022","E09000026","Redbridge","E12000007","London",1934,1918,16,84.5,581,3.3,"00BC","Redbridge",NA,13182,8013,13197,24088,11829,10411,12115,18094,-1353,2398,-1082,-5994
"3779","Redbridge 024D","E01003772","E02000774","Redbridge 024","E09000026","Redbridge","E12000007","London",1700,1700,0,111.5,524,3.2,"00BC","Redbridge",NA,15169,8714,16494,23283,15974,11134,12367,22524,805,2420,-4127,-759
"3771","Redbridge 022D","E01003773","E02000772","Redbridge 022","E09000026","Redbridge","E12000007","London",1673,1673,0,70.7,579,2.9,"00BC","Redbridge",NA,19375,14522,21258,21009,13512,12998,16097,26439,-5863,-1524,-5161,5430
"3737","Redbridge 014A","E01003774","E02000764","Redbridge 014","E09000026","Redbridge","E12000007","London",1764,1750,14,68.9,867,2,"00BC","Redbridge",NA,20895,20988,21663,29863,24162,23691,25686,29889,3267,2703,4023,26
"3738","Redbridge 014B","E01003775","E02000764","Redbridge 014","E09000026","Redbridge","E12000007","London",1736,1736,0,52.5,686,2.5,"00BC","Redbridge",NA,23856,24491,24585,30844,26385,26304,30513,29758,2529,1813,5928,-1086
"3739","Redbridge 014C","E01003776","E02000764","Redbridge 014","E09000026","Redbridge","E12000007","London",1653,1632,21,47.8,932,1.8,"00BC","Redbridge",NA,7634,5846,9442,22026,10562,6728,11445,19845,2928,882,2003,-2181
"3740","Redbridge 014D","E01003777","E02000764","Redbridge 014","E09000026","Redbridge","E12000007","London",1772,1740,32,75.2,856,2,"00BC","Redbridge",NA,21164,20269,28707,31509,23648,25676,30568,31580,2484,5407,1861,71
"3741","Redbridge 014E","E01003778","E02000764","Redbridge 014","E09000026","Redbridge","E12000007","London",1839,1831,8,52.5,879,2.1,"00BC","Redbridge",NA,17635,18793,24566,29864,21248,22365,29525,22618,3613,3572,4959,-7246
"3742","Redbridge 014F","E01003779","E02000764","Redbridge 014","E09000026","Redbridge","E12000007","London",1585,1485,100,94.7,708,2.1,"00BC","Redbridge",NA,15363,13520,16178,30077,16111,14351,15197,26464,748,831,-981,-3613
"3743","Redbridge 014G","E01003780","E02000764","Redbridge 014","E09000026","Redbridge","E12000007","London",1516,1516,0,50.5,507,3,"00BC","Redbridge",NA,27709,29675,25795,30614,30564,31066,30932,31085,2855,1391,5137,471
"3780","Redbridge 026A","E01003781","E02000776","Redbridge 026","E09000026","Redbridge","E12000007","London",1662,1632,30,98.9,602,2.7,"00BC","Redbridge",NA,11837,8343,12165,27641,12882,10723,14761,23369,1045,2380,2596,-4272
"3781","Redbridge 026B","E01003782","E02000776","Redbridge 026","E09000026","Redbridge","E12000007","London",1755,1755,0,104.8,518,3.4,"00BC","Redbridge",NA,9304,3815,13123,23600,11148,10124,14340,18718,1844,6309,1217,-4882
"3788","Redbridge 029A","E01003783","E02000779","Redbridge 029","E09000026","Redbridge","E12000007","London",2235,2184,51,94.9,858,2.5,"00BC","Redbridge",NA,2388,3564,2534,21491,3836,5517,5755,21123,1448,1953,3221,-368
"3789","Redbridge 029B","E01003784","E02000779","Redbridge 029","E09000026","Redbridge","E12000007","London",1760,1760,0,127.4,546,3.2,"00BC","Redbridge",NA,13793,7513,13082,26888,12038,10071,10633,21991,-1755,2558,-2449,-4897
"3790","Redbridge 029C","E01003785","E02000779","Redbridge 029","E09000026","Redbridge","E12000007","London",1904,1898,6,51.6,704,2.7,"00BC","Redbridge",NA,5679,3984,6801,25398,7243,8328,9132,20409,1564,4344,2331,-4989
"3782","Redbridge 026C","E01003786","E02000776","Redbridge 026","E09000026","Redbridge","E12000007","London",1419,1419,0,109.1,442,3.2,"00BC","Redbridge",NA,17166,11625,19565,28005,17905,14336,14661,28582,739,2711,-4904,577
"3783","Redbridge 026D","E01003787","E02000776","Redbridge 026","E09000026","Redbridge","E12000007","London",1536,1532,4,113.9,469,3.3,"00BC","Redbridge",NA,15083,9144,13358,28789,15013,10978,14580,24978,-70,1834,1222,-3811
"3791","Redbridge 029D","E01003788","E02000779","Redbridge 029","E09000026","Redbridge","E12000007","London",1852,1816,36,116.4,645,2.8,"00BC","Redbridge",NA,7669,5621,6650,23737,9277,10226,11773,18815,1608,4605,5123,-4922
"3752","Redbridge 018A","E01003789","E02000768","Redbridge 018","E09000026","Redbridge","E12000007","London",1444,1444,0,46.7,625,2.3,"00BC","Redbridge",NA,15163,19494,24120,30286,22452,27181,27374,30625,7289,7687,3254,339
"3784","Redbridge 027A","E01003790","E02000777","Redbridge 027","E09000026","Redbridge","E12000007","London",1417,1417,0,16.6,557,2.5,"00BC","Redbridge",NA,16823,14746,16763,27486,14753,15660,15806,26409,-2070,914,-957,-1077
"3785","Redbridge 027B","E01003791","E02000777","Redbridge 027","E09000026","Redbridge","E12000007","London",1488,1485,3,11.5,540,2.8,"00BC","Redbridge",NA,16993,26752,27698,29603,16356,25194,28779,29494,-637,-1558,1081,-109
"3786","Redbridge 027C","E01003792","E02000777","Redbridge 027","E09000026","Redbridge","E12000007","London",1422,1394,28,18.2,508,2.7,"00BC","Redbridge",NA,21586,24389,22429,30325,18004,24483,22617,31391,-3582,94,188,1066
"3787","Redbridge 027D","E01003793","E02000777","Redbridge 027","E09000026","Redbridge","E12000007","London",1556,1556,0,27.3,760,2,"00BC","Redbridge",NA,8595,7129,12375,26286,10038,9376,11675,17388,1443,2247,-700,-8898
"3753","Redbridge 018B","E01003794","E02000768","Redbridge 018","E09000026","Redbridge","E12000007","London",1472,1472,0,41.4,544,2.7,"00BC","Redbridge",NA,18931,15362,18926,22265,22026,20467,20722,22894,3095,5105,1796,629
"3754","Redbridge 018C","E01003795","E02000768","Redbridge 018","E09000026","Redbridge","E12000007","London",1178,1178,0,15,433,2.7,"00BC","Redbridge",NA,25748,27705,26967,30084,24823,30035,25824,30327,-925,2330,-1143,243
"3755","Redbridge 018D","E01003796","E02000768","Redbridge 018","E09000026","Redbridge","E12000007","London",1566,1566,0,63.6,638,2.5,"00BC","Redbridge",NA,20173,20356,21688,29543,22157,23537,25135,29567,1984,3181,3447,24
"3839","Richmond upon Thames 001A","E01003797","E02000784","Richmond upon Thames 001","E09000027","Richmond upon Thames","E12000007","London",1479,1445,34,35,523,2.8,"00BD","Richmond upon Thames",NA,30366,29261,32018,32470,29954,31235,32081,32567,-412,1974,63,97
"3840","Richmond upon Thames 001B","E01003798","E02000784","Richmond upon Thames 001","E09000027","Richmond upon Thames","E12000007","London",1503,1503,0,67.6,691,2.2,"00BD","Richmond upon Thames",NA,22254,20027,22146,23785,24074,20586,22166,29906,1820,559,20,6121
"3841","Richmond upon Thames 001C","E01003799","E02000784","Richmond upon Thames 001","E09000027","Richmond upon Thames","E12000007","London",1621,1621,0,19.6,653,2.5,"00BD","Richmond upon Thames",NA,29124,31197,32075,31605,26941,31250,31711,32672,-2183,53,-364,1067
"3842","Richmond upon Thames 001D","E01003800","E02000784","Richmond upon Thames 001","E09000027","Richmond upon Thames","E12000007","London",1573,1573,0,61.2,640,2.5,"00BD","Richmond upon Thames",NA,20307,13920,22428,24643,21253,16254,23456,27851,946,2334,1028,3208
"3843","Richmond upon Thames 001E","E01003801","E02000784","Richmond upon Thames 001","E09000027","Richmond upon Thames","E12000007","London",1321,1304,17,41,534,2.4,"00BD","Richmond upon Thames",NA,27882,31321,31712,32448,29368,31912,32608,32728,1486,591,896,280
"3844","Richmond upon Thames 001F","E01003802","E02000784","Richmond upon Thames 001","E09000027","Richmond upon Thames","E12000007","London",1328,1328,0,33.8,623,2.1,"00BD","Richmond upon Thames",NA,31537,32281,32376,31938,29402,32318,32668,30546,-2135,37,292,-1392
"3845","Richmond upon Thames 001G","E01003803","E02000784","Richmond upon Thames 001","E09000027","Richmond upon Thames","E12000007","London",1474,1474,0,72.6,632,2.3,"00BD","Richmond upon Thames",NA,10530,5232,9739,13909,10425,9163,7930,11397,-105,3931,-1809,-2512
"3866","Richmond upon Thames 005A","E01003804","E02000788","Richmond upon Thames 005","E09000027","Richmond upon Thames","E12000007","London",1758,1758,0,97.4,768,2.3,"00BD","Richmond upon Thames",NA,29586,24735,30626,32021,28930,28575,30304,32231,-656,3840,-322,210
"3896","Richmond upon Thames 012A","E01003805","E02000795","Richmond upon Thames 012","E09000027","Richmond upon Thames","E12000007","London",1673,1667,6,21,593,2.8,"00BD","Richmond upon Thames",NA,32343,32402,32415,32250,32337,32786,32699,32839,-6,384,284,589
"3897","Richmond upon Thames 012B","E01003806","E02000795","Richmond upon Thames 012","E09000027","Richmond upon Thames","E12000007","London",1605,1481,124,3.9,523,2.8,"00BD","Richmond upon Thames",NA,26355,31184,32114,32479,26639,32707,32379,32537,284,1523,265,58
"3867","Richmond upon Thames 005B","E01003807","E02000788","Richmond upon Thames 005","E09000027","Richmond upon Thames","E12000007","London",1795,1795,0,97.7,817,2.2,"00BD","Richmond upon Thames",NA,25654,20963,23536,31998,25658,21984,27747,30780,4,1021,4211,-1218
"3868","Richmond upon Thames 005C","E01003808","E02000788","Richmond upon Thames 005","E09000027","Richmond upon Thames","E12000007","London",1782,1782,0,131.4,793,2.2,"00BD","Richmond upon Thames",NA,29300,22930,31564,29789,27828,25290,28703,30962,-1472,2360,-2861,1173
"3869","Richmond upon Thames 005D","E01003809","E02000788","Richmond upon Thames 005","E09000027","Richmond upon Thames","E12000007","London",1735,1719,16,44.2,657,2.6,"00BD","Richmond upon Thames",NA,28898,29975,31417,32455,29545,31772,32263,32660,647,1797,846,205
"3928","Richmond upon Thames 019A","E01003810","E02000802","Richmond upon Thames 019","E09000027","Richmond upon Thames","E12000007","London",1605,1597,8,84.8,613,2.6,"00BD","Richmond upon Thames",NA,27778,24187,23175,29893,27946,23899,26995,32251,168,-288,3820,2358
"3924","Richmond upon Thames 018A","E01003811","E02000801","Richmond upon Thames 018","E09000027","Richmond upon Thames","E12000007","London",1548,1548,0,86.8,640,2.4,"00BD","Richmond upon Thames",NA,30692,28091,29549,31212,30148,28811,31950,31488,-544,720,2401,276
"3925","Richmond upon Thames 018B","E01003812","E02000801","Richmond upon Thames 018","E09000027","Richmond upon Thames","E12000007","London",1836,1836,0,63.3,772,2.4,"00BD","Richmond upon Thames",NA,24963,19105,24086,30174,25653,23162,25785,31430,690,4057,1699,1256
"3929","Richmond upon Thames 019B","E01003813","E02000802","Richmond upon Thames 019","E09000027","Richmond upon Thames","E12000007","London",1630,1618,12,51.4,643,2.5,"00BD","Richmond upon Thames",NA,31672,31296,30390,31960,30595,32256,28171,32715,-1077,960,-2219,755
"3930","Richmond upon Thames 019C","E01003814","E02000802","Richmond upon Thames 019","E09000027","Richmond upon Thames","E12000007","London",1714,1606,108,40.3,760,2.1,"00BD","Richmond upon Thames",NA,24195,16768,23131,31812,23690,19932,25627,32639,-505,3164,2496,827
"3931","Richmond upon Thames 019D","E01003815","E02000802","Richmond upon Thames 019","E09000027","Richmond upon Thames","E12000007","London",1798,1794,4,34.7,824,2.2,"00BD","Richmond upon Thames",NA,21706,15861,20093,29164,22835,18672,25191,29360,1129,2811,5098,196
"3898","Richmond upon Thames 012C","E01003816","E02000795","Richmond upon Thames 012","E09000027","Richmond upon Thames","E12000007","London",1707,1707,0,5.6,640,2.7,"00BD","Richmond upon Thames",NA,22958,20300,24096,25409,21654,24738,23729,27822,-1304,4438,-367,2413
"3899","Richmond upon Thames 012D","E01003817","E02000795","Richmond upon Thames 012","E09000027","Richmond upon Thames","E12000007","London",1913,1689,224,4.7,867,1.9,"00BD","Richmond upon Thames",NA,16462,18717,23224,25288,21995,22225,24582,27518,5533,3508,1358,2230
"3921","Richmond upon Thames 017A","E01003818","E02000800","Richmond upon Thames 017","E09000027","Richmond upon Thames","E12000007","London",1560,1560,0,32.1,661,2.4,"00BD","Richmond upon Thames",NA,26315,19974,24325,27771,24973,19213,24095,29106,-1342,-761,-230,1335
"3922","Richmond upon Thames 017B","E01003819","E02000800","Richmond upon Thames 017","E09000027","Richmond upon Thames","E12000007","London",1675,1675,0,16,747,2.2,"00BD","Richmond upon Thames",NA,6967,6176,7990,14264,9165,7834,7612,14876,2198,1658,-378,612
"3923","Richmond upon Thames 017C","E01003820","E02000800","Richmond upon Thames 017","E09000027","Richmond upon Thames","E12000007","London",1949,1949,0,66,751,2.6,"00BD","Richmond upon Thames",NA,17533,10282,15163,20522,20095,15661,17504,19373,2562,5379,2341,-1149
"3879","Richmond upon Thames 008A","E01003821","E02000791","Richmond upon Thames 008","E09000027","Richmond upon Thames","E12000007","London",1513,1438,75,51.4,784,1.8,"00BD","Richmond upon Thames",NA,27144,27441,28740,31106,28695,30790,32511,32797,1551,3349,3771,1691
"3948","Richmond upon Thames 023A","E01003822","E02000806","Richmond upon Thames 023","E09000027","Richmond upon Thames","E12000007","London",1444,1420,24,38.6,516,2.8,"00BD","Richmond upon Thames",NA,30901,31107,31832,32358,31597,32530,32312,32748,696,1423,480,390
"3949","Richmond upon Thames 023B","E01003823","E02000806","Richmond upon Thames 023","E09000027","Richmond upon Thames","E12000007","London",1638,1638,0,3.8,796,2.1,"00BD","Richmond upon Thames",NA,24040,23174,31459,32198,24965,30591,31564,31581,925,7417,105,-617
"3950","Richmond upon Thames 023C","E01003824","E02000806","Richmond upon Thames 023","E09000027","Richmond upon Thames","E12000007","London",1661,1641,20,51,649,2.5,"00BD","Richmond upon Thames",NA,30479,29708,27637,31754,29530,26797,29187,32482,-949,-2911,1550,728
"3951","Richmond upon Thames 023D","E01003825","E02000806","Richmond upon Thames 023","E09000027","Richmond upon Thames","E12000007","London",1762,1762,0,51.2,653,2.7,"00BD","Richmond upon Thames",NA,30216,27106,28962,26656,30718,29302,30677,31614,502,2196,1715,4958
"3952","Richmond upon Thames 023E","E01003826","E02000806","Richmond upon Thames 023","E09000027","Richmond upon Thames","E12000007","London",1768,1695,73,16.3,760,2.2,"00BD","Richmond upon Thames",NA,11628,7299,9226,12293,11950,10654,11306,13775,322,3355,2080,1482
"3953","Richmond upon Thames 023F","E01003827","E02000806","Richmond upon Thames 023","E09000027","Richmond upon Thames","E12000007","London",1712,1712,0,37.6,800,2.1,"00BD","Richmond upon Thames",NA,22563,15113,22534,27979,23474,20061,21924,29187,911,4948,-610,1208
"3932","Richmond upon Thames 020A","E01003828","E02000803","Richmond upon Thames 020","E09000027","Richmond upon Thames","E12000007","London",1517,1517,0,48.9,630,2.4,"00BD","Richmond upon Thames",NA,30809,28177,28988,31234,28595,29865,27180,31080,-2214,1688,-1808,-154
"3933","Richmond upon Thames 020B","E01003829","E02000803","Richmond upon Thames 020","E09000027","Richmond upon Thames","E12000007","London",1675,1675,0,41.9,686,2.4,"00BD","Richmond upon Thames",NA,9113,6242,8707,10672,9415,8791,9080,14675,302,2549,373,4003
"3934","Richmond upon Thames 020C","E01003830","E02000803","Richmond upon Thames 020","E09000027","Richmond upon Thames","E12000007","London",1760,1760,0,35,734,2.4,"00BD","Richmond upon Thames",NA,25649,19247,24898,30394,24258,23339,23455,31963,-1391,4092,-1443,1569
"3935","Richmond upon Thames 020D","E01003831","E02000803","Richmond upon Thames 020","E09000027","Richmond upon Thames","E12000007","London",1618,1611,7,51.1,697,2.3,"00BD","Richmond upon Thames",NA,25989,22208,23286,25920,20904,18974,24577,24867,-5085,-3234,1291,-1053
"3936","Richmond upon Thames 020E","E01003832","E02000803","Richmond upon Thames 020","E09000027","Richmond upon Thames","E12000007","London",1431,1431,0,64.3,681,2.1,"00BD","Richmond upon Thames",NA,8575,5041,5437,12778,5864,4507,3355,11516,-2711,-534,-2082,-1262
"3937","Richmond upon Thames 020F","E01003833","E02000803","Richmond upon Thames 020","E09000027","Richmond upon Thames","E12000007","London",1386,1352,34,70.3,658,2.1,"00BD","Richmond upon Thames",NA,18954,12813,17692,18659,15907,12297,15741,21528,-3047,-516,-1951,2869
"3942","Richmond upon Thames 022A","E01003834","E02000805","Richmond upon Thames 022","E09000027","Richmond upon Thames","E12000007","London",1720,1512,208,15.9,829,1.8,"00BD","Richmond upon Thames",NA,22653,18749,23062,29847,22560,23361,24404,31880,-93,4612,1342,2033
"3943","Richmond upon Thames 022B","E01003835","E02000805","Richmond upon Thames 022","E09000027","Richmond upon Thames","E12000007","London",1527,1498,29,42.2,537,2.8,"00BD","Richmond upon Thames",NA,30716,29055,30344,32263,30314,30938,31510,32757,-402,1883,1166,494
"3944","Richmond upon Thames 022C","E01003836","E02000805","Richmond upon Thames 022","E09000027","Richmond upon Thames","E12000007","London",1505,1472,33,60.7,613,2.4,"00BD","Richmond upon Thames",NA,19971,14104,18679,29695,19375,18536,15300,23711,-596,4432,-3379,-5984
"3945","Richmond upon Thames 022D","E01003837","E02000805","Richmond upon Thames 022","E09000027","Richmond upon Thames","E12000007","London",1812,1797,15,35.2,802,2.2,"00BD","Richmond upon Thames",NA,28627,25238,26664,32284,27093,25918,27655,32646,-1534,680,991,362
"3946","Richmond upon Thames 022E","E01003838","E02000805","Richmond upon Thames 022","E09000027","Richmond upon Thames","E12000007","London",1786,1786,0,58.8,758,2.4,"00BD","Richmond upon Thames",NA,27999,21953,27805,32218,27799,27142,29080,32351,-200,5189,1275,133
"3947","Richmond upon Thames 022F","E01003839","E02000805","Richmond upon Thames 022","E09000027","Richmond upon Thames","E12000007","London",1871,1864,7,81.5,916,2,"00BD","Richmond upon Thames",NA,20646,17731,18326,30081,19795,15334,19437,28421,-851,-2397,1111,-1660
"3900","Richmond upon Thames 013A","E01003840","E02000796","Richmond upon Thames 013","E09000027","Richmond upon Thames","E12000007","London",1584,1584,0,79.2,560,2.8,"00BD","Richmond upon Thames",NA,21227,15871,21750,23797,17506,14158,21253,21936,-3721,-1713,-497,-1861
"3901","Richmond upon Thames 013B","E01003841","E02000796","Richmond upon Thames 013","E09000027","Richmond upon Thames","E12000007","London",1932,1925,7,66.5,811,2.4,"00BD","Richmond upon Thames",NA,8112,3175,7443,13395,8955,7528,9905,9937,843,4353,2462,-3458
"3902","Richmond upon Thames 013C","E01003842","E02000796","Richmond upon Thames 013","E09000027","Richmond upon Thames","E12000007","London",1677,1677,0,42.6,619,2.7,"00BD","Richmond upon Thames",NA,17958,11320,19511,15464,15479,12125,15183,15540,-2479,805,-4328,76
"3903","Richmond upon Thames 013D","E01003843","E02000796","Richmond upon Thames 013","E09000027","Richmond upon Thames","E12000007","London",2044,2039,5,61.6,753,2.7,"00BD","Richmond upon Thames",NA,19157,14201,15047,21095,17309,12179,14642,18420,-1848,-2022,-405,-2675
"3904","Richmond upon Thames 013E","E01003844","E02000796","Richmond upon Thames 013","E09000027","Richmond upon Thames","E12000007","London",1450,1444,6,50.7,553,2.6,"00BD","Richmond upon Thames",NA,28108,25866,27812,29068,26809,26147,25064,30037,-1299,281,-2748,969
"3905","Richmond upon Thames 013F","E01003845","E02000796","Richmond upon Thames 013","E09000027","Richmond upon Thames","E12000007","London",1626,1615,11,39.6,622,2.6,"00BD","Richmond upon Thames",NA,28842,26828,23962,23701,25984,26975,26203,23837,-2858,147,2241,136
"3846","Richmond upon Thames 002A","E01003846","E02000785","Richmond upon Thames 002","E09000027","Richmond upon Thames","E12000007","London",1734,1734,0,72.5,628,2.8,"00BD","Richmond upon Thames",NA,31455,30860,31886,32482,31228,32190,32649,32827,-227,1330,763,345
"3847","Richmond upon Thames 002B","E01003847","E02000785","Richmond upon Thames 002","E09000027","Richmond upon Thames","E12000007","London",1582,1582,0,9.9,842,1.9,"00BD","Richmond upon Thames",NA,24235,22501,29691,32450,27933,28453,32197,32250,3698,5952,2506,-200
"3859","Richmond upon Thames 004A","E01003848","E02000787","Richmond upon Thames 004","E09000027","Richmond upon Thames","E12000007","London",1808,1808,0,90.7,817,2.2,"00BD","Richmond upon Thames",NA,21885,15601,25942,28615,22098,21559,26276,26550,213,5958,334,-2065
"3848","Richmond upon Thames 002C","E01003849","E02000785","Richmond upon Thames 002","E09000027","Richmond upon Thames","E12000007","London",1534,1480,54,76.6,653,2.3,"00BD","Richmond upon Thames",NA,27295,28168,21742,31513,27614,27232,26800,31546,319,-936,5058,33
"3849","Richmond upon Thames 002D","E01003851","E02000785","Richmond upon Thames 002","E09000027","Richmond upon Thames","E12000007","London",1688,1642,46,67.7,691,2.4,"00BD","Richmond upon Thames",NA,28678,31736,32067,32480,30262,32586,32677,32796,1584,850,610,316
"3852","Richmond upon Thames 003A","E01003852","E02000786","Richmond upon Thames 003","E09000027","Richmond upon Thames","E12000007","London",1324,1324,0,19.7,652,2,"00BD","Richmond upon Thames",NA,21671,20423,27619,32092,18943,22143,28254,31185,-2728,1720,635,-907
"3853","Richmond upon Thames 003B","E01003853","E02000786","Richmond upon Thames 003","E09000027","Richmond upon Thames","E12000007","London",1535,1491,44,50.9,622,2.4,"00BD","Richmond upon Thames",NA,21126,16586,18681,29672,20494,19081,18005,27767,-632,2495,-676,-1905
"3854","Richmond upon Thames 003C","E01003854","E02000786","Richmond upon Thames 003","E09000027","Richmond upon Thames","E12000007","London",1413,1413,0,100.3,653,2.2,"00BD","Richmond upon Thames",NA,20746,20082,22902,21641,22714,23219,26102,22981,1968,3137,3200,1340
"3855","Richmond upon Thames 003D","E01003855","E02000786","Richmond upon Thames 003","E09000027","Richmond upon Thames","E12000007","London",1689,1689,0,57.5,831,2,"00BD","Richmond upon Thames",NA,13013,8484,13298,24462,14670,10074,13120,23195,1657,1590,-178,-1267
"3856","Richmond upon Thames 003E","E01003856","E02000786","Richmond upon Thames 003","E09000027","Richmond upon Thames","E12000007","London",1568,1568,0,127.9,749,2.1,"00BD","Richmond upon Thames",NA,25082,22005,29694,25640,26065,21748,28598,30476,983,-257,-1096,4836
"3857","Richmond upon Thames 003F","E01003857","E02000786","Richmond upon Thames 003","E09000027","Richmond upon Thames","E12000007","London",1752,1752,0,116.1,756,2.3,"00BD","Richmond upon Thames",NA,25358,20522,29597,25662,27825,26668,29702,30409,2467,6146,105,4747
"3858","Richmond upon Thames 003G","E01003858","E02000786","Richmond upon Thames 003","E09000027","Richmond upon Thames","E12000007","London",1638,1628,10,100.1,678,2.4,"00BD","Richmond upon Thames",NA,28491,31476,31669,32299,30894,32326,32145,32801,2403,850,476,502
"3870","Richmond upon Thames 005E","E01003859","E02000788","Richmond upon Thames 005","E09000027","Richmond upon Thames","E12000007","London",1622,1622,0,84.5,631,2.6,"00BD","Richmond upon Thames",NA,29200,24271,29742,32273,30059,28896,31024,32727,859,4625,1282,454
"3850","Richmond upon Thames 002E","E01003860","E02000785","Richmond upon Thames 002","E09000027","Richmond upon Thames","E12000007","London",1691,1681,10,11.2,819,2.1,"00BD","Richmond upon Thames",NA,25745,26021,25223,31466,26339,28713,29055,32710,594,2692,3832,1244
"3860","Richmond upon Thames 004C","E01003861","E02000787","Richmond upon Thames 004","E09000027","Richmond upon Thames","E12000007","London",1751,1751,0,91.1,855,2,"00BD","Richmond upon Thames",NA,24827,21412,27297,24378,23815,22002,30365,24170,-1012,590,3068,-208
"3861","Richmond upon Thames 004D","E01003862","E02000787","Richmond upon Thames 004","E09000027","Richmond upon Thames","E12000007","London",1388,1388,0,65.8,627,2.2,"00BD","Richmond upon Thames",NA,18512,13818,20027,22970,16961,14889,16094,27164,-1551,1071,-3933,4194
"3862","Richmond upon Thames 004E","E01003863","E02000787","Richmond upon Thames 004","E09000027","Richmond upon Thames","E12000007","London",1420,1420,0,66.8,639,2.2,"00BD","Richmond upon Thames",NA,17911,14828,15053,25936,16291,13949,14439,27870,-1620,-879,-614,1934
"3851","Richmond upon Thames 002F","E01003864","E02000785","Richmond upon Thames 002","E09000027","Richmond upon Thames","E12000007","London",1466,1466,0,57.3,671,2.2,"00BD","Richmond upon Thames",NA,28895,26281,28913,32157,27278,27697,26469,32721,-1617,1416,-2444,564
"3863","Richmond upon Thames 004F","E01003865","E02000787","Richmond upon Thames 004","E09000027","Richmond upon Thames","E12000007","London",1311,1311,0,95.8,529,2.5,"00BD","Richmond upon Thames",NA,18852,13430,16810,29247,22136,20471,21143,25564,3284,7041,4333,-3683
"3875","Richmond upon Thames 007A","E01003866","E02000790","Richmond upon Thames 007","E09000027","Richmond upon Thames","E12000007","London",1587,1587,0,103.2,642,2.5,"00BD","Richmond upon Thames",NA,31608,31071,31978,32456,31541,32627,32783,32655,-67,1556,805,199
"3892","Richmond upon Thames 011A","E01003867","E02000794","Richmond upon Thames 011","E09000027","Richmond upon Thames","E12000007","London",1492,1485,7,35.7,576,2.6,"00BD","Richmond upon Thames",NA,21629,20206,25783,30379,24875,25271,24694,30177,3246,5065,-1089,-202
"3876","Richmond upon Thames 007B","E01003868","E02000790","Richmond upon Thames 007","E09000027","Richmond upon Thames","E12000007","London",1506,1506,0,113.4,639,2.4,"00BD","Richmond upon Thames",NA,27143,29426,30056,31389,27965,30176,30336,32830,822,750,280,1441
"3893","Richmond upon Thames 011B","E01003869","E02000794","Richmond upon Thames 011","E09000027","Richmond upon Thames","E12000007","London",1617,1605,12,50,693,2.3,"00BD","Richmond upon Thames",NA,28084,30111,29570,31177,29944,31934,31626,32674,1860,1823,2056,1497
"3894","Richmond upon Thames 011C","E01003870","E02000794","Richmond upon Thames 011","E09000027","Richmond upon Thames","E12000007","London",1870,1863,7,43.8,721,2.6,"00BD","Richmond upon Thames",NA,29800,29151,28516,32264,26847,28142,30251,32688,-2953,-1009,1735,424
"3877","Richmond upon Thames 007C","E01003871","E02000790","Richmond upon Thames 007","E09000027","Richmond upon Thames","E12000007","London",1649,1649,0,84.6,642,2.6,"00BD","Richmond upon Thames",NA,30735,31282,31679,32351,30640,28090,31091,31678,-95,-3192,-588,-673
"3878","Richmond upon Thames 007D","E01003872","E02000790","Richmond upon Thames 007","E09000027","Richmond upon Thames","E12000007","London",1451,1451,0,45.9,686,2.1,"00BD","Richmond upon Thames",NA,25494,26007,25850,32382,26297,28884,28662,32600,803,2877,2812,218
"3871","Richmond upon Thames 006A","E01003873","E02000789","Richmond upon Thames 006","E09000027","Richmond upon Thames","E12000007","London",1660,1654,6,85.7,850,1.9,"00BD","Richmond upon Thames",NA,27215,26887,28077,32038,25856,28044,31174,32713,-1359,1157,3097,675
"3872","Richmond upon Thames 006B","E01003874","E02000789","Richmond upon Thames 006","E09000027","Richmond upon Thames","E12000007","London",1529,1508,21,112.1,787,1.9,"00BD","Richmond upon Thames",NA,28278,27456,27512,30646,28664,29930,30423,31434,386,2474,2911,788
"3873","Richmond upon Thames 006C","E01003875","E02000789","Richmond upon Thames 006","E09000027","Richmond upon Thames","E12000007","London",1613,1613,0,31.6,681,2.4,"00BD","Richmond upon Thames",NA,27676,21510,28937,31176,27283,24858,28152,32514,-393,3348,-785,1338
"3880","Richmond upon Thames 008B","E01003876","E02000791","Richmond upon Thames 008","E09000027","Richmond upon Thames","E12000007","London",1591,1591,0,33.4,865,1.8,"00BD","Richmond upon Thames",NA,25768,29763,28491,31813,24045,31644,32458,32824,-1723,1881,3967,1011
"3881","Richmond upon Thames 008C","E01003877","E02000791","Richmond upon Thames 008","E09000027","Richmond upon Thames","E12000007","London",1482,1479,3,93.5,724,2,"00BD","Richmond upon Thames",NA,26100,24744,29169,32073,29701,30747,31416,32637,3601,6003,2247,564
"3874","Richmond upon Thames 006D","E01003878","E02000789","Richmond upon Thames 006","E09000027","Richmond upon Thames","E12000007","London",1394,1331,63,14,648,2.1,"00BD","Richmond upon Thames",NA,16590,11359,10837,24686,14651,10467,11356,19973,-1939,-892,519,-4713
"3882","Richmond upon Thames 008D","E01003879","E02000791","Richmond upon Thames 008","E09000027","Richmond upon Thames","E12000007","London",1551,1338,213,82.8,613,2.2,"00BD","Richmond upon Thames",NA,29429,30996,31848,32396,30190,32185,32682,31603,761,1189,834,-793
"3917","Richmond upon Thames 016A","E01003880","E02000799","Richmond upon Thames 016","E09000027","Richmond upon Thames","E12000007","London",1468,1468,0,63.2,581,2.5,"00BD","Richmond upon Thames",NA,27486,23810,30492,32321,29214,30896,31274,32624,1728,7086,782,303
"3918","Richmond upon Thames 016B","E01003881","E02000799","Richmond upon Thames 016","E09000027","Richmond upon Thames","E12000007","London",1837,1105,732,55.5,492,2.2,"00BD","Richmond upon Thames",NA,31152,31028,30671,32138,29898,32128,32389,32273,-1254,1100,1718,135
"3906","Richmond upon Thames 014A","E01003882","E02000797","Richmond upon Thames 014","E09000027","Richmond upon Thames","E12000007","London",1797,1790,7,83.7,793,2.3,"00BD","Richmond upon Thames",NA,29144,29139,26047,32253,28319,29612,28629,32789,-825,473,2582,536
"3907","Richmond upon Thames 014B","E01003883","E02000797","Richmond upon Thames 014","E09000027","Richmond upon Thames","E12000007","London",1775,1775,0,92.6,836,2.1,"00BD","Richmond upon Thames",NA,28957,27006,29205,28334,29263,26216,30720,28228,306,-790,1515,-106
"3919","Richmond upon Thames 016C","E01003884","E02000799","Richmond upon Thames 016","E09000027","Richmond upon Thames","E12000007","London",1594,1568,26,56.7,698,2.2,"00BD","Richmond upon Thames",NA,28358,25294,25108,32228,27079,26120,23381,32517,-1279,826,-1727,289
"3920","Richmond upon Thames 016D","E01003885","E02000799","Richmond upon Thames 016","E09000027","Richmond upon Thames","E12000007","London",1516,1516,0,34.5,647,2.3,"00BD","Richmond upon Thames",NA,27708,26677,28958,31341,27718,26770,28046,32654,10,93,-912,1313
"3938","Richmond upon Thames 021A","E01003886","E02000804","Richmond upon Thames 021","E09000027","Richmond upon Thames","E12000007","London",1699,1699,0,82.9,684,2.5,"00BD","Richmond upon Thames",NA,28453,27364,30206,32279,30866,30085,31911,32563,2413,2721,1705,284
"3939","Richmond upon Thames 021B","E01003887","E02000804","Richmond upon Thames 021","E09000027","Richmond upon Thames","E12000007","London",1724,1724,0,77.6,789,2.2,"00BD","Richmond upon Thames",NA,29679,30487,31098,31483,30301,31980,31984,32143,622,1493,886,660
"3940","Richmond upon Thames 021C","E01003888","E02000804","Richmond upon Thames 021","E09000027","Richmond upon Thames","E12000007","London",1907,1884,23,24,896,2.1,"00BD","Richmond upon Thames",NA,18781,12445,15042,29990,19520,13049,16244,29984,739,604,1202,-6
"3941","Richmond upon Thames 021D","E01003889","E02000804","Richmond upon Thames 021","E09000027","Richmond upon Thames","E12000007","London",1776,1706,70,7,779,2.2,"00BD","Richmond upon Thames",NA,29908,31723,30862,32404,28893,31670,32477,32805,-1015,-53,1615,401
"3926","Richmond upon Thames 018C","E01003890","E02000801","Richmond upon Thames 018","E09000027","Richmond upon Thames","E12000007","London",1509,1509,0,70,642,2.4,"00BD","Richmond upon Thames",NA,30357,30916,31094,32249,27833,28348,30116,32788,-2524,-2568,-978,539
"3927","Richmond upon Thames 018D","E01003891","E02000801","Richmond upon Thames 018","E09000027","Richmond upon Thames","E12000007","London",1715,1706,9,56.4,826,2.1,"00BD","Richmond upon Thames",NA,30499,29751,31157,32348,31741,31505,30508,31870,1242,1754,-649,-478
"3883","Richmond upon Thames 009A","E01003892","E02000792","Richmond upon Thames 009","E09000027","Richmond upon Thames","E12000007","London",2012,1930,82,48.7,924,2.1,"00BD","Richmond upon Thames",NA,30199,28931,31344,32416,29365,32260,32612,32462,-834,3329,1268,46
"3884","Richmond upon Thames 009B","E01003893","E02000792","Richmond upon Thames 009","E09000027","Richmond upon Thames","E12000007","London",1616,1569,47,74.2,759,2.1,"00BD","Richmond upon Thames",NA,27841,27255,30563,32457,27041,29307,31304,32820,-800,2052,741,363
"3885","Richmond upon Thames 009C","E01003894","E02000792","Richmond upon Thames 009","E09000027","Richmond upon Thames","E12000007","London",1643,1635,8,98.9,760,2.2,"00BD","Richmond upon Thames",NA,29846,30117,29995,32259,29354,31092,31185,32799,-492,975,1190,540
"3886","Richmond upon Thames 009D","E01003895","E02000792","Richmond upon Thames 009","E09000027","Richmond upon Thames","E12000007","London",1718,1698,20,38.4,766,2.2,"00BD","Richmond upon Thames",NA,24742,18251,24872,32242,25488,24268,27776,31712,746,6017,2904,-530
"3908","Richmond upon Thames 014C","E01003896","E02000797","Richmond upon Thames 014","E09000027","Richmond upon Thames","E12000007","London",1646,1646,0,53.1,796,2.1,"00BD","Richmond upon Thames",NA,27506,29291,26999,30992,24813,28764,31294,32341,-2693,-527,4295,1349
"3909","Richmond upon Thames 014D","E01003897","E02000797","Richmond upon Thames 014","E09000027","Richmond upon Thames","E12000007","London",1761,1683,78,89.5,848,2,"00BD","Richmond upon Thames",NA,26293,24129,25912,30390,25522,27642,30924,32777,-771,3513,5012,2387
"3910","Richmond upon Thames 015A","E01003898","E02000798","Richmond upon Thames 015","E09000027","Richmond upon Thames","E12000007","London",1490,1458,32,82.4,675,2.2,"00BD","Richmond upon Thames",NA,27858,26409,29467,29300,27820,24202,28545,31530,-38,-2207,-922,2230
"3911","Richmond upon Thames 015B","E01003899","E02000798","Richmond upon Thames 015","E09000027","Richmond upon Thames","E12000007","London",1377,1377,0,82.2,632,2.2,"00BD","Richmond upon Thames",NA,28183,25717,28524,30592,29465,30346,30619,32115,1282,4629,2095,1523
"3912","Richmond upon Thames 015C","E01003900","E02000798","Richmond upon Thames 015","E09000027","Richmond upon Thames","E12000007","London",1562,1562,0,21,614,2.5,"00BD","Richmond upon Thames",NA,14408,9119,13534,20258,13114,12460,10585,20439,-1294,3341,-2949,181
"3913","Richmond upon Thames 015D","E01003901","E02000798","Richmond upon Thames 015","E09000027","Richmond upon Thames","E12000007","London",1640,1640,0,58.5,605,2.7,"00BD","Richmond upon Thames",NA,29419,30976,28151,27352,28470,31118,31616,30931,-949,142,3465,3579
"3914","Richmond upon Thames 015E","E01003902","E02000798","Richmond upon Thames 015","E09000027","Richmond upon Thames","E12000007","London",1296,1296,0,80,503,2.6,"00BD","Richmond upon Thames",NA,28184,25231,25298,26631,28785,27167,26198,30184,601,1936,900,3553
"3915","Richmond upon Thames 015F","E01003903","E02000798","Richmond upon Thames 015","E09000027","Richmond upon Thames","E12000007","London",1627,1610,17,23.9,580,2.8,"00BD","Richmond upon Thames",NA,19080,14314,22317,22199,19797,18682,23294,23768,717,4368,977,1569
"3916","Richmond upon Thames 015G","E01003904","E02000798","Richmond upon Thames 015","E09000027","Richmond upon Thames","E12000007","London",1536,1536,0,63.5,671,2.3,"00BD","Richmond upon Thames",NA,25522,18431,25239,23208,26099,22623,26064,31259,577,4192,825,8051
"3887","Richmond upon Thames 010A","E01003905","E02000793","Richmond upon Thames 010","E09000027","Richmond upon Thames","E12000007","London",1435,1388,47,39.3,548,2.5,"00BD","Richmond upon Thames",NA,26099,23636,27691,27205,27025,25496,29772,28447,926,1860,2081,1242
"3888","Richmond upon Thames 010B","E01003906","E02000793","Richmond upon Thames 010","E09000027","Richmond upon Thames","E12000007","London",1618,1538,80,77.7,649,2.4,"00BD","Richmond upon Thames",NA,21378,16388,18520,27672,20424,17213,21249,24734,-954,825,2729,-2938
"3889","Richmond upon Thames 010C","E01003907","E02000793","Richmond upon Thames 010","E09000027","Richmond upon Thames","E12000007","London",1683,1683,0,70.5,673,2.5,"00BD","Richmond upon Thames",NA,12301,9255,10178,17281,11775,9423,11577,16537,-526,168,1399,-744
"3890","Richmond upon Thames 010D","E01003908","E02000793","Richmond upon Thames 010","E09000027","Richmond upon Thames","E12000007","London",1817,1817,0,62.2,668,2.7,"00BD","Richmond upon Thames",NA,29249,25880,30362,29418,28999,29192,29284,29797,-250,3312,-1078,379
"3891","Richmond upon Thames 010E","E01003909","E02000793","Richmond upon Thames 010","E09000027","Richmond upon Thames","E12000007","London",1569,1564,5,70.6,606,2.6,"00BD","Richmond upon Thames",NA,25062,16097,22741,29517,25144,22016,25218,28731,82,5919,2477,-786
"3895","Richmond upon Thames 011D","E01003910","E02000794","Richmond upon Thames 011","E09000027","Richmond upon Thames","E12000007","London",1630,1624,6,55,670,2.4,"00BD","Richmond upon Thames",NA,28943,26748,28316,28947,29357,30181,30915,28389,414,3433,2599,-558
"4046","Southwark 020A","E01003911","E02000826","Southwark 020","E09000028","Southwark","E12000007","London",1985,1985,0,176.9,742,2.7,"00BE","Southwark",NA,5958,3936,10753,12837,6534,5956,10865,14862,576,2020,112,2025
"4041","Southwark 019A","E01003912","E02000825","Southwark 019","E09000028","Southwark","E12000007","London",1595,1571,24,195,571,2.8,"00BE","Southwark",NA,3611,1642,3662,13102,3725,2984,4562,13309,114,1342,900,207
"4066","Southwark 024A","E01003913","E02000830","Southwark 024","E09000028","Southwark","E12000007","London",1847,1817,30,78.5,800,2.3,"00BE","Southwark",NA,7229,9842,4894,23741,10883,12744,11594,26384,3654,2902,6700,2643
"4067","Southwark 024B","E01003914","E02000830","Southwark 024","E09000028","Southwark","E12000007","London",1842,1831,11,126.5,722,2.5,"00BE","Southwark",NA,6359,6223,7888,19425,10142,10854,14013,26032,3783,4631,6125,6607
"4068","Southwark 024C","E01003915","E02000830","Southwark 024","E09000028","Southwark","E12000007","London",1940,1940,0,199.2,811,2.4,"00BE","Southwark",NA,4890,4358,5490,16865,7124,6296,7808,21489,2234,1938,2318,4624
"4047","Southwark 020B","E01003916","E02000826","Southwark 020","E09000028","Southwark","E12000007","London",2190,2080,110,145.1,830,2.5,"00BE","Southwark",NA,9277,7366,10717,14988,9846,9544,14723,24595,569,2178,4006,9607
"4048","Southwark 020C","E01003917","E02000826","Southwark 020","E09000028","Southwark","E12000007","London",1775,1761,14,159.2,787,2.2,"00BE","Southwark",NA,7200,5434,8911,17394,6672,5721,8732,23628,-528,287,-179,6234
"4049","Southwark 020D","E01003918","E02000826","Southwark 020","E09000028","Southwark","E12000007","London",1602,1602,0,184.6,653,2.5,"00BE","Southwark",NA,6017,4965,8667,14714,4429,3860,6067,17173,-1588,-1105,-2600,2459
"4051","Southwark 021A","E01003919","E02000827","Southwark 021","E09000028","Southwark","E12000007","London",1776,1692,84,118.6,702,2.4,"00BE","Southwark",NA,4996,4382,8852,23014,10538,14835,17385,25690,5542,10453,8533,2676
"4052","Southwark 021B","E01003920","E02000827","Southwark 021","E09000028","Southwark","E12000007","London",1854,1854,0,213.3,766,2.4,"00BE","Southwark",NA,2955,2447,3627,12373,4489,3109,5419,17590,1534,662,1792,5217
"4053","Southwark 021C","E01003921","E02000827","Southwark 021","E09000028","Southwark","E12000007","London",1461,1371,90,122.5,673,2,"00BE","Southwark",NA,2302,2802,3397,8663,2782,5602,4752,15014,480,2800,1355,6351
"4054","Southwark 021D","E01003922","E02000827","Southwark 021","E09000028","Southwark","E12000007","London",1917,1914,3,138.2,821,2.3,"00BE","Southwark",NA,3720,3798,6812,12833,5618,5592,9595,18400,1898,1794,2783,5567
"4031","Southwark 017A","E01003923","E02000823","Southwark 017","E09000028","Southwark","E12000007","London",1735,1735,0,146.2,730,2.4,"00BE","Southwark",NA,6064,5692,6901,18838,8703,8236,11485,23929,2639,2544,4584,5091
"4055","Southwark 021E","E01003924","E02000827","Southwark 021","E09000028","Southwark","E12000007","London",1928,1916,12,242.5,802,2.4,"00BE","Southwark",NA,2808,2422,2601,15667,5586,5333,7536,15292,2778,2911,4935,-375
"4050","Southwark 020E","E01003925","E02000826","Southwark 020","E09000028","Southwark","E12000007","London",1336,1286,50,151.5,527,2.4,"00BE","Southwark",NA,3874,3845,6880,13738,4609,3485,6092,12074,735,-360,-788,-1664
"4056","Southwark 021F","E01003926","E02000827","Southwark 021","E09000028","Southwark","E12000007","London",1423,1423,0,133,540,2.6,"00BE","Southwark",NA,5791,4999,9448,14176,6614,4849,9190,17829,823,-150,-258,3653
"3959","Southwark 002A","E01003927","E02000808","Southwark 002","E09000028","Southwark","E12000007","London",2377,1985,392,84.1,995,2,"00BE","Southwark",NA,9139,9871,13407,18856,12262,12835,18567,25300,3123,2964,5160,6444
"3960","Southwark 002B","E01003929","E02000808","Southwark 002","E09000028","Southwark","E12000007","London",2111,2111,0,90,1074,2,"00BE","Southwark",NA,7874,9961,8176,22285,12169,16594,22514,21827,4295,6633,14338,-458
"4115","Southwark 034A","E01003930","E02006802","Southwark 034","E09000028","Southwark","E12000007","London",1496,963,533,138.9,458,2.1,"00BE","Southwark",NA,7988,12291,12239,22707,6336,10420,12103,18121,-1652,-1871,-136,-4586
"4116","Southwark 034B","E01003932","E02006802","Southwark 034","E09000028","Southwark","E12000007","London",1573,1434,139,128.6,651,2.2,"00BE","Southwark",NA,4181,4901,4128,14215,3525,4311,5652,14757,-656,-590,1524,542
"4117","Southwark 034C","E01003933","E02006802","Southwark 034","E09000028","Southwark","E12000007","London",1751,1376,375,79.2,537,2.6,"00BE","Southwark",NA,4673,5103,11883,15302,6168,9687,14374,22381,1495,4584,2491,7079
"3961","Southwark 002C","E01003934","E02000808","Southwark 002","E09000028","Southwark","E12000007","London",1422,1422,0,60.4,811,1.8,"00BE","Southwark",NA,4882,6389,1787,16023,13066,10468,11654,26113,8184,4079,9867,10090
"3962","Southwark 002D","E01003935","E02000808","Southwark 002","E09000028","Southwark","E12000007","London",1342,946,396,95.4,451,2.1,"00BE","Southwark",NA,13546,12559,20491,18428,13524,11640,16797,21161,-22,-919,-3694,2733
"3993","Southwark 009A","E01003936","E02000815","Southwark 009","E09000028","Southwark","E12000007","London",1845,1198,647,195.9,552,2.2,"00BE","Southwark",NA,20113,31886,32233,29102,18834,30638,32634,15820,-1279,-1248,401,-13282
"3994","Southwark 009B","E01003937","E02000815","Southwark 009","E09000028","Southwark","E12000007","London",1553,1553,0,161.8,734,2.1,"00BE","Southwark",NA,11078,14190,25510,16953,10370,18689,25001,25745,-708,4499,-509,8792
"3977","Southwark 006A","E01003938","E02000812","Southwark 006","E09000028","Southwark","E12000007","London",1814,1814,0,235,790,2.3,"00BE","Southwark",NA,6705,5617,10688,16004,8208,7323,10775,24844,1503,1706,87,8840
"3963","Southwark 002E","E01003939","E02000808","Southwark 002","E09000028","Southwark","E12000007","London",1850,1848,2,120.8,836,2.2,"00BE","Southwark",NA,11563,11993,20835,21680,13988,14997,22169,24303,2425,3004,1334,2623
"3978","Southwark 006B","E01003940","E02000812","Southwark 006","E09000028","Southwark","E12000007","London",1483,1483,0,272.6,620,2.4,"00BE","Southwark",NA,5835,4741,6267,15432,6640,3983,7811,19989,805,-758,1544,4557
"3979","Southwark 006C","E01003941","E02000812","Southwark 006","E09000028","Southwark","E12000007","London",1897,1897,0,202.7,912,2.1,"00BE","Southwark",NA,6625,8454,11922,15110,14823,16002,22342,21007,8198,7548,10420,5897
"3980","Southwark 006D","E01003942","E02000812","Southwark 006","E09000028","Southwark","E12000007","London",1637,1399,238,137.4,561,2.5,"00BE","Southwark",NA,6701,6228,8170,16192,7195,7163,10754,21851,494,935,2584,5659
"3995","Southwark 009C","E01003943","E02000815","Southwark 009","E09000028","Southwark","E12000007","London",1367,1367,0,225.2,549,2.5,"00BE","Southwark",NA,4665,4704,9146,11275,3484,4164,6102,15301,-1181,-540,-3044,4026
"4110","Southwark 033A","E01003945","E02000839","Southwark 033","E09000028","Southwark","E12000007","London",1663,1663,0,19.8,730,2.3,"00BE","Southwark",NA,11761,14847,13997,21371,14617,18430,21451,30813,2856,3583,7454,9442
"4111","Southwark 033B","E01003946","E02000839","Southwark 033","E09000028","Southwark","E12000007","London",1768,1757,11,38.6,726,2.4,"00BE","Southwark",NA,13161,13084,20632,21672,14238,13946,15925,26724,1077,862,-4707,5052
"4112","Southwark 033C","E01003947","E02000839","Southwark 033","E09000028","Southwark","E12000007","London",1517,1517,0,108.6,612,2.5,"00BE","Southwark",NA,5892,3608,6138,10073,4350,1659,4516,12544,-1542,-1949,-1622,2471
"4113","Southwark 033D","E01003948","E02000839","Southwark 033","E09000028","Southwark","E12000007","London",1566,1529,37,58.5,742,2.1,"00BE","Southwark",NA,12205,14617,13751,22063,13380,14195,18149,22101,1175,-422,4398,38
"4105","Southwark 032A","E01003949","E02000838","Southwark 032","E09000028","Southwark","E12000007","London",1870,1860,10,82.3,871,2.1,"00BE","Southwark",NA,9800,10976,11360,29382,14954,15239,16127,24362,5154,4263,4767,-5020
"4106","Southwark 032B","E01003950","E02000838","Southwark 032","E09000028","Southwark","E12000007","London",1906,1896,10,77.9,798,2.4,"00BE","Southwark",NA,3650,3691,3039,14442,5588,4887,6628,15930,1938,1196,3589,1488
"4114","Southwark 033E","E01003951","E02000839","Southwark 033","E09000028","Southwark","E12000007","London",1522,1403,119,14.4,571,2.5,"00BE","Southwark",NA,13311,20439,21407,14607,15149,20781,20741,20936,1838,342,-666,6329
"4095","Southwark 030A","E01003952","E02000836","Southwark 030","E09000028","Southwark","E12000007","London",1640,1640,0,124.1,692,2.4,"00BE","Southwark",NA,13661,15343,21245,20143,16954,14993,19870,29223,3293,-350,-1375,9080
"4086","Southwark 028A","E01003953","E02000834","Southwark 028","E09000028","Southwark","E12000007","London",2082,2073,9,102.7,980,2.1,"00BE","Southwark",NA,9407,12164,13097,20184,14696,15832,17910,26862,5289,3668,4813,6678
"4096","Southwark 030B","E01003954","E02000836","Southwark 030","E09000028","Southwark","E12000007","London",1598,1596,2,158.1,670,2.4,"00BE","Southwark",NA,14140,13424,17278,24890,17378,15746,18474,28410,3238,2322,1196,3520
"4087","Southwark 028B","E01003955","E02000834","Southwark 028","E09000028","Southwark","E12000007","London",1817,1813,4,130.3,822,2.2,"00BE","Southwark",NA,10962,10191,11925,19609,16164,13378,16511,28244,5202,3187,4586,8635
"4097","Southwark 030C","E01003956","E02000836","Southwark 030","E09000028","Southwark","E12000007","London",1685,1685,0,145.9,720,2.3,"00BE","Southwark",NA,12448,13347,13428,22069,20584,18976,19207,30821,8136,5629,5779,8752
"4107","Southwark 032C","E01003957","E02000838","Southwark 032","E09000028","Southwark","E12000007","London",1788,1760,28,105.9,714,2.5,"00BE","Southwark",NA,12246,10692,14232,22663,17838,17656,19973,23877,5592,6964,5741,1214
"4108","Southwark 032D","E01003958","E02000838","Southwark 032","E09000028","Southwark","E12000007","London",1711,1710,1,107.6,699,2.4,"00BE","Southwark",NA,11827,12963,13252,23851,17740,16326,19748,27546,5913,3363,6496,3695
"4006","Southwark 012A","E01003960","E02000818","Southwark 012","E09000028","Southwark","E12000007","London",1863,1863,0,147,766,2.4,"00BE","Southwark",NA,7293,11127,18202,21440,7739,9987,15344,20638,446,-1140,-2858,-802
"4007","Southwark 012B","E01003961","E02000818","Southwark 012","E09000028","Southwark","E12000007","London",2045,2045,0,170.6,897,2.3,"00BE","Southwark",NA,2507,2244,3587,10560,3188,3190,5553,13428,681,946,1966,2868
"4026","Southwark 016A","E01003963","E02000822","Southwark 016","E09000028","Southwark","E12000007","London",1648,1648,0,277.4,662,2.5,"00BE","Southwark",NA,2581,1944,3305,9395,3111,2448,5073,12368,530,504,1768,2973
"4021","Southwark 015A","E01003964","E02000821","Southwark 015","E09000028","Southwark","E12000007","London",1927,1909,18,43.5,730,2.6,"00BE","Southwark",NA,2860,3315,3585,16457,5367,8547,9476,13744,2507,5232,5891,-2713
"4022","Southwark 015B","E01003966","E02000821","Southwark 015","E09000028","Southwark","E12000007","London",1941,1941,0,189.7,745,2.6,"00BE","Southwark",NA,3630,3692,4700,10991,4434,7033,8539,11663,804,3341,3839,672
"4027","Southwark 016B","E01003967","E02000822","Southwark 016","E09000028","Southwark","E12000007","London",1673,1658,15,288,600,2.8,"00BE","Southwark",NA,4893,3465,4559,11160,4631,4112,7674,13772,-262,647,3115,2612
"4023","Southwark 015C","E01003968","E02000821","Southwark 015","E09000028","Southwark","E12000007","London",1441,1441,0,270.4,525,2.7,"00BE","Southwark",NA,5915,3329,6165,14170,4496,3367,5161,11277,-1419,38,-1004,-2893
"4032","Southwark 017B","E01003969","E02000823","Southwark 017","E09000028","Southwark","E12000007","London",1858,1851,7,65.4,764,2.4,"00BE","Southwark",NA,5302,7142,9877,15823,7306,10027,13592,16569,2004,2885,3715,746
"4028","Southwark 016C","E01003970","E02000822","Southwark 016","E09000028","Southwark","E12000007","London",1486,1486,0,74.2,579,2.6,"00BE","Southwark",NA,5752,5707,8671,11166,3794,3262,7044,14346,-1958,-2445,-1627,3180
"4024","Southwark 015D","E01003971","E02000821","Southwark 015","E09000028","Southwark","E12000007","London",1809,1809,0,284,608,3,"00BE","Southwark",NA,6050,3110,8257,13268,4775,3186,5655,14016,-1275,76,-2602,748
"4029","Southwark 016D","E01003972","E02000822","Southwark 016","E09000028","Southwark","E12000007","London",1654,1654,0,227.2,714,2.3,"00BE","Southwark",NA,7138,8812,8624,14423,7745,8279,10141,17694,607,-533,1517,3271
"4030","Southwark 016E","E01003973","E02000822","Southwark 016","E09000028","Southwark","E12000007","London",1650,1650,0,186.2,739,2.2,"00BE","Southwark",NA,5076,4183,7795,10422,5709,7868,8614,10715,633,3685,819,293
"4025","Southwark 015E","E01003974","E02000821","Southwark 015","E09000028","Southwark","E12000007","London",1268,1268,0,227.2,489,2.6,"00BE","Southwark",NA,4937,3409,5833,12069,5236,4639,8597,13963,299,1230,2764,1894
"3972","Southwark 004A","E01003975","E02000810","Southwark 004","E09000028","Southwark","E12000007","London",1630,1630,0,199.3,667,2.4,"00BE","Southwark",NA,4321,2783,6387,8598,4886,3463,7099,12156,565,680,712,3558
"3964","Southwark 003A","E01003976","E02000809","Southwark 003","E09000028","Southwark","E12000007","London",1955,1955,0,162.9,916,2.1,"00BE","Southwark",NA,6039,4419,11000,10996,8724,9672,14929,12985,2685,5253,3929,1989
"3997","Southwark 010A","E01003977","E02000816","Southwark 010","E09000028","Southwark","E12000007","London",1672,1672,0,129.3,800,2.1,"00BE","Southwark",NA,5788,7375,6083,13149,4836,7164,7777,7989,-952,-211,1694,-5160
"3973","Southwark 004B","E01003978","E02000810","Southwark 004","E09000028","Southwark","E12000007","London",1840,1840,0,132.9,908,2,"00BE","Southwark",NA,7913,7644,11827,18027,8899,8592,15020,24328,986,948,3193,6301
"3981","Southwark 006E","E01003979","E02000812","Southwark 006","E09000028","Southwark","E12000007","London",1784,1664,120,106.6,809,2.1,"00BE","Southwark",NA,6402,6788,6157,13573,6588,7639,10048,13700,186,851,3891,127
"4010","Southwark 013A","E01003980","E02000819","Southwark 013","E09000028","Southwark","E12000007","London",1906,1899,7,98.2,847,2.2,"00BE","Southwark",NA,4197,4040,5313,18357,5109,6212,7980,15752,912,2172,2667,-2605
"3982","Southwark 006F","E01003981","E02000812","Southwark 006","E09000028","Southwark","E12000007","London",1675,1440,235,88,693,2.1,"00BE","Southwark",NA,9750,10596,13338,21815,7976,12340,16484,18097,-1774,1744,3146,-3718
"4036","Southwark 018A","E01003983","E02000824","Southwark 018","E09000028","Southwark","E12000007","London",2022,2021,1,172.2,730,2.8,"00BE","Southwark",NA,3061,1526,4396,11843,5321,3562,5435,11828,2260,2036,1039,-15
"4061","Southwark 023A","E01003984","E02000829","Southwark 023","E09000028","Southwark","E12000007","London",1997,1993,4,121.2,856,2.3,"00BE","Southwark",NA,3577,3706,4340,11451,4969,5166,7602,15741,1392,1460,3262,4290
"4002","Southwark 011A","E01003986","E02000817","Southwark 011","E09000028","Southwark","E12000007","London",1235,1230,5,68.5,549,2.2,"00BE","Southwark",NA,3494,3050,3418,5776,1788,1662,2549,6167,-1706,-1388,-869,391
"4003","Southwark 011B","E01003987","E02000817","Southwark 011","E09000028","Southwark","E12000007","London",1777,1777,0,129.4,754,2.4,"00BE","Southwark",NA,4991,2728,6068,8638,4888,3179,5282,8665,-103,451,-786,27
"4037","Southwark 018B","E01003988","E02000824","Southwark 018","E09000028","Southwark","E12000007","London",2193,2187,6,56.7,898,2.4,"00BE","Southwark",NA,4948,4031,5593,10221,5952,6310,8994,14434,1004,2279,3401,4213
"4038","Southwark 018C","E01003989","E02000824","Southwark 018","E09000028","Southwark","E12000007","London",1960,1960,0,79.9,720,2.7,"00BE","Southwark",NA,5630,3621,7279,12716,6822,5185,9578,14517,1192,1564,2299,1801
"4039","Southwark 018D","E01003990","E02000824","Southwark 018","E09000028","Southwark","E12000007","London",2132,2130,2,149.2,769,2.8,"00BE","Southwark",NA,3143,1636,3269,11412,5490,3110,4621,18803,2347,1474,1352,7391
"4033","Southwark 017C","E01003991","E02000823","Southwark 017","E09000028","Southwark","E12000007","London",1208,1208,0,153.1,559,2.2,"00BE","Southwark",NA,4781,4566,6064,9309,3666,2797,6340,9491,-1115,-1769,276,182
"4015","Southwark 014A","E01003992","E02000820","Southwark 014","E09000028","Southwark","E12000007","London",1492,1492,0,202.4,590,2.5,"00BE","Southwark",NA,6222,3509,9334,10622,6883,5213,10420,14906,661,1704,1086,4284
"4034","Southwark 017D","E01003993","E02000823","Southwark 017","E09000028","Southwark","E12000007","London",1713,1713,0,199.7,630,2.7,"00BE","Southwark",NA,4565,3320,4352,16097,5276,3209,5513,18513,711,-111,1161,2416
"4008","Southwark 012E","E01003994","E02000818","Southwark 012","E09000028","Southwark","E12000007","London",1493,1468,25,105.7,622,2.4,"00BE","Southwark",NA,4281,5062,5204,13979,4122,4371,6829,15797,-159,-691,1625,1818
"4016","Southwark 014B","E01003995","E02000820","Southwark 014","E09000028","Southwark","E12000007","London",1384,1384,0,215.6,738,1.9,"00BE","Southwark",NA,5694,5829,6381,18678,4002,6006,5720,16801,-1692,177,-661,-1877
"4035","Southwark 017E","E01003997","E02000823","Southwark 017","E09000028","Southwark","E12000007","London",1219,1219,0,159.6,472,2.6,"00BE","Southwark",NA,4971,4846,12052,11297,6583,7140,9693,21304,1612,2294,-2359,10007
"4017","Southwark 014D","E01003998","E02000820","Southwark 014","E09000028","Southwark","E12000007","London",1331,1331,0,142.2,632,2.1,"00BE","Southwark",NA,6610,8818,7619,18687,8893,10817,10527,22703,2283,1999,2908,4016
"4018","Southwark 014E","E01003999","E02000820","Southwark 014","E09000028","Southwark","E12000007","London",1442,1442,0,164.1,602,2.4,"00BE","Southwark",NA,6710,5675,10648,14983,8458,7817,10948,15753,1748,2142,300,770
"4076","Southwark 026A","E01004000","E02000832","Southwark 026","E09000028","Southwark","E12000007","London",1881,1874,7,115.9,839,2.2,"00BE","Southwark",NA,6336,5314,4701,13432,6368,5184,6788,13133,32,-130,2087,-299
"4077","Southwark 026B","E01004001","E02000832","Southwark 026","E09000028","Southwark","E12000007","London",1738,1738,0,88.9,718,2.4,"00BE","Southwark",NA,4461,2384,5082,8402,5142,3321,4821,12810,681,937,-261,4408
"4091","Southwark 029A","E01004002","E02000835","Southwark 029","E09000028","Southwark","E12000007","London",1609,1602,7,47.7,639,2.5,"00BE","Southwark",NA,9532,10766,10603,19948,12405,12697,12771,26750,2873,1931,2168,6802
"4062","Southwark 023B","E01004003","E02000829","Southwark 023","E09000028","Southwark","E12000007","London",1702,1700,2,134.8,755,2.3,"00BE","Southwark",NA,2665,3609,2135,11168,4198,3904,4303,14870,1533,295,2168,3702
"4063","Southwark 023C","E01004004","E02000829","Southwark 023","E09000028","Southwark","E12000007","London",2499,2492,7,127.6,1069,2.3,"00BE","Southwark",NA,3829,5076,3203,19461,5434,5080,7726,20539,1605,4,4523,1078
"4064","Southwark 023D","E01004005","E02000829","Southwark 023","E09000028","Southwark","E12000007","London",2223,2079,144,144.7,882,2.4,"00BE","Southwark",NA,1282,1475,1542,8628,2568,2907,2508,15500,1286,1432,966,6872
"4065","Southwark 023E","E01004006","E02000829","Southwark 023","E09000028","Southwark","E12000007","London",1968,1968,0,130,772,2.5,"00BE","Southwark",NA,6286,4468,5550,11026,7937,6867,10217,19561,1651,2399,4667,8535
"4040","Southwark 018E","E01004007","E02000824","Southwark 018","E09000028","Southwark","E12000007","London",1261,1261,0,157.8,436,2.9,"00BE","Southwark",NA,7171,4200,9499,13106,3789,1867,4899,15415,-3382,-2333,-4600,2309
"4057","Southwark 022B","E01004008","E02000828","Southwark 022","E09000028","Southwark","E12000007","London",2141,2134,7,213.2,808,2.6,"00BE","Southwark",NA,3205,1351,3006,9985,4785,3175,5730,17220,1580,1824,2724,7235
"4058","Southwark 022D","E01004010","E02000828","Southwark 022","E09000028","Southwark","E12000007","London",1526,1526,0,118.7,601,2.5,"00BE","Southwark",NA,4757,5144,7800,10786,5239,5459,7845,17133,482,315,45,6347
"4042","Southwark 019B","E01004011","E02000825","Southwark 019","E09000028","Southwark","E12000007","London",2112,2112,0,184.9,724,2.9,"00BE","Southwark",NA,3598,1942,3297,11951,6279,5130,6265,17150,2681,3188,2968,5199
"4043","Southwark 019C","E01004012","E02000825","Southwark 019","E09000028","Southwark","E12000007","London",2502,2502,0,177.8,934,2.7,"00BE","Southwark",NA,2327,636,3315,13037,8407,5864,9322,18415,6080,5228,6007,5378
"4044","Southwark 019D","E01004013","E02000825","Southwark 019","E09000028","Southwark","E12000007","London",1656,1656,0,158.3,606,2.7,"00BE","Southwark",NA,7149,4367,11311,10201,4505,3333,5342,15667,-2644,-1034,-5969,5466
"4045","Southwark 019E","E01004014","E02000825","Southwark 019","E09000028","Southwark","E12000007","London",1784,1739,45,194.5,710,2.4,"00BE","Southwark",NA,3821,2473,4803,8089,4500,2911,6545,17678,679,438,1742,9589
"4088","Southwark 028C","E01004015","E02000834","Southwark 028","E09000028","Southwark","E12000007","London",1558,1548,10,27.2,690,2.2,"00BE","Southwark",NA,10520,12478,16096,22643,10968,15408,16527,28293,448,2930,431,5650
"4092","Southwark 029B","E01004016","E02000835","Southwark 029","E09000028","Southwark","E12000007","London",2349,2347,2,41.1,934,2.5,"00BE","Southwark",NA,9195,9129,13099,17551,10698,9220,11766,24138,1503,91,-1333,6587
"4093","Southwark 029C","E01004017","E02000835","Southwark 029","E09000028","Southwark","E12000007","London",1548,1515,33,43.5,627,2.4,"00BE","Southwark",NA,14801,15782,17148,24207,16471,17346,17962,29575,1670,1564,814,5368
"4109","Southwark 032E","E01004018","E02000838","Southwark 032","E09000028","Southwark","E12000007","London",1905,1894,11,70.6,780,2.4,"00BE","Southwark",NA,16796,15689,19127,28981,21112,20082,23123,27306,4316,4393,3996,-1675
"4078","Southwark 026C","E01004019","E02000832","Southwark 026","E09000028","Southwark","E12000007","London",2319,2292,27,169.5,912,2.5,"00BE","Southwark",NA,6320,5567,4613,18554,9711,6518,8977,21030,3391,951,4364,2476
"4094","Southwark 029D","E01004020","E02000835","Southwark 029","E09000028","Southwark","E12000007","London",1730,1730,0,88.4,730,2.4,"00BE","Southwark",NA,4466,4055,4636,13157,7352,4618,9076,17604,2886,563,4440,4447
"4089","Southwark 028D","E01004021","E02000834","Southwark 028","E09000028","Southwark","E12000007","London",2109,2102,7,139,1032,2,"00BE","Southwark",NA,11831,16194,14279,25462,15967,16762,19856,23069,4136,568,5577,-2393
"3974","Southwark 004C","E01004022","E02000810","Southwark 004","E09000028","Southwark","E12000007","London",2483,2479,4,107,1146,2.2,"00BE","Southwark",NA,6153,6577,7365,10722,8992,9260,15304,19610,2839,2683,7939,8888
"3975","Southwark 004D","E01004023","E02000810","Southwark 004","E09000028","Southwark","E12000007","London",1540,1540,0,134.7,703,2.2,"00BE","Southwark",NA,6027,4853,6857,10304,5901,6482,10057,14593,-126,1629,3200,4289
"4004","Southwark 011C","E01004024","E02000817","Southwark 011","E09000028","Southwark","E12000007","London",1860,1825,35,154.5,819,2.2,"00BE","Southwark",NA,4358,4003,4093,9911,5031,4069,6776,11896,673,66,2683,1985
"3965","Southwark 003E","E01004027","E02000809","Southwark 003","E09000028","Southwark","E12000007","London",2072,2072,0,68.5,993,2.1,"00BE","Southwark",NA,7027,4609,7623,13781,11204,10824,13369,13743,4177,6215,5746,-38
"3976","Southwark 004E","E01004028","E02000810","Southwark 004","E09000028","Southwark","E12000007","London",1651,1642,9,137.8,713,2.3,"00BE","Southwark",NA,4460,3457,4646,13115,7368,7088,10373,18323,2908,3631,5727,5208
"3954","Southwark 001A","E01004029","E02000807","Southwark 001","E09000028","Southwark","E12000007","London",1835,1835,0,170.4,819,2.2,"00BE","Southwark",NA,13999,16459,26537,14298,19622,18464,27018,16312,5623,2005,481,2014
"3983","Southwark 007A","E01004030","E02000813","Southwark 007","E09000028","Southwark","E12000007","London",1457,1457,0,155.2,726,2,"00BE","Southwark",NA,6684,7829,8990,14755,7862,7434,8849,17368,1178,-395,-141,2613
"3984","Southwark 007B","E01004031","E02000813","Southwark 007","E09000028","Southwark","E12000007","London",2060,2036,24,48.3,880,2.3,"00BE","Southwark",NA,6257,7241,11673,16037,9077,10768,15765,24346,2820,3527,4092,8309
"3955","Southwark 001B","E01004032","E02000807","Southwark 001","E09000028","Southwark","E12000007","London",1695,1694,1,124.2,714,2.4,"00BE","Southwark",NA,19997,25900,30193,24087,26469,31254,32307,25367,6472,5354,2114,1280
"3985","Southwark 007C","E01004033","E02000813","Southwark 007","E09000028","Southwark","E12000007","London",1519,1513,6,104.5,699,2.2,"00BE","Southwark",NA,5051,4175,7746,13688,4685,4210,6613,18308,-366,35,-1133,4620
"3986","Southwark 007D","E01004034","E02000813","Southwark 007","E09000028","Southwark","E12000007","London",1541,1541,0,116.7,635,2.4,"00BE","Southwark",NA,4774,3167,8198,7192,6657,5633,9841,16559,1883,2466,1643,9367
"4005","Southwark 011D","E01004035","E02000817","Southwark 011","E09000028","Southwark","E12000007","London",1622,1593,29,72.3,687,2.3,"00BE","Southwark",NA,3223,4110,5544,9607,3056,3494,6372,12132,-167,-616,828,2525
"3987","Southwark 007E","E01004036","E02000813","Southwark 007","E09000028","Southwark","E12000007","London",2014,2014,0,207.8,806,2.5,"00BE","Southwark",NA,4160,3597,6392,11051,4556,4152,6612,12465,396,555,220,1414
"3998","Southwark 010B","E01004037","E02000816","Southwark 010","E09000028","Southwark","E12000007","London",1953,1953,0,131.7,878,2.2,"00BE","Southwark",NA,5883,4719,8382,12159,8892,8022,11709,20266,3009,3303,3327,8107
"3999","Southwark 010C","E01004038","E02000816","Southwark 010","E09000028","Southwark","E12000007","London",2340,2340,0,109,920,2.5,"00BE","Southwark",NA,6040,5871,9617,10872,8753,8344,11722,17599,2713,2473,2105,6727
"4011","Southwark 013B","E01004039","E02000819","Southwark 013","E09000028","Southwark","E12000007","London",1568,1568,0,183.2,633,2.5,"00BE","Southwark",NA,10032,8700,17846,15029,9216,12310,19354,16014,-816,3610,1508,985
"4012","Southwark 013C","E01004040","E02000819","Southwark 013","E09000028","Southwark","E12000007","London",1780,1780,0,161.5,680,2.6,"00BE","Southwark",NA,2134,2502,3209,10966,3081,3363,5042,14916,947,861,1833,3950
"4013","Southwark 013D","E01004041","E02000819","Southwark 013","E09000028","Southwark","E12000007","London",1660,1660,0,216.1,699,2.4,"00BE","Southwark",NA,6763,7136,9022,13525,6518,7713,10945,13059,-245,577,1923,-466
"4000","Southwark 010D","E01004042","E02000816","Southwark 010","E09000028","Southwark","E12000007","London",1712,1710,2,115.8,762,2.2,"00BE","Southwark",NA,3737,3352,3606,6538,2195,1895,3577,9957,-1542,-1457,-29,3419
"4001","Southwark 010E","E01004043","E02000816","Southwark 010","E09000028","Southwark","E12000007","London",1366,1355,11,114.3,599,2.3,"00BE","Southwark",NA,5337,6894,7249,8766,9224,10132,12157,11582,3887,3238,4908,2816
"4014","Southwark 013E","E01004044","E02000819","Southwark 013","E09000028","Southwark","E12000007","London",1401,1394,7,199.3,556,2.5,"00BE","Southwark",NA,4570,3500,4720,13431,5542,4504,6288,11827,972,1004,1568,-1604
"4081","Southwark 027A","E01004045","E02000833","Southwark 027","E09000028","Southwark","E12000007","London",1518,1518,0,243.7,601,2.5,"00BE","Southwark",NA,6302,3785,8924,12290,7526,5200,5921,16875,1224,1415,-3003,4585
"4090","Southwark 028E","E01004046","E02000834","Southwark 028","E09000028","Southwark","E12000007","London",1633,1625,8,110.6,674,2.4,"00BE","Southwark",NA,9408,10649,10110,22674,14028,15011,13821,25200,4620,4362,3711,2526
"4082","Southwark 027B","E01004047","E02000833","Southwark 027","E09000028","Southwark","E12000007","London",1595,1595,0,157.6,607,2.6,"00BE","Southwark",NA,6160,3354,8515,12147,8136,4965,8812,15514,1976,1611,297,3367
"4083","Southwark 027C","E01004048","E02000833","Southwark 027","E09000028","Southwark","E12000007","London",1587,1587,0,39.3,645,2.5,"00BE","Southwark",NA,11643,9976,17802,15402,12649,12248,14646,18763,1006,2272,-3156,3361
"4084","Southwark 027D","E01004049","E02000833","Southwark 027","E09000028","Southwark","E12000007","London",1672,1332,340,155.8,507,2.6,"00BE","Southwark",NA,10059,8253,15395,17112,10650,9902,15666,18328,591,1649,271,1216
"4069","Southwark 024D","E01004050","E02000830","Southwark 024","E09000028","Southwark","E12000007","London",1475,1472,3,79.9,652,2.3,"00BE","Southwark",NA,14227,15669,20264,23067,16052,18722,24570,31742,1825,3053,4306,8675
"4085","Southwark 027E","E01004051","E02000833","Southwark 027","E09000028","Southwark","E12000007","London",1383,1302,81,91.5,613,2.1,"00BE","Southwark",NA,16325,20599,24731,24516,25803,27364,31054,29719,9478,6765,6323,5203
"4070","Southwark 024E","E01004052","E02000830","Southwark 024","E09000028","Southwark","E12000007","London",1766,1759,7,102.1,798,2.2,"00BE","Southwark",NA,6351,9357,7263,19996,13599,16056,17440,23479,7248,6699,10177,3483
"3956","Southwark 001C","E01004053","E02000807","Southwark 001","E09000028","Southwark","E12000007","London",1836,1830,6,124.5,877,2.1,"00BE","Southwark",NA,19443,22447,28844,24894,26536,25646,30196,27087,7093,3199,1352,2193
"3957","Southwark 001D","E01004054","E02000807","Southwark 001","E09000028","Southwark","E12000007","London",1656,1655,1,134.3,782,2.1,"00BE","Southwark",NA,19696,27992,31615,23840,25809,28807,31882,31348,6113,815,267,7508
"3958","Southwark 001E","E01004055","E02000807","Southwark 001","E09000028","Southwark","E12000007","London",1291,1291,0,65.6,513,2.5,"00BE","Southwark",NA,4758,4187,5565,7551,4040,4248,4739,8252,-718,61,-826,701
"3988","Southwark 008A","E01004056","E02000814","Southwark 008","E09000028","Southwark","E12000007","London",2065,2061,4,110.1,906,2.3,"00BE","Southwark",NA,8322,7444,15718,18043,15554,13100,18096,23482,7232,5656,2378,5439
"3989","Southwark 008B","E01004057","E02000814","Southwark 008","E09000028","Southwark","E12000007","London",1500,1488,12,61.6,668,2.2,"00BE","Southwark",NA,12632,11833,16791,18827,14454,13655,16093,24951,1822,1822,-698,6124
"3990","Southwark 008C","E01004058","E02000814","Southwark 008","E09000028","Southwark","E12000007","London",1699,1699,0,121.1,855,2,"00BE","Southwark",NA,22010,32076,32353,25438,26188,32307,32727,32736,4178,231,374,7298
"3991","Southwark 008D","E01004059","E02000814","Southwark 008","E09000028","Southwark","E12000007","London",1487,1487,0,47.4,662,2.2,"00BE","Southwark",NA,15979,28473,31783,24829,19117,27567,32437,28809,3138,-906,654,3980
"3992","Southwark 008E","E01004060","E02000814","Southwark 008","E09000028","Southwark","E12000007","London",1901,1828,73,194.4,785,2.3,"00BE","Southwark",NA,4586,5890,7638,14678,6271,8063,11783,9638,1685,2173,4145,-5040
"4071","Southwark 025A","E01004061","E02000831","Southwark 025","E09000028","Southwark","E12000007","London",1750,1748,2,83.8,772,2.3,"00BE","Southwark",NA,10716,9944,11261,24979,12137,15933,18930,28883,1421,5989,7669,3904
"4072","Southwark 025B","E01004062","E02000831","Southwark 025","E09000028","Southwark","E12000007","London",1985,1932,53,119.4,830,2.3,"00BE","Southwark",NA,6098,6892,8423,14098,5720,7325,10300,13905,-378,433,1877,-193
"4073","Southwark 025C","E01004063","E02000831","Southwark 025","E09000028","Southwark","E12000007","London",1959,1927,32,111.4,847,2.3,"00BE","Southwark",NA,5115,5749,5669,14728,7168,8399,9849,29040,2053,2650,4180,14312
"4079","Southwark 026D","E01004064","E02000832","Southwark 026","E09000028","Southwark","E12000007","London",1975,1973,2,120.6,808,2.4,"00BE","Southwark",NA,3954,4921,5031,9580,6747,6063,7595,14724,2793,1142,2564,5144
"4074","Southwark 025D","E01004065","E02000831","Southwark 025","E09000028","Southwark","E12000007","London",1525,1515,10,135.8,625,2.4,"00BE","Southwark",NA,9647,8592,8827,17259,13020,14347,15910,25254,3373,5755,7083,7995
"4075","Southwark 025E","E01004066","E02000831","Southwark 025","E09000028","Southwark","E12000007","London",2159,2159,0,151.4,844,2.6,"00BE","Southwark",NA,3753,3293,4867,14852,8817,7791,8736,23246,5064,4498,3869,8394
"4059","Southwark 022E","E01004067","E02000828","Southwark 022","E09000028","Southwark","E12000007","London",2165,2147,18,93.1,831,2.6,"00BE","Southwark",NA,2541,2712,4180,11519,5273,6668,11809,15782,2732,3956,7629,4263
"4080","Southwark 026E","E01004068","E02000832","Southwark 026","E09000028","Southwark","E12000007","London",2047,1974,73,109.2,829,2.4,"00BE","Southwark",NA,3910,2122,4144,10382,4342,2808,4964,13528,432,686,820,3146
"4100","Southwark 031A","E01004069","E02000837","Southwark 031","E09000028","Southwark","E12000007","London",1437,1387,50,15.7,497,2.8,"00BE","Southwark",NA,20711,31833,32062,31774,24534,32269,32639,32583,3823,436,577,809
"4101","Southwark 031B","E01004070","E02000837","Southwark 031","E09000028","Southwark","E12000007","London",1985,1985,0,61.7,779,2.5,"00BE","Southwark",NA,13025,13899,14036,24627,18407,17573,20142,31596,5382,3674,6106,6969
"4098","Southwark 030D","E01004071","E02000836","Southwark 030","E09000028","Southwark","E12000007","London",1579,1572,7,125.7,663,2.4,"00BE","Southwark",NA,8976,7819,10138,17011,14134,11747,13836,28889,5158,3928,3698,11878
"4099","Southwark 030E","E01004072","E02000836","Southwark 030","E09000028","Southwark","E12000007","London",1738,1726,12,61.7,617,2.8,"00BE","Southwark",NA,18692,19978,20489,29905,23012,24456,26912,32475,4320,4478,6423,2570
"4102","Southwark 031C","E01004073","E02000837","Southwark 031","E09000028","Southwark","E12000007","London",1931,1931,0,96.7,736,2.6,"00BE","Southwark",NA,17386,20651,23979,30405,24484,23613,28484,32161,7098,2962,4505,1756
"4103","Southwark 031D","E01004074","E02000837","Southwark 031","E09000028","Southwark","E12000007","London",1883,1868,15,53.3,631,3,"00BE","Southwark",NA,16439,24477,24912,31497,23491,24340,27411,32501,7052,-137,2499,1004
"4104","Southwark 031E","E01004075","E02000837","Southwark 031","E09000028","Southwark","E12000007","London",1849,1849,0,31.4,657,2.8,"00BE","Southwark",NA,24193,30911,31971,31817,24696,31948,32451,32813,503,1037,480,996
"4170","Sutton 011A","E01004076","E02000850","Sutton 011","E09000029","Sutton","E12000007","London",1487,1487,0,4.3,616,2.4,"00BF","Sutton",NA,13472,13025,18037,16619,15595,14554,17164,17319,2123,1529,-873,700
"4171","Sutton 011B","E01004077","E02000850","Sutton 011","E09000029","Sutton","E12000007","London",1560,1558,2,59.1,629,2.5,"00BF","Sutton",NA,22391,20025,23574,18753,17970,19677,18157,17643,-4421,-348,-5417,-1110
"4172","Sutton 011C","E01004078","E02000850","Sutton 011","E09000029","Sutton","E12000007","London",1617,1617,0,50.1,686,2.4,"00BF","Sutton",NA,16298,12015,21703,10902,17347,14679,17027,13888,1049,2664,-4676,2986
"4173","Sutton 011D","E01004079","E02000850","Sutton 011","E09000029","Sutton","E12000007","London",1399,1399,0,43.7,489,2.9,"00BF","Sutton",NA,28462,28038,23919,26163,26368,29734,28700,26516,-2094,1696,4781,353
"4174","Sutton 011E","E01004080","E02000850","Sutton 011","E09000029","Sutton","E12000007","London",1332,1326,6,45.1,506,2.6,"00BF","Sutton",NA,29091,26114,29146,24311,28104,23950,24774,25144,-987,-2164,-4372,833
"4175","Sutton 011F","E01004081","E02000850","Sutton 011","E09000029","Sutton","E12000007","London",1507,1507,0,88.5,615,2.5,"00BF","Sutton",NA,24778,22609,26372,18642,23586,19634,23147,22139,-1192,-2975,-3225,3497
"4176","Sutton 011G","E01004082","E02000850","Sutton 011","E09000029","Sutton","E12000007","London",1407,1407,0,80.1,496,2.8,"00BF","Sutton",NA,29400,24655,29631,22498,29518,26997,28547,21429,118,2342,-1084,-1069
"4212","Sutton 019A","E01004083","E02000858","Sutton 019","E09000029","Sutton","E12000007","London",1420,1420,0,57.8,612,2.3,"00BF","Sutton",NA,4981,3590,4374,5177,4376,2686,3607,4005,-605,-904,-767,-1172
"4232","Sutton 024A","E01004084","E02000863","Sutton 024","E09000029","Sutton","E12000007","London",1462,1447,15,28.8,504,2.9,"00BF","Sutton",NA,29221,30529,28991,30344,29780,30993,29541,30335,559,464,550,-9
"4233","Sutton 024B","E01004085","E02000863","Sutton 024","E09000029","Sutton","E12000007","London",1595,1595,0,19.7,582,2.7,"00BF","Sutton",NA,26254,25105,25340,28506,24224,27863,25770,29436,-2030,2758,430,930
"4213","Sutton 019B","E01004086","E02000858","Sutton 019","E09000029","Sutton","E12000007","London",1617,1612,5,28.9,592,2.7,"00BF","Sutton",NA,16341,13422,17721,14978,16394,13276,17709,19386,53,-146,-12,4408
"4202","Sutton 017A","E01004087","E02000856","Sutton 017","E09000029","Sutton","E12000007","London",1465,1458,7,40.9,522,2.8,"00BF","Sutton",NA,29778,29093,29145,29194,28897,28167,26191,29061,-881,-926,-2954,-133
"4214","Sutton 019C","E01004088","E02000858","Sutton 019","E09000029","Sutton","E12000007","London",1818,1818,0,38.8,733,2.5,"00BF","Sutton",NA,4849,1730,3405,5907,2008,1233,1566,2550,-2841,-497,-1839,-3357
"4215","Sutton 019D","E01004089","E02000858","Sutton 019","E09000029","Sutton","E12000007","London",1290,1290,0,115,549,2.3,"00BF","Sutton",NA,6645,4571,5792,6527,6421,4379,5425,10734,-224,-192,-367,4207
"4222","Sutton 021A","E01004090","E02000860","Sutton 021","E09000029","Sutton","E12000007","London",1193,1168,25,63,540,2.2,"00BF","Sutton",NA,6828,4866,5087,8602,3846,3398,2737,8990,-2982,-1468,-2350,388
"4227","Sutton 022A","E01004091","E02000861","Sutton 022","E09000029","Sutton","E12000007","London",1282,1282,0,34.3,474,2.7,"00BF","Sutton",NA,30273,31746,30228,28748,29537,31536,28801,30263,-736,-210,-1427,1515
"4228","Sutton 022B","E01004092","E02000861","Sutton 022","E09000029","Sutton","E12000007","London",1437,1430,7,22.1,585,2.4,"00BF","Sutton",NA,29348,31494,28326,31545,26793,30524,30162,31729,-2555,-970,1836,184
"4236","Sutton 025A","E01004093","E02006836","Sutton 025","E09000029","Sutton","E12000007","London",1522,1499,23,37.8,598,2.5,"00BF","Sutton",NA,30256,28942,30112,30636,29613,30518,28149,31681,-643,1576,-1963,1045
"4237","Sutton 025B","E01004094","E02006836","Sutton 025","E09000029","Sutton","E12000007","London",1677,1677,0,60.4,748,2.2,"00BF","Sutton",NA,26955,24295,29931,29587,28796,26911,26941,30363,1841,2616,-2990,776
"4238","Sutton 025C","E01004095","E02006836","Sutton 025","E09000029","Sutton","E12000007","London",1511,1459,52,52.1,635,2.3,"00BF","Sutton",NA,27245,25519,25843,32042,29345,29242,27117,31886,2100,3723,1274,-156
"4223","Sutton 021B","E01004096","E02000860","Sutton 021","E09000029","Sutton","E12000007","London",1426,1412,14,92.7,756,1.9,"00BF","Sutton",NA,19048,15826,19692,27068,15753,14954,20290,24852,-3295,-872,598,-2216
"4192","Sutton 015A","E01004097","E02000854","Sutton 015","E09000029","Sutton","E12000007","London",1676,1676,0,61.6,625,2.7,"00BF","Sutton",NA,28026,22952,26257,28904,29106,26091,28656,29329,1080,3139,2399,425
"4193","Sutton 015B","E01004098","E02000854","Sutton 015","E09000029","Sutton","E12000007","London",1256,1234,22,56.2,504,2.4,"00BF","Sutton",NA,26199,24222,23105,31020,26975,21966,26032,31111,776,-2256,2927,91
"4194","Sutton 015C","E01004099","E02000854","Sutton 015","E09000029","Sutton","E12000007","London",1441,1441,0,37.1,711,2,"00BF","Sutton",NA,15995,13707,23220,14271,13179,11370,12611,18045,-2816,-2337,-10609,3774
"4195","Sutton 015D","E01004100","E02000854","Sutton 015","E09000029","Sutton","E12000007","London",1354,1354,0,38.5,536,2.5,"00BF","Sutton",NA,26052,25620,25981,24778,27627,26777,22949,26633,1575,1157,-3032,1855
"4182","Sutton 013A","E01004101","E02000852","Sutton 013","E09000029","Sutton","E12000007","London",1361,1361,0,60.8,531,2.6,"00BF","Sutton",NA,26253,26379,26507,22012,29698,28928,30126,24509,3445,2549,3619,2497
"4196","Sutton 015E","E01004102","E02000854","Sutton 015","E09000029","Sutton","E12000007","London",1374,1362,12,35.1,556,2.4,"00BF","Sutton",NA,23602,27096,16698,28115,22570,23302,17487,26833,-1032,-3794,789,-1282
"4183","Sutton 013B","E01004103","E02000852","Sutton 013","E09000029","Sutton","E12000007","London",1577,1577,0,89.8,734,2.1,"00BF","Sutton",NA,22347,18903,24308,28290,23987,18782,23504,27369,1640,-121,-804,-921
"4217","Sutton 020A","E01004104","E02000859","Sutton 020","E09000029","Sutton","E12000007","London",1528,1515,13,41.5,551,2.7,"00BF","Sutton",NA,32074,30680,31775,29748,31706,30972,29389,30118,-368,292,-2386,370
"4229","Sutton 022C","E01004105","E02000861","Sutton 022","E09000029","Sutton","E12000007","London",1819,1819,0,47.3,647,2.8,"00BF","Sutton",NA,22189,24235,10355,30192,31196,27025,29097,30590,9007,2790,18742,398
"4230","Sutton 022D","E01004106","E02000861","Sutton 022","E09000029","Sutton","E12000007","London",1529,1529,0,18.8,522,2.9,"00BF","Sutton",NA,31306,32438,31343,31740,32242,32660,31596,32041,936,222,253,301
"4218","Sutton 020B","E01004107","E02000859","Sutton 020","E09000029","Sutton","E12000007","London",1529,1522,7,63.2,619,2.5,"00BF","Sutton",NA,19401,12111,20968,15857,18792,14780,15818,18227,-609,2669,-5150,2370
"4234","Sutton 024C","E01004108","E02000863","Sutton 024","E09000029","Sutton","E12000007","London",1714,1645,69,3.7,595,2.8,"00BF","Sutton",NA,15265,17417,16384,14490,17540,20090,21056,20413,2275,2673,4672,5923
"4235","Sutton 024D","E01004109","E02000863","Sutton 024","E09000029","Sutton","E12000007","London",1596,1596,0,24,638,2.5,"00BF","Sutton",NA,17806,14291,18155,16918,17223,12890,11197,16555,-583,-1401,-6958,-363
"4197","Sutton 016A","E01004110","E02000855","Sutton 016","E09000029","Sutton","E12000007","London",1828,1809,19,58.9,790,2.3,"00BF","Sutton",NA,21280,17971,21882,27208,23729,19333,20020,27181,2449,1362,-1862,-27
"4198","Sutton 016B","E01004111","E02000855","Sutton 016","E09000029","Sutton","E12000007","London",1511,1511,0,31.7,578,2.6,"00BF","Sutton",NA,25602,25632,28926,25792,28510,26545,30447,27131,2908,913,1521,1339
"4199","Sutton 016C","E01004112","E02000855","Sutton 016","E09000029","Sutton","E12000007","London",1636,1635,1,31.2,668,2.4,"00BF","Sutton",NA,30794,31170,30937,31983,32177,32141,30559,32241,1383,971,-378,258
"4239","Sutton 025D","E01004114","E02006836","Sutton 025","E09000029","Sutton","E12000007","London",1735,1676,59,11.2,595,2.8,"00BF","Sutton",NA,30202,31733,29794,31227,30363,31689,31921,30868,161,-44,2127,-359
"4160","Sutton 009A","E01004115","E02000848","Sutton 009","E09000029","Sutton","E12000007","London",1750,1750,0,67.4,664,2.6,"00BF","Sutton",NA,27789,25192,24036,24081,27852,21917,29645,22609,63,-3275,5609,-1472
"4154","Sutton 008A","E01004116","E02000847","Sutton 008","E09000029","Sutton","E12000007","London",1608,1532,76,49.8,640,2.4,"00BF","Sutton",NA,27082,23263,29525,26659,28986,22253,27807,25530,1904,-1010,-1718,-1129
"4145","Sutton 006A","E01004117","E02000845","Sutton 006","E09000029","Sutton","E12000007","London",1464,1464,0,57.4,508,2.9,"00BF","Sutton",NA,29553,26589,31625,18125,31709,32034,30997,22613,2156,5445,-628,4488
"4161","Sutton 009B","E01004118","E02000848","Sutton 009","E09000029","Sutton","E12000007","London",1675,1675,0,61.8,669,2.5,"00BF","Sutton",NA,25317,24621,26386,22579,26540,23618,24389,23720,1223,-1003,-1997,1141
"4162","Sutton 009C","E01004119","E02000848","Sutton 009","E09000029","Sutton","E12000007","London",1418,1418,0,55.4,506,2.8,"00BF","Sutton",NA,29279,29957,31473,17362,25332,27896,28954,17625,-3947,-2061,-2519,263
"4200","Sutton 016D","E01004120","E02000855","Sutton 016","E09000029","Sutton","E12000007","London",1538,1538,0,53.3,547,2.8,"00BF","Sutton",NA,29659,31531,30416,24478,30655,29984,30536,23283,996,-1547,120,-1195
"4146","Sutton 006B","E01004121","E02000845","Sutton 006","E09000029","Sutton","E12000007","London",1566,1566,0,61.8,627,2.5,"00BF","Sutton",NA,21558,18700,24706,25607,25619,21358,25584,25101,4061,2658,878,-506
"4155","Sutton 008B","E01004122","E02000847","Sutton 008","E09000029","Sutton","E12000007","London",1372,1372,0,52.9,517,2.7,"00BF","Sutton",NA,30187,25946,29871,27662,29584,26918,27937,27737,-603,972,-1934,75
"4125","Sutton 002A","E01004123","E02000841","Sutton 002","E09000029","Sutton","E12000007","London",2126,2126,0,52.2,838,2.5,"00BF","Sutton",NA,6861,6264,10693,8867,7560,8426,9727,12217,699,2162,-966,3350
"4126","Sutton 002B","E01004124","E02000841","Sutton 002","E09000029","Sutton","E12000007","London",1826,1826,0,99.3,655,2.8,"00BF","Sutton",NA,11750,8360,14943,5476,12249,10030,9993,8740,499,1670,-4950,3264
"4120","Sutton 001A","E01004125","E02000840","Sutton 001","E09000029","Sutton","E12000007","London",1583,1583,0,114.1,630,2.5,"00BF","Sutton",NA,7721,6293,7711,5671,7689,6653,9767,6034,-32,360,2056,363
"4127","Sutton 002C","E01004126","E02000841","Sutton 002","E09000029","Sutton","E12000007","London",1509,1509,0,117.2,564,2.7,"00BF","Sutton",NA,10299,8126,14989,4394,7089,5651,9269,5112,-3210,-2475,-5720,718
"4140","Sutton 005A","E01004127","E02000844","Sutton 005","E09000029","Sutton","E12000007","London",1645,1645,0,79.8,630,2.6,"00BF","Sutton",NA,13769,10801,17039,9951,14026,13434,14034,13605,257,2633,-3005,3654
"4128","Sutton 002D","E01004128","E02000841","Sutton 002","E09000029","Sutton","E12000007","London",1488,1401,87,87.2,528,2.7,"00BF","Sutton",NA,11609,9203,13668,5570,10841,8877,8921,8949,-768,-326,-4747,3379
"4129","Sutton 002E","E01004129","E02000841","Sutton 002","E09000029","Sutton","E12000007","London",1772,1762,10,66.9,750,2.3,"00BF","Sutton",NA,6744,6112,6568,5082,6125,6532,7425,5093,-619,420,857,11
"4130","Sutton 003A","E01004130","E02000842","Sutton 003","E09000029","Sutton","E12000007","London",1598,1598,0,23.6,644,2.5,"00BF","Sutton",NA,21873,23783,24952,17759,21905,22759,22963,21275,32,-1024,-1989,3516
"4131","Sutton 003B","E01004131","E02000842","Sutton 003","E09000029","Sutton","E12000007","London",1632,1632,0,79.5,613,2.7,"00BF","Sutton",NA,22479,21352,23374,20689,25517,21869,25367,20062,3038,517,1993,-627
"4163","Sutton 009D","E01004132","E02000848","Sutton 009","E09000029","Sutton","E12000007","London",1536,1536,0,89.8,514,3,"00BF","Sutton",NA,29052,27625,28830,20873,29496,27824,30698,19663,444,199,1868,-1210
"4164","Sutton 009E","E01004133","E02000848","Sutton 009","E09000029","Sutton","E12000007","London",1510,1510,0,78.9,533,2.8,"00BF","Sutton",NA,29005,27357,29170,17510,29128,27847,27711,18862,123,490,-1459,1352
"4132","Sutton 003C","E01004134","E02000842","Sutton 003","E09000029","Sutton","E12000007","London",1435,1435,0,65.5,555,2.6,"00BF","Sutton",NA,19359,21056,24406,16157,20136,19173,20790,17076,777,-1883,-3616,919
"4133","Sutton 003D","E01004135","E02000842","Sutton 003","E09000029","Sutton","E12000007","London",1448,1448,0,52.3,517,2.8,"00BF","Sutton",NA,25406,25037,26095,19268,24537,24296,22751,16585,-869,-741,-3344,-2683
"4134","Sutton 003E","E01004136","E02000842","Sutton 003","E09000029","Sutton","E12000007","London",1553,1553,0,64.3,550,2.8,"00BF","Sutton",NA,22467,19697,21096,16430,26432,25529,24712,18832,3965,5832,3616,2402
"4177","Sutton 012A","E01004137","E02000851","Sutton 012","E09000029","Sutton","E12000007","London",1518,1518,0,65.5,763,2,"00BF","Sutton",NA,20315,23617,26037,27706,15330,17985,18694,26604,-4985,-5632,-7343,-1102
"4184","Sutton 013C","E01004138","E02000852","Sutton 013","E09000029","Sutton","E12000007","London",1552,1552,0,91.9,697,2.2,"00BF","Sutton",NA,19276,16733,20839,20535,19769,16923,18471,23045,493,190,-2368,2510
"4185","Sutton 013D","E01004139","E02000852","Sutton 013","E09000029","Sutton","E12000007","London",1368,1358,10,88.5,595,2.3,"00BF","Sutton",NA,24762,22577,21933,28140,22307,20984,20428,25763,-2455,-1593,-1505,-2377
"4178","Sutton 012B","E01004140","E02000851","Sutton 012","E09000029","Sutton","E12000007","London",1509,1509,0,114.1,746,2,"00BF","Sutton",NA,6395,5451,5855,8205,4588,5113,5686,10363,-1807,-338,-169,2158
"4179","Sutton 012C","E01004141","E02000851","Sutton 012","E09000029","Sutton","E12000007","London",1555,1536,19,129.3,724,2.1,"00BF","Sutton",NA,11402,8964,11565,17074,10986,8324,9882,14938,-416,-640,-1683,-2136
"4180","Sutton 012D","E01004142","E02000851","Sutton 012","E09000029","Sutton","E12000007","London",2038,2024,14,53.1,1052,1.9,"00BF","Sutton",NA,6576,6142,5241,10698,10270,7719,11678,16888,3694,1577,6437,6190
"4187","Sutton 014A","E01004143","E02000853","Sutton 014","E09000029","Sutton","E12000007","London",1453,1453,0,122.8,626,2.3,"00BF","Sutton",NA,22263,18381,27103,23894,23193,17959,23475,22861,930,-422,-3628,-1033
"4150","Sutton 007A","E01004144","E02000846","Sutton 007","E09000029","Sutton","E12000007","London",1627,1627,0,40,633,2.6,"00BF","Sutton",NA,20704,27229,27550,24962,25083,25538,24840,26777,4379,-1691,-2710,1815
"4151","Sutton 007B","E01004145","E02000846","Sutton 007","E09000029","Sutton","E12000007","London",2131,2131,0,46.5,786,2.7,"00BF","Sutton",NA,18736,16658,22744,15615,19398,16321,22458,19622,662,-337,-286,4007
"4152","Sutton 007C","E01004146","E02000846","Sutton 007","E09000029","Sutton","E12000007","London",1710,1661,49,79.8,686,2.4,"00BF","Sutton",NA,12079,15222,14926,21832,19230,18302,21103,22741,7151,3080,6177,909
"4153","Sutton 007D","E01004147","E02000846","Sutton 007","E09000029","Sutton","E12000007","London",1585,1537,48,55.3,603,2.5,"00BF","Sutton",NA,22799,19215,20812,21192,27671,24542,25596,21438,4872,5327,4784,246
"4188","Sutton 014B","E01004148","E02000853","Sutton 014","E09000029","Sutton","E12000007","London",1592,1592,0,67.8,643,2.5,"00BF","Sutton",NA,11417,11069,11640,13776,12772,10852,12727,16108,1355,-217,1087,2332
"4181","Sutton 012E","E01004149","E02000851","Sutton 012","E09000029","Sutton","E12000007","London",1710,1710,0,62.4,813,2.1,"00BF","Sutton",NA,19022,18895,21664,19186,20933,20520,21579,20353,1911,1625,-85,1167
"4224","Sutton 021C","E01004150","E02000860","Sutton 021","E09000029","Sutton","E12000007","London",1560,1548,12,96.7,936,1.7,"00BF","Sutton",NA,15522,11885,13970,22292,11784,8952,10859,20254,-3738,-2933,-3111,-2038
"4225","Sutton 021D","E01004151","E02000860","Sutton 021","E09000029","Sutton","E12000007","London",1711,1587,124,85.1,790,2,"00BF","Sutton",NA,20806,19029,20436,31409,18733,18407,19208,26206,-2073,-622,-1228,-5203
"4207","Sutton 018A","E01004152","E02000857","Sutton 018","E09000029","Sutton","E12000007","London",1562,1506,56,76.3,849,1.8,"00BF","Sutton",NA,17892,15328,19661,27174,14646,11614,18604,24575,-3246,-3714,-1057,-2599
"4226","Sutton 021E","E01004153","E02000860","Sutton 021","E09000029","Sutton","E12000007","London",1708,1708,0,98.8,903,1.9,"00BF","Sutton",NA,22527,21830,22950,29525,20234,17792,19772,26130,-2293,-4038,-3178,-3395
"4231","Sutton 022E","E01004154","E02000861","Sutton 022","E09000029","Sutton","E12000007","London",1430,1419,11,42,561,2.5,"00BF","Sutton",NA,30831,29787,29268,31471,31407,31159,29017,32256,576,1372,-251,785
"4208","Sutton 018B","E01004155","E02000857","Sutton 018","E09000029","Sutton","E12000007","London",1628,1549,79,85.1,822,1.9,"00BF","Sutton",NA,24570,22078,29331,30648,27555,25720,30764,29910,2985,3642,1433,-738
"4209","Sutton 018C","E01004156","E02000857","Sutton 018","E09000029","Sutton","E12000007","London",1687,1653,34,81.2,892,1.9,"00BF","Sutton",NA,24593,25098,26559,31380,22628,20890,27262,29598,-1965,-4208,703,-1782
"4201","Sutton 016E","E01004157","E02000855","Sutton 016","E09000029","Sutton","E12000007","London",1274,1274,0,48.7,452,2.8,"00BF","Sutton",NA,31938,31970,30741,31180,32267,32306,31613,30691,329,336,872,-489
"4210","Sutton 018D","E01004158","E02000857","Sutton 018","E09000029","Sutton","E12000007","London",1479,1438,41,62.1,696,2.1,"00BF","Sutton",NA,27199,27983,26123,31290,25827,21439,23763,30366,-1372,-6544,-2360,-924
"4189","Sutton 014C","E01004159","E02000853","Sutton 014","E09000029","Sutton","E12000007","London",1528,1528,0,44.8,629,2.4,"00BF","Sutton",NA,22996,23193,25000,19540,19748,19043,18828,16264,-3248,-4150,-6172,-3276
"4190","Sutton 014D","E01004160","E02000853","Sutton 014","E09000029","Sutton","E12000007","London",1575,1575,0,69.8,672,2.3,"00BF","Sutton",NA,26201,25929,27699,26702,25566,23200,24370,27247,-635,-2729,-3329,545
"4191","Sutton 014E","E01004161","E02000853","Sutton 014","E09000029","Sutton","E12000007","London",1444,1444,0,44.2,594,2.4,"00BF","Sutton",NA,27921,26038,29207,24519,26870,24420,26318,22450,-1051,-1618,-2889,-2069
"4211","Sutton 018E","E01004162","E02000857","Sutton 018","E09000029","Sutton","E12000007","London",1549,1500,49,87,745,2,"00BF","Sutton",NA,20489,18955,23419,29448,21469,18032,23211,28101,980,-923,-208,-1347
"4141","Sutton 005B","E01004163","E02000844","Sutton 005","E09000029","Sutton","E12000007","London",1541,1541,0,71.2,615,2.5,"00BF","Sutton",NA,20321,22104,24271,11910,19305,19117,19746,14809,-1016,-2987,-4525,2899
"4135","Sutton 004A","E01004164","E02000843","Sutton 004","E09000029","Sutton","E12000007","London",1476,1476,0,62.9,639,2.3,"00BF","Sutton",NA,20547,24096,27158,13547,19243,24096,25669,13189,-1304,0,-1489,-358
"4142","Sutton 005C","E01004165","E02000844","Sutton 005","E09000029","Sutton","E12000007","London",1668,1668,0,66.6,705,2.4,"00BF","Sutton",NA,15960,13763,17110,13437,16340,13888,14683,17866,380,125,-2427,4429
"4136","Sutton 004B","E01004166","E02000843","Sutton 004","E09000029","Sutton","E12000007","London",1449,1449,0,58.7,658,2.2,"00BF","Sutton",NA,20959,17541,20897,18250,20797,17623,20346,23065,-162,82,-551,4815
"4143","Sutton 005D","E01004167","E02000844","Sutton 005","E09000029","Sutton","E12000007","London",1318,1318,0,80.5,527,2.5,"00BF","Sutton",NA,11969,7651,13745,11766,8956,5246,9646,11730,-3013,-2405,-4099,-36
"4186","Sutton 013E","E01004168","E02000852","Sutton 013","E09000029","Sutton","E12000007","London",1576,1576,0,70.1,579,2.7,"00BF","Sutton",NA,24934,23905,22567,17757,25592,26810,24942,15176,658,2905,2375,-2581
"4137","Sutton 004C","E01004169","E02000843","Sutton 004","E09000029","Sutton","E12000007","London",1135,1135,0,78.3,460,2.5,"00BF","Sutton",NA,8196,4375,10776,7993,13710,13245,19227,14311,5514,8870,8451,6318
"4203","Sutton 017B","E01004170","E02000856","Sutton 017","E09000029","Sutton","E12000007","London",1721,1714,7,68.5,751,2.3,"00BF","Sutton",NA,25644,26132,23400,28693,23396,19248,25142,27105,-2248,-6884,1742,-1588
"4165","Sutton 010A","E01004171","E02000849","Sutton 010","E09000029","Sutton","E12000007","London",1518,1493,25,41.3,558,2.7,"00BF","Sutton",NA,24914,23370,25759,22975,25933,25868,29680,25508,1019,2498,3921,2533
"4166","Sutton 010B","E01004172","E02000849","Sutton 010","E09000029","Sutton","E12000007","London",1549,1527,22,86.6,748,2,"00BF","Sutton",NA,9983,7584,11182,19699,12600,8225,11830,20576,2617,641,648,877
"4167","Sutton 010C","E01004173","E02000849","Sutton 010","E09000029","Sutton","E12000007","London",1385,1385,0,61.3,520,2.7,"00BF","Sutton",NA,21423,20546,21979,17583,19032,16379,17087,20808,-2391,-4167,-4892,3225
"4204","Sutton 017C","E01004174","E02000856","Sutton 017","E09000029","Sutton","E12000007","London",1444,1444,0,84.3,664,2.2,"00BF","Sutton",NA,17531,17465,14807,26458,18198,18502,14830,25146,667,1037,23,-1312
"4168","Sutton 010D","E01004175","E02000849","Sutton 010","E09000029","Sutton","E12000007","London",1614,1608,6,62,690,2.3,"00BF","Sutton",NA,23170,20257,20764,19342,22462,21040,19636,19034,-708,783,-1128,-308
"4169","Sutton 010E","E01004176","E02000849","Sutton 010","E09000029","Sutton","E12000007","London",1419,1419,0,88.1,583,2.4,"00BF","Sutton",NA,20319,17769,24506,19481,18962,16716,21287,24225,-1357,-1053,-3219,4744
"4219","Sutton 020C","E01004177","E02000859","Sutton 020","E09000029","Sutton","E12000007","London",1754,1684,70,78.8,911,1.8,"00BF","Sutton",NA,12899,13273,14799,22221,12080,9436,11750,22846,-819,-3837,-3049,625
"4205","Sutton 017D","E01004178","E02000856","Sutton 017","E09000029","Sutton","E12000007","London",1979,1961,18,81.8,950,2.1,"00BF","Sutton",NA,13051,13212,15229,25690,14507,12883,15604,23582,1456,-329,375,-2108
"4206","Sutton 017E","E01004179","E02000856","Sutton 017","E09000029","Sutton","E12000007","London",1567,1560,7,68.2,599,2.6,"00BF","Sutton",NA,25541,25453,27171,28600,25969,25239,29850,28649,428,-214,2679,49
"4220","Sutton 020D","E01004180","E02000859","Sutton 020","E09000029","Sutton","E12000007","London",1711,1682,29,28.7,616,2.7,"00BF","Sutton",NA,30307,30275,25509,30886,30137,27103,26510,30167,-170,-3172,1001,-719
"4221","Sutton 020E","E01004181","E02000859","Sutton 020","E09000029","Sutton","E12000007","London",1643,1583,60,58.5,756,2.1,"00BF","Sutton",NA,18270,17966,19678,27466,17046,14906,17731,23850,-1224,-3060,-1947,-3616
"4216","Sutton 019E","E01004182","E02000858","Sutton 019","E09000029","Sutton","E12000007","London",1546,1546,0,105,653,2.4,"00BF","Sutton",NA,13425,7266,14112,15530,9690,6898,7144,15260,-3735,-368,-6968,-270
"4121","Sutton 001B","E01004183","E02000840","Sutton 001","E09000029","Sutton","E12000007","London",1667,1667,0,78.3,663,2.5,"00BF","Sutton",NA,8356,5873,9919,5049,9060,8103,8860,6872,704,2230,-1059,1823
"4122","Sutton 001C","E01004184","E02000840","Sutton 001","E09000029","Sutton","E12000007","London",1590,1590,0,57.5,598,2.7,"00BF","Sutton",NA,7692,4618,8708,4309,7755,6808,8074,6066,63,2190,-634,1757
"4123","Sutton 001D","E01004185","E02000840","Sutton 001","E09000029","Sutton","E12000007","London",1452,1427,25,36,565,2.5,"00BF","Sutton",NA,6768,3924,6501,6755,3965,2819,4069,3357,-2803,-1105,-2432,-3398
"4138","Sutton 004D","E01004186","E02000843","Sutton 004","E09000029","Sutton","E12000007","London",1724,1724,0,57.6,790,2.2,"00BF","Sutton",NA,19592,16433,24756,17917,19522,18173,21330,21210,-70,1740,-3426,3293
"4144","Sutton 005E","E01004187","E02000844","Sutton 005","E09000029","Sutton","E12000007","London",1607,1607,0,92.3,640,2.5,"00BF","Sutton",NA,13152,11245,16029,8143,10504,9142,10436,10786,-2648,-2103,-5593,2643
"4139","Sutton 004E","E01004188","E02000843","Sutton 004","E09000029","Sutton","E12000007","London",1711,1711,0,48.5,724,2.4,"00BF","Sutton",NA,15666,8757,18675,13301,15248,10929,15499,11487,-418,2172,-3176,-1814
"4124","Sutton 001E","E01004189","E02000840","Sutton 001","E09000029","Sutton","E12000007","London",1879,1879,0,55.9,750,2.5,"00BF","Sutton",NA,10627,7697,13204,6943,8793,7839,9283,7363,-1834,142,-3921,420
"4156","Sutton 008C","E01004190","E02000847","Sutton 008","E09000029","Sutton","E12000007","London",1367,1367,0,51.7,499,2.7,"00BF","Sutton",NA,31189,30515,30821,23847,31021,30688,28984,25652,-168,173,-1837,1805
"4157","Sutton 008D","E01004191","E02000847","Sutton 008","E09000029","Sutton","E12000007","London",1651,1651,0,67.3,657,2.5,"00BF","Sutton",NA,26905,23391,28426,23053,28015,24345,26457,23657,1110,954,-1969,604
"4147","Sutton 006C","E01004192","E02000845","Sutton 006","E09000029","Sutton","E12000007","London",1931,1931,0,49.5,753,2.6,"00BF","Sutton",NA,22301,16156,27994,13451,23500,18708,22568,18672,1199,2552,-5426,5221
"4148","Sutton 006D","E01004193","E02000845","Sutton 006","E09000029","Sutton","E12000007","London",2328,2328,0,62.7,923,2.5,"00BF","Sutton",NA,28455,27352,28717,19793,23706,17201,26479,20429,-4749,-10151,-2238,636
"4158","Sutton 008E","E01004194","E02000847","Sutton 008","E09000029","Sutton","E12000007","London",1356,1356,0,66.2,609,2.2,"00BF","Sutton",NA,20684,16015,17625,22940,24147,22042,20842,22880,3463,6027,3217,-60
"4149","Sutton 006E","E01004195","E02000845","Sutton 006","E09000029","Sutton","E12000007","London",1578,1561,17,66.6,661,2.4,"00BF","Sutton",NA,21332,17632,18707,22961,24939,21847,27144,24184,3607,4215,8437,1223
"4159","Sutton 008F","E01004196","E02000847","Sutton 008","E09000029","Sutton","E12000007","London",1444,1430,14,59.1,567,2.5,"00BF","Sutton",NA,29850,28320,27670,24011,29712,24591,29232,25881,-138,-3729,1562,1870
"4245","Tower Hamlets 002A","E01004197","E02000865","Tower Hamlets 002","E09000030","Tower Hamlets","E12000007","London",2329,2285,44,137.1,964,2.4,"00BG","Tower Hamlets",NA,1945,2076,4668,18162,4639,4440,7562,16575,2694,2364,2894,-1587
"4246","Tower Hamlets 002B","E01004198","E02000865","Tower Hamlets 002","E09000030","Tower Hamlets","E12000007","London",1529,1522,7,160.9,606,2.5,"00BG","Tower Hamlets",NA,1582,964,3253,10586,2046,1873,3846,9596,464,909,593,-990
"4247","Tower Hamlets 002C","E01004199","E02000865","Tower Hamlets 002","E09000030","Tower Hamlets","E12000007","London",1637,1637,0,237.2,574,2.9,"00BG","Tower Hamlets",NA,977,247,3820,5136,1319,1198,2563,6652,342,951,-1257,1516
"4260","Tower Hamlets 005A","E01004200","E02000868","Tower Hamlets 005","E09000030","Tower Hamlets","E12000007","London",1566,1394,172,273.3,585,2.4,"00BG","Tower Hamlets",NA,6461,6989,14191,15445,8220,9814,18457,29894,1759,2825,4266,14449
"4248","Tower Hamlets 002D","E01004201","E02000865","Tower Hamlets 002","E09000030","Tower Hamlets","E12000007","London",1556,1533,23,119.9,619,2.5,"00BG","Tower Hamlets",NA,4309,1614,6309,14722,6563,4707,7999,17817,2254,3093,1690,3095
"4261","Tower Hamlets 005B","E01004202","E02000868","Tower Hamlets 005","E09000030","Tower Hamlets","E12000007","London",1705,1705,0,152,713,2.4,"00BG","Tower Hamlets",NA,4148,1801,7225,13945,8470,7158,15059,22747,4322,5357,7834,8802
"4262","Tower Hamlets 005C","E01004203","E02000868","Tower Hamlets 005","E09000030","Tower Hamlets","E12000007","London",1779,1779,0,169.1,689,2.6,"00BG","Tower Hamlets",NA,3179,2722,9544,11550,6930,9006,14102,19879,3751,6284,4558,8329
"4263","Tower Hamlets 005D","E01004204","E02000868","Tower Hamlets 005","E09000030","Tower Hamlets","E12000007","London",1582,1538,44,187.2,631,2.4,"00BG","Tower Hamlets",NA,2748,1001,5234,12629,3278,1940,5027,13484,530,939,-207,855
"4295","Tower Hamlets 013A","E01004205","E02000876","Tower Hamlets 013","E09000030","Tower Hamlets","E12000007","London",2106,2106,0,155.9,688,3.1,"00BG","Tower Hamlets",NA,1224,145,3884,6711,3008,1859,4532,9616,1784,1714,648,2905
"4296","Tower Hamlets 013B","E01004206","E02000876","Tower Hamlets 013","E09000030","Tower Hamlets","E12000007","London",1492,1491,1,194,554,2.7,"00BG","Tower Hamlets",NA,796,114,1984,7043,1408,1254,3224,7673,612,1140,1240,630
"4286","Tower Hamlets 011A","E01004207","E02000874","Tower Hamlets 011","E09000030","Tower Hamlets","E12000007","London",1416,1342,74,206.4,515,2.6,"00BG","Tower Hamlets",NA,4518,2241,8795,17744,3336,3870,6119,11423,-1182,1629,-2676,-6321
"4297","Tower Hamlets 013C","E01004208","E02000876","Tower Hamlets 013","E09000030","Tower Hamlets","E12000007","London",1976,1842,134,122.1,788,2.3,"00BG","Tower Hamlets",NA,6350,3973,14767,19865,7015,11816,18825,22328,665,7843,4058,2463
"4287","Tower Hamlets 011B","E01004209","E02000874","Tower Hamlets 011","E09000030","Tower Hamlets","E12000007","London",1366,1366,0,169.9,466,2.9,"00BG","Tower Hamlets",NA,2562,614,7017,6155,1999,1507,5613,7451,-563,893,-1404,1296
"4298","Tower Hamlets 013D","E01004211","E02000876","Tower Hamlets 013","E09000030","Tower Hamlets","E12000007","London",1463,1461,2,88.8,720,2,"00BG","Tower Hamlets",NA,4788,4239,9629,20315,5346,8041,13946,29851,558,3802,4317,9536
"4288","Tower Hamlets 011D","E01004212","E02000874","Tower Hamlets 011","E09000030","Tower Hamlets","E12000007","London",1780,1604,176,202.7,720,2.2,"00BG","Tower Hamlets",NA,3639,1772,8826,13747,6771,8387,13734,13488,3132,6615,4908,-259
"4366","Tower Hamlets 030A","E01004214","E02000893","Tower Hamlets 030","E09000030","Tower Hamlets","E12000007","London",1669,1669,0,248.4,665,2.5,"00BG","Tower Hamlets",NA,1241,80,2356,9424,2622,1231,2178,6275,1381,1151,-178,-3149
"4358","Tower Hamlets 028A","E01004215","E02000891","Tower Hamlets 028","E09000030","Tower Hamlets","E12000007","London",2756,2756,0,91.4,1168,2.4,"00BG","Tower Hamlets",NA,4142,1315,6472,11698,11618,7554,15275,22056,7476,6239,8803,10358
"4367","Tower Hamlets 030B","E01004216","E02000893","Tower Hamlets 030","E09000030","Tower Hamlets","E12000007","London",1619,1619,0,178.5,737,2.2,"00BG","Tower Hamlets",NA,14105,10656,24462,18906,18141,12497,23141,24234,4036,1841,-1321,5328
"4368","Tower Hamlets 030C","E01004217","E02000893","Tower Hamlets 030","E09000030","Tower Hamlets","E12000007","London",1745,1745,0,42.2,779,2.2,"00BG","Tower Hamlets",NA,6264,3718,9444,18062,9132,6558,9944,18988,2868,2840,500,926
"4369","Tower Hamlets 030D","E01004218","E02000893","Tower Hamlets 030","E09000030","Tower Hamlets","E12000007","London",1750,1750,0,119,731,2.4,"00BG","Tower Hamlets",NA,14112,11562,18283,19173,19205,14750,21971,25426,5093,3188,3688,6253
"4359","Tower Hamlets 028B","E01004219","E02000891","Tower Hamlets 028","E09000030","Tower Hamlets","E12000007","London",2294,2294,0,115,851,2.7,"00BG","Tower Hamlets",NA,537,63,2012,12634,5688,4600,11110,16187,5151,4537,9098,3553
"4360","Tower Hamlets 028D","E01004221","E02000891","Tower Hamlets 028","E09000030","Tower Hamlets","E12000007","London",1881,1881,0,141.3,802,2.3,"00BG","Tower Hamlets",NA,9101,4065,17907,17698,12786,9849,13772,23851,3685,5784,-4135,6153
"4241","Tower Hamlets 001A","E01004222","E02000864","Tower Hamlets 001","E09000030","Tower Hamlets","E12000007","London",2480,2479,1,179.5,1048,2.4,"00BG","Tower Hamlets",NA,1374,593,2238,5974,2724,1249,3871,10272,1350,656,1633,4298
"4242","Tower Hamlets 001B","E01004223","E02000864","Tower Hamlets 001","E09000030","Tower Hamlets","E12000007","London",2079,2079,0,35.1,938,2.2,"00BG","Tower Hamlets",NA,1860,1444,3015,12474,3753,4449,5691,10942,1893,3005,2676,-1532
"4243","Tower Hamlets 001C","E01004224","E02000864","Tower Hamlets 001","E09000030","Tower Hamlets","E12000007","London",2000,2000,0,45.6,806,2.5,"00BG","Tower Hamlets",NA,1420,1875,2636,5508,4699,3798,7617,12713,3279,1923,4981,7205
"4254","Tower Hamlets 004A","E01004225","E02000867","Tower Hamlets 004","E09000030","Tower Hamlets","E12000007","London",2178,2178,0,173.5,1147,1.9,"00BG","Tower Hamlets",NA,11373,24251,30509,21402,13864,15287,28229,20174,2491,-8964,-2280,-1228
"4244","Tower Hamlets 001D","E01004226","E02000864","Tower Hamlets 001","E09000030","Tower Hamlets","E12000007","London",1738,1738,0,187.5,676,2.6,"00BG","Tower Hamlets",NA,4689,2545,5573,10199,4281,3914,7295,12047,-408,1369,1722,1848
"4249","Tower Hamlets 003A","E01004228","E02000866","Tower Hamlets 003","E09000030","Tower Hamlets","E12000007","London",1857,1849,8,146.6,769,2.4,"00BG","Tower Hamlets",NA,7475,7272,8336,20595,9763,9469,12464,23285,2288,2197,4128,2690
"4255","Tower Hamlets 004C","E01004229","E02000867","Tower Hamlets 004","E09000030","Tower Hamlets","E12000007","London",1484,1484,0,142.4,551,2.7,"00BG","Tower Hamlets",NA,4667,2742,7442,13455,6711,6016,10398,15733,2044,3274,2956,2278
"4250","Tower Hamlets 003B","E01004230","E02000866","Tower Hamlets 003","E09000030","Tower Hamlets","E12000007","London",2101,2091,10,133.1,803,2.6,"00BG","Tower Hamlets",NA,3607,2251,5312,12860,6106,6647,9471,12812,2499,4396,4159,-48
"4256","Tower Hamlets 004D","E01004231","E02000867","Tower Hamlets 004","E09000030","Tower Hamlets","E12000007","London",1793,1793,0,165.4,629,2.9,"00BG","Tower Hamlets",NA,1534,989,4451,8235,4117,4156,7759,10791,2583,3167,3308,2556
"4251","Tower Hamlets 003C","E01004232","E02000866","Tower Hamlets 003","E09000030","Tower Hamlets","E12000007","London",1665,1631,34,86.1,603,2.7,"00BG","Tower Hamlets",NA,7330,8905,11954,25480,12002,16296,20867,30905,4672,7391,8913,5425
"4252","Tower Hamlets 003D","E01004233","E02000866","Tower Hamlets 003","E09000030","Tower Hamlets","E12000007","London",1821,1821,0,218.9,751,2.4,"00BG","Tower Hamlets",NA,3276,891,4806,8975,5262,2367,6441,9059,1986,1476,1635,84
"4253","Tower Hamlets 003E","E01004234","E02000866","Tower Hamlets 003","E09000030","Tower Hamlets","E12000007","London",2218,2218,0,38.7,903,2.5,"00BG","Tower Hamlets",NA,7529,9752,12273,24541,9985,16309,20252,25066,2456,6557,7979,525
"4272","Tower Hamlets 008A","E01004235","E02000871","Tower Hamlets 008","E09000030","Tower Hamlets","E12000007","London",1372,1372,0,345.6,513,2.7,"00BG","Tower Hamlets",NA,1923,767,5267,8083,4738,2716,5049,10828,2815,1949,-218,2745
"4273","Tower Hamlets 008B","E01004236","E02000871","Tower Hamlets 008","E09000030","Tower Hamlets","E12000007","London",1679,1679,0,164.3,497,3.4,"00BG","Tower Hamlets",NA,789,69,3881,4738,2710,1323,4733,8223,1921,1254,852,3485
"4274","Tower Hamlets 008C","E01004237","E02000871","Tower Hamlets 008","E09000030","Tower Hamlets","E12000007","London",1158,1158,0,177.3,506,2.3,"00BG","Tower Hamlets",NA,3029,1354,7692,11901,4254,2200,7551,19104,1225,846,-141,7203
"4275","Tower Hamlets 008D","E01004238","E02000871","Tower Hamlets 008","E09000030","Tower Hamlets","E12000007","London",2733,2733,0,77,1058,2.6,"00BG","Tower Hamlets",NA,717,50,3710,5435,3501,1552,7395,18030,2784,1502,3685,12595
"4276","Tower Hamlets 008E","E01004239","E02000871","Tower Hamlets 008","E09000030","Tower Hamlets","E12000007","London",1649,1649,0,154.5,533,3.1,"00BG","Tower Hamlets",NA,2794,1330,6000,9530,3334,2869,5767,7436,540,1539,-233,-2094
"4290","Tower Hamlets 012A","E01004240","E02000875","Tower Hamlets 012","E09000030","Tower Hamlets","E12000007","London",1815,1815,0,209.6,574,3.2,"00BG","Tower Hamlets",NA,2965,453,6324,8258,4235,3349,6551,8443,1270,2896,227,185
"4291","Tower Hamlets 012B","E01004241","E02000875","Tower Hamlets 012","E09000030","Tower Hamlets","E12000007","London",1621,1621,0,138.8,570,2.8,"00BG","Tower Hamlets",NA,1494,241,3740,5708,2608,2578,4430,8714,1114,2337,690,3006
"4292","Tower Hamlets 012C","E01004242","E02000875","Tower Hamlets 012","E09000030","Tower Hamlets","E12000007","London",2453,2433,20,121.6,898,2.7,"00BG","Tower Hamlets",NA,798,160,1954,7383,3361,2261,7298,12618,2563,2101,5344,5235
"4325","Tower Hamlets 020A","E01004243","E02000883","Tower Hamlets 020","E09000030","Tower Hamlets","E12000007","London",1789,1789,0,153.4,614,2.9,"00BG","Tower Hamlets",NA,1660,360,3614,7327,3699,3728,4376,4273,2039,3368,762,-3054
"4326","Tower Hamlets 020B","E01004244","E02000883","Tower Hamlets 020","E09000030","Tower Hamlets","E12000007","London",1885,1788,97,137.1,686,2.6,"00BG","Tower Hamlets",NA,912,661,1563,9689,1192,968,1002,8001,280,307,-561,-1688
"4317","Tower Hamlets 018A","E01004245","E02000881","Tower Hamlets 018","E09000030","Tower Hamlets","E12000007","London",1539,1539,0,72.5,433,3.6,"00BG","Tower Hamlets",NA,375,49,1857,3816,1487,431,2294,4939,1112,382,437,1123
"4318","Tower Hamlets 018B","E01004246","E02000881","Tower Hamlets 018","E09000030","Tower Hamlets","E12000007","London",1977,1977,0,97.1,747,2.6,"00BG","Tower Hamlets",NA,5886,4495,9599,17256,4396,4635,8764,14083,-1490,140,-835,-3173
"4327","Tower Hamlets 020C","E01004247","E02000883","Tower Hamlets 020","E09000030","Tower Hamlets","E12000007","London",1934,1934,0,162.5,714,2.7,"00BG","Tower Hamlets",NA,1156,481,5301,4796,1248,979,2667,5937,92,498,-2634,1141
"4319","Tower Hamlets 018C","E01004248","E02000881","Tower Hamlets 018","E09000030","Tower Hamlets","E12000007","London",1344,1344,0,125.7,441,3,"00BG","Tower Hamlets",NA,834,177,3182,4742,1088,650,3117,2118,254,473,-65,-2624
"4320","Tower Hamlets 018D","E01004249","E02000881","Tower Hamlets 018","E09000030","Tower Hamlets","E12000007","London",2049,2049,0,112.5,758,2.7,"00BG","Tower Hamlets",NA,1829,613,3877,6672,1450,731,3048,6201,-379,118,-829,-471
"4328","Tower Hamlets 020D","E01004250","E02000883","Tower Hamlets 020","E09000030","Tower Hamlets","E12000007","London",2342,2342,0,234.4,866,2.7,"00BG","Tower Hamlets",NA,1523,299,3708,3365,1960,1185,3653,5353,437,886,-55,1988
"4338","Tower Hamlets 023A","E01004251","E02000886","Tower Hamlets 023","E09000030","Tower Hamlets","E12000007","London",2082,2082,0,163.6,779,2.7,"00BG","Tower Hamlets",NA,828,200,2526,7069,4211,3771,6773,11044,3383,3571,4247,3975
"4342","Tower Hamlets 024A","E01004252","E02000887","Tower Hamlets 024","E09000030","Tower Hamlets","E12000007","London",2707,2707,0,168.1,1107,2.4,"00BG","Tower Hamlets",NA,221,19,341,6652,3354,2513,5397,16538,3133,2494,5056,9886
"4343","Tower Hamlets 024B","E01004253","E02000887","Tower Hamlets 024","E09000030","Tower Hamlets","E12000007","London",2340,2266,74,153.3,829,2.7,"00BG","Tower Hamlets",NA,3355,1833,6567,8738,3679,2534,5752,8277,324,701,-815,-461
"4339","Tower Hamlets 023B","E01004254","E02000886","Tower Hamlets 023","E09000030","Tower Hamlets","E12000007","London",2120,2120,0,124.3,1046,2,"00BG","Tower Hamlets",NA,13869,14549,28571,18141,12809,10594,23155,28638,-1060,-3955,-5416,10497
"4340","Tower Hamlets 023C","E01004255","E02000886","Tower Hamlets 023","E09000030","Tower Hamlets","E12000007","London",1618,1618,0,172.3,647,2.5,"00BG","Tower Hamlets",NA,1628,202,3595,7078,4059,3476,5437,11573,2431,3274,1842,4495
"4344","Tower Hamlets 024C","E01004256","E02000887","Tower Hamlets 024","E09000030","Tower Hamlets","E12000007","London",1729,1729,0,120.7,611,2.8,"00BG","Tower Hamlets",NA,1198,353,4207,9084,2606,1161,4196,7232,1408,808,-11,-1852
"4345","Tower Hamlets 024D","E01004257","E02000887","Tower Hamlets 024","E09000030","Tower Hamlets","E12000007","London",1884,1883,1,149.9,618,3,"00BG","Tower Hamlets",NA,2122,1513,7955,5738,2620,1586,6298,7275,498,73,-1657,1537
"4341","Tower Hamlets 023D","E01004258","E02000886","Tower Hamlets 023","E09000030","Tower Hamlets","E12000007","London",1506,1506,0,154.5,713,2.1,"00BG","Tower Hamlets",NA,7757,6911,12959,7554,11594,11365,15187,19431,3837,4454,2228,11877
"4268","Tower Hamlets 007A","E01004259","E02000870","Tower Hamlets 007","E09000030","Tower Hamlets","E12000007","London",1723,1694,29,129.3,812,2.1,"00BG","Tower Hamlets",NA,5465,5211,9672,20003,7762,8918,14161,21171,2297,3707,4489,1168
"4269","Tower Hamlets 007B","E01004260","E02000870","Tower Hamlets 007","E09000030","Tower Hamlets","E12000007","London",1790,1790,0,182.5,636,2.8,"00BG","Tower Hamlets",NA,3433,1181,8221,8225,3708,3638,7322,10893,275,2457,-899,2668
"4281","Tower Hamlets 010A","E01004261","E02000873","Tower Hamlets 010","E09000030","Tower Hamlets","E12000007","London",2525,1655,870,151.9,550,3,"00BG","Tower Hamlets",NA,8499,6305,19737,6956,9309,10370,20753,9353,810,4065,1016,2397
"4282","Tower Hamlets 010B","E01004262","E02000873","Tower Hamlets 010","E09000030","Tower Hamlets","E12000007","London",1742,1366,376,118.7,495,2.8,"00BG","Tower Hamlets",NA,5443,3248,9393,13870,6573,9011,16003,12260,1130,5763,6610,-1610
"4270","Tower Hamlets 007C","E01004263","E02000870","Tower Hamlets 007","E09000030","Tower Hamlets","E12000007","London",1419,1401,18,174.1,529,2.6,"00BG","Tower Hamlets",NA,3857,1525,5561,11283,3739,2936,6750,7132,-118,1411,1189,-4151
"4283","Tower Hamlets 010C","E01004264","E02000873","Tower Hamlets 010","E09000030","Tower Hamlets","E12000007","London",1537,1537,0,252.8,457,3.4,"00BG","Tower Hamlets",NA,2821,409,6793,7278,4533,2400,7328,10548,1712,1991,535,3270
"4271","Tower Hamlets 007D","E01004266","E02000870","Tower Hamlets 007","E09000030","Tower Hamlets","E12000007","London",1545,1545,0,188.2,583,2.7,"00BG","Tower Hamlets",NA,4523,3137,9244,12840,7926,6453,10817,21324,3403,3316,1573,8484
"4293","Tower Hamlets 012D","E01004267","E02000875","Tower Hamlets 012","E09000030","Tower Hamlets","E12000007","London",1767,1754,13,83.8,707,2.5,"00BG","Tower Hamlets",NA,3275,2736,8502,12831,3494,2220,7477,17423,219,-516,-1025,4592
"4294","Tower Hamlets 012E","E01004268","E02000875","Tower Hamlets 012","E09000030","Tower Hamlets","E12000007","London",1784,1756,28,345.1,688,2.6,"00BG","Tower Hamlets",NA,751,276,2411,3741,3717,2016,5364,10429,2966,1740,2953,6688
"4299","Tower Hamlets 014A","E01004269","E02000877","Tower Hamlets 014","E09000030","Tower Hamlets","E12000007","London",1975,1920,55,127.3,726,2.6,"00BG","Tower Hamlets",NA,2069,1686,3517,7295,3344,3450,7302,17407,1275,1764,3785,10112
"4300","Tower Hamlets 014B","E01004270","E02000877","Tower Hamlets 014","E09000030","Tower Hamlets","E12000007","London",2236,2236,0,76.2,745,3,"00BG","Tower Hamlets",NA,5441,4847,14115,12986,7979,8222,18309,19189,2538,3375,4194,6203
"4301","Tower Hamlets 014C","E01004271","E02000877","Tower Hamlets 014","E09000030","Tower Hamlets","E12000007","London",1589,1589,0,165.7,548,2.9,"00BG","Tower Hamlets",NA,2012,427,4035,8462,3746,2264,7126,8670,1734,1837,3091,208
"4302","Tower Hamlets 014D","E01004272","E02000877","Tower Hamlets 014","E09000030","Tower Hamlets","E12000007","London",2099,2099,0,221.4,639,3.3,"00BG","Tower Hamlets",NA,1483,158,4896,4461,2542,1640,3270,6649,1059,1482,-1626,2188
"4303","Tower Hamlets 014E","E01004273","E02000877","Tower Hamlets 014","E09000030","Tower Hamlets","E12000007","London",1904,1904,0,112.9,594,3.2,"00BG","Tower Hamlets",NA,1315,208,4413,6938,1604,798,3464,7071,289,590,-949,133
"4370","Tower Hamlets 031A","E01004274","E02000894","Tower Hamlets 031","E09000030","Tower Hamlets","E12000007","London",1973,1973,0,232.4,654,3,"00BG","Tower Hamlets",NA,2935,333,6065,14618,7912,3943,7507,14907,4977,3610,1442,289
"4371","Tower Hamlets 031B","E01004275","E02000894","Tower Hamlets 031","E09000030","Tower Hamlets","E12000007","London",1879,1879,0,135.5,768,2.4,"00BG","Tower Hamlets",NA,8388,10197,14605,12266,16101,14489,18933,16936,7713,4292,4328,4670
"4372","Tower Hamlets 031C","E01004276","E02000894","Tower Hamlets 031","E09000030","Tower Hamlets","E12000007","London",2024,2024,0,248.6,996,2,"00BG","Tower Hamlets",NA,24253,32307,32400,26619,27612,31577,32635,27663,3359,-730,235,1044
"4381","Tower Hamlets 033A","E01004277","E02006854","Tower Hamlets 033","E09000030","Tower Hamlets","E12000007","London",1630,1630,0,37.8,898,1.8,"00BG","Tower Hamlets",NA,21021,32250,31438,24084,26856,29549,28111,32285,5835,-2701,-3327,8201
"4376","Tower Hamlets 032A","E01004280","E02006853","Tower Hamlets 032","E09000030","Tower Hamlets","E12000007","London",1879,1879,0,137.9,769,2.4,"00BG","Tower Hamlets",NA,4819,1180,8788,14760,7292,4318,9236,13338,2473,3138,448,-1422
"4373","Tower Hamlets 031D","E01004281","E02000894","Tower Hamlets 031","E09000030","Tower Hamlets","E12000007","London",1770,1770,0,140.9,831,2.1,"00BG","Tower Hamlets",NA,18970,19240,30375,21737,20952,23765,29045,24562,1982,4525,-1330,2825
"4309","Tower Hamlets 016A","E01004283","E02000879","Tower Hamlets 016","E09000030","Tower Hamlets","E12000007","London",2317,2143,174,153.3,756,2.8,"00BG","Tower Hamlets",NA,2231,239,5722,14661,5052,3825,8631,11720,2821,3586,2909,-2941
"4321","Tower Hamlets 019A","E01004284","E02000882","Tower Hamlets 019","E09000030","Tower Hamlets","E12000007","London",2302,2302,0,120.6,884,2.6,"00BG","Tower Hamlets",NA,258,12,1400,5641,6032,4657,11561,18014,5774,4645,10161,12373
"4322","Tower Hamlets 019B","E01004285","E02000882","Tower Hamlets 019","E09000030","Tower Hamlets","E12000007","London",2318,2318,0,185.9,658,3.5,"00BG","Tower Hamlets",NA,1355,31,5599,9039,2972,1628,4306,5295,1617,1597,-1293,-3744
"4323","Tower Hamlets 019C","E01004286","E02000882","Tower Hamlets 019","E09000030","Tower Hamlets","E12000007","London",2364,2353,11,151.5,817,2.9,"00BG","Tower Hamlets",NA,2127,678,2591,12906,3214,2278,3666,10679,1087,1600,1075,-2227
"4310","Tower Hamlets 016B","E01004287","E02000879","Tower Hamlets 016","E09000030","Tower Hamlets","E12000007","London",2171,2171,0,254.5,854,2.5,"00BG","Tower Hamlets",NA,2237,343,4364,10128,5116,3657,7381,11753,2879,3314,3017,1625
"4324","Tower Hamlets 019D","E01004288","E02000882","Tower Hamlets 019","E09000030","Tower Hamlets","E12000007","London",1620,1590,30,157.6,525,3,"00BG","Tower Hamlets",NA,2732,454,5205,12025,2393,1481,3592,7228,-339,1027,-1613,-4797
"4311","Tower Hamlets 016C","E01004289","E02000879","Tower Hamlets 016","E09000030","Tower Hamlets","E12000007","London",1844,1844,0,175.8,670,2.8,"00BG","Tower Hamlets",NA,3606,901,5959,17506,4562,4172,6637,16475,956,3271,678,-1031
"4312","Tower Hamlets 016D","E01004290","E02000879","Tower Hamlets 016","E09000030","Tower Hamlets","E12000007","London",1302,1259,43,126.9,575,2.2,"00BG","Tower Hamlets",NA,4422,1956,10094,17014,6198,8049,11848,21070,1776,6093,1754,4056
"4355","Tower Hamlets 027A","E01004291","E02000890","Tower Hamlets 027","E09000030","Tower Hamlets","E12000007","London",1844,1844,0,159.1,1051,1.8,"00BG","Tower Hamlets",NA,10910,12100,18732,20969,20448,21952,25842,28683,9538,9852,7110,7714
"4351","Tower Hamlets 026A","E01004292","E02000889","Tower Hamlets 026","E09000030","Tower Hamlets","E12000007","London",1738,1738,0,115.9,818,2.1,"00BG","Tower Hamlets",NA,17725,20791,28550,25131,24280,27432,31267,28964,6555,6641,2717,3833
"4356","Tower Hamlets 027B","E01004293","E02000890","Tower Hamlets 027","E09000030","Tower Hamlets","E12000007","London",2125,2125,0,65.1,1133,1.9,"00BG","Tower Hamlets",NA,16657,15875,25365,27845,23630,24309,28070,28559,6973,8434,2705,714
"4352","Tower Hamlets 026B","E01004294","E02000889","Tower Hamlets 026","E09000030","Tower Hamlets","E12000007","London",1757,1690,67,82.4,877,1.9,"00BG","Tower Hamlets",NA,4599,3773,2473,21644,12187,11537,14792,24436,7588,7764,12319,2792
"4353","Tower Hamlets 026C","E01004295","E02000889","Tower Hamlets 026","E09000030","Tower Hamlets","E12000007","London",1516,1516,0,186.5,500,3,"00BG","Tower Hamlets",NA,1281,108,5244,12309,3513,2693,5501,7789,2232,2585,257,-4520
"4354","Tower Hamlets 026D","E01004296","E02000889","Tower Hamlets 026","E09000030","Tower Hamlets","E12000007","London",1605,1605,0,118.9,684,2.3,"00BG","Tower Hamlets",NA,3957,654,7354,12256,6454,3526,7238,17721,2497,2872,-116,5465
"4357","Tower Hamlets 027C","E01004297","E02000890","Tower Hamlets 027","E09000030","Tower Hamlets","E12000007","London",1826,1826,0,151.7,909,2,"00BG","Tower Hamlets",NA,15716,13722,24746,22580,21978,23298,29257,29158,6262,9576,4511,6578
"4334","Tower Hamlets 022A","E01004298","E02000885","Tower Hamlets 022","E09000030","Tower Hamlets","E12000007","London",1637,1629,8,178.3,635,2.6,"00BG","Tower Hamlets",NA,475,233,2538,5030,2403,1378,5865,11716,1928,1145,3327,6686
"4335","Tower Hamlets 022B","E01004300","E02000885","Tower Hamlets 022","E09000030","Tower Hamlets","E12000007","London",1349,1349,0,258.4,522,2.6,"00BG","Tower Hamlets",NA,3076,830,4557,11565,3245,1564,4504,11546,169,734,-53,-19
"4346","Tower Hamlets 025B","E01004301","E02000888","Tower Hamlets 025","E09000030","Tower Hamlets","E12000007","London",1324,1324,0,161.9,413,3.2,"00BG","Tower Hamlets",NA,1363,300,7574,9076,2591,1738,6306,13012,1228,1438,-1268,3936
"4347","Tower Hamlets 025C","E01004302","E02000888","Tower Hamlets 025","E09000030","Tower Hamlets","E12000007","London",1987,1987,0,399,637,3.1,"00BG","Tower Hamlets",NA,617,132,6011,5037,5249,4526,11449,8558,4632,4394,5438,3521
"4348","Tower Hamlets 025D","E01004303","E02000888","Tower Hamlets 025","E09000030","Tower Hamlets","E12000007","London",2362,2362,0,106.5,967,2.4,"00BG","Tower Hamlets",NA,5573,2793,8281,21771,7672,4713,11370,20206,2099,1920,3089,-1565
"4336","Tower Hamlets 022C","E01004304","E02000885","Tower Hamlets 022","E09000030","Tower Hamlets","E12000007","London",1957,1955,2,190.4,653,3,"00BG","Tower Hamlets",NA,430,128,3699,8484,2748,2554,5797,8496,2318,2426,2098,12
"4337","Tower Hamlets 022D","E01004305","E02000885","Tower Hamlets 022","E09000030","Tower Hamlets","E12000007","London",1952,1940,12,214.3,699,2.8,"00BG","Tower Hamlets",NA,2294,289,5383,9884,4212,2770,8010,12197,1918,2481,2627,2313
"4304","Tower Hamlets 015A","E01004306","E02000878","Tower Hamlets 015","E09000030","Tower Hamlets","E12000007","London",1799,1799,0,147.7,687,2.6,"00BG","Tower Hamlets",NA,2901,1613,7886,10021,3830,6442,11538,21659,929,4829,3652,11638
"4305","Tower Hamlets 015B","E01004307","E02000878","Tower Hamlets 015","E09000030","Tower Hamlets","E12000007","London",2186,1857,329,101.9,1014,1.8,"00BG","Tower Hamlets",NA,9056,10014,18887,15163,16147,22127,29983,20876,7091,12113,11096,5713
"4306","Tower Hamlets 015C","E01004308","E02000878","Tower Hamlets 015","E09000030","Tower Hamlets","E12000007","London",1478,1469,9,177.4,504,2.9,"00BG","Tower Hamlets",NA,4401,2186,7617,12761,5669,5163,10232,13735,1268,2977,2615,974
"4307","Tower Hamlets 015D","E01004309","E02000878","Tower Hamlets 015","E09000030","Tower Hamlets","E12000007","London",2852,2433,419,224.9,902,2.7,"00BG","Tower Hamlets",NA,559,135,1077,7512,2409,2557,4080,12274,1850,2422,3003,4762
"4308","Tower Hamlets 015E","E01004310","E02000878","Tower Hamlets 015","E09000030","Tower Hamlets","E12000007","London",1971,1893,78,214.5,793,2.4,"00BG","Tower Hamlets",NA,582,97,2303,9406,4509,5008,6826,16884,3927,4911,4523,7478
"4264","Tower Hamlets 006A","E01004311","E02000869","Tower Hamlets 006","E09000030","Tower Hamlets","E12000007","London",1518,1518,0,179.2,644,2.4,"00BG","Tower Hamlets",NA,2002,1045,2531,10530,3009,3101,6617,16860,1007,2056,4086,6330
"4277","Tower Hamlets 009A","E01004312","E02000872","Tower Hamlets 009","E09000030","Tower Hamlets","E12000007","London",1614,1614,0,234.9,628,2.6,"00BG","Tower Hamlets",NA,1205,566,4335,5448,2778,1536,6049,9867,1573,970,1714,4419
"4278","Tower Hamlets 009B","E01004313","E02000872","Tower Hamlets 009","E09000030","Tower Hamlets","E12000007","London",2043,2043,0,248.8,812,2.5,"00BG","Tower Hamlets",NA,2590,849,7216,8527,7274,5473,11885,14627,4684,4624,4669,6100
"4265","Tower Hamlets 006B","E01004314","E02000869","Tower Hamlets 006","E09000030","Tower Hamlets","E12000007","London",1100,1100,0,132.1,493,2.2,"00BG","Tower Hamlets",NA,7597,6247,16913,21526,11058,15167,23060,25358,3461,8920,6147,3832
"4266","Tower Hamlets 006C","E01004315","E02000869","Tower Hamlets 006","E09000030","Tower Hamlets","E12000007","London",1628,1628,0,170.3,718,2.3,"00BG","Tower Hamlets",NA,2034,1261,4030,9991,5204,6067,9496,20337,3170,4806,5466,10346
"4279","Tower Hamlets 009C","E01004316","E02000872","Tower Hamlets 009","E09000030","Tower Hamlets","E12000007","London",1138,1134,4,323.3,455,2.5,"00BG","Tower Hamlets",NA,2267,1205,5386,7482,2933,4185,6269,14943,666,2980,883,7461
"4280","Tower Hamlets 009D","E01004317","E02000872","Tower Hamlets 009","E09000030","Tower Hamlets","E12000007","London",2706,2689,17,100,1193,2.3,"00BG","Tower Hamlets",NA,2518,1683,3419,18120,7110,8151,13712,28771,4592,6468,10293,10651
"4267","Tower Hamlets 006D","E01004318","E02000869","Tower Hamlets 006","E09000030","Tower Hamlets","E12000007","London",1459,1433,26,248.6,630,2.3,"00BG","Tower Hamlets",NA,2169,1707,2275,11025,2639,2523,3516,12298,470,816,1241,1273
"4329","Tower Hamlets 021A","E01004319","E02000884","Tower Hamlets 021","E09000030","Tower Hamlets","E12000007","London",1886,1886,0,210.3,595,3.2,"00BG","Tower Hamlets",NA,896,64,3129,6231,4078,3051,7546,14159,3182,2987,4417,7928
"4330","Tower Hamlets 021C","E01004321","E02000884","Tower Hamlets 021","E09000030","Tower Hamlets","E12000007","London",1822,1769,53,174.7,711,2.5,"00BG","Tower Hamlets",NA,1879,749,5325,11102,4068,3163,6554,16696,2189,2414,1229,5594
"4313","Tower Hamlets 017A","E01004322","E02000880","Tower Hamlets 017","E09000030","Tower Hamlets","E12000007","London",1292,1160,132,91.1,502,2.3,"00BG","Tower Hamlets",NA,2421,2102,5828,16030,2643,4664,7198,17255,222,2562,1370,1225
"4314","Tower Hamlets 017B","E01004323","E02000880","Tower Hamlets 017","E09000030","Tower Hamlets","E12000007","London",1466,1466,0,207.4,480,3.1,"00BG","Tower Hamlets",NA,5015,2557,10909,19181,5248,3595,9758,18272,233,1038,-1151,-909
"4315","Tower Hamlets 017C","E01004324","E02000880","Tower Hamlets 017","E09000030","Tower Hamlets","E12000007","London",1574,1570,4,206.8,485,3.2,"00BG","Tower Hamlets",NA,1526,322,5130,8172,1987,1744,6481,9212,461,1422,1351,1040
"4331","Tower Hamlets 021D","E01004325","E02000884","Tower Hamlets 021","E09000030","Tower Hamlets","E12000007","London",2487,2475,12,182.2,1033,2.4,"00BG","Tower Hamlets",NA,7439,7637,18014,17970,8626,12434,23406,23727,1187,4797,5392,5757
"4316","Tower Hamlets 017D","E01004326","E02000880","Tower Hamlets 017","E09000030","Tower Hamlets","E12000007","London",1444,1438,6,172.5,623,2.3,"00BG","Tower Hamlets",NA,4569,2831,9200,19854,5728,6672,13718,17928,1159,3841,4518,-1926
"4523","Waltham Forest 028A","E01004327","E02000922","Waltham Forest 028","E09000031","Waltham Forest","E12000007","London",1213,1213,0,103.7,465,2.6,"00BH","Waltham Forest",NA,6842,3737,9780,14837,5987,5666,8203,12844,-855,1929,-1577,-1993
"4524","Waltham Forest 028B","E01004328","E02000922","Waltham Forest 028","E09000031","Waltham Forest","E12000007","London",1840,1836,4,178.3,671,2.7,"00BH","Waltham Forest",NA,7653,7076,10624,17149,9552,11572,17775,13975,1899,4496,7151,-3174
"4525","Waltham Forest 028C","E01004329","E02000922","Waltham Forest 028","E09000031","Waltham Forest","E12000007","London",1931,1923,8,166.3,671,2.9,"00BH","Waltham Forest",NA,5875,3115,9316,19464,9150,10811,14787,12192,3275,7696,5471,-7272
"4526","Waltham Forest 028D","E01004330","E02000922","Waltham Forest 028","E09000031","Waltham Forest","E12000007","London",1834,1834,0,192.4,625,2.9,"00BH","Waltham Forest",NA,9806,8010,11875,15631,13068,15129,21925,18694,3262,7119,10050,3063
"4527","Waltham Forest 028E","E01004331","E02000922","Waltham Forest 028","E09000031","Waltham Forest","E12000007","London",1856,1841,15,174.8,675,2.7,"00BH","Waltham Forest",NA,6028,3029,10251,15627,8541,7087,14258,13258,2513,4058,4007,-2369
"4528","Waltham Forest 028F","E01004332","E02000922","Waltham Forest 028","E09000031","Waltham Forest","E12000007","London",1849,1824,25,160.6,633,2.9,"00BH","Waltham Forest",NA,5432,5436,10436,9664,6425,9392,12551,11733,993,3956,2115,2069
"4502","Waltham Forest 024A","E01004333","E02000918","Waltham Forest 024","E09000031","Waltham Forest","E12000007","London",1769,1769,0,177.3,611,2.9,"00BH","Waltham Forest",NA,5005,2954,7687,10737,7693,6622,9705,16130,2688,3668,2018,5393
"4503","Waltham Forest 024B","E01004334","E02000918","Waltham Forest 024","E09000031","Waltham Forest","E12000007","London",1507,1507,0,140.6,637,2.4,"00BH","Waltham Forest",NA,1635,789,2099,8204,2836,2095,4612,7311,1201,1306,2513,-893
"4517","Waltham Forest 027A","E01004335","E02000921","Waltham Forest 027","E09000031","Waltham Forest","E12000007","London",1843,1843,0,153.7,645,2.9,"00BH","Waltham Forest",NA,1397,591,3086,9775,2064,1579,2279,7804,667,988,-807,-1971
"4512","Waltham Forest 026A","E01004336","E02000920","Waltham Forest 026","E09000031","Waltham Forest","E12000007","London",1699,1691,8,78.5,564,3,"00BH","Waltham Forest",NA,6368,5826,13694,17710,7535,11827,14038,13491,1167,6001,344,-4219
"4518","Waltham Forest 027B","E01004337","E02000921","Waltham Forest 027","E09000031","Waltham Forest","E12000007","London",1966,1966,0,172.2,717,2.7,"00BH","Waltham Forest",NA,5166,2586,9676,11372,6953,6084,10750,11698,1787,3498,1074,326
"4519","Waltham Forest 027C","E01004338","E02000921","Waltham Forest 027","E09000031","Waltham Forest","E12000007","London",1772,1771,1,194.5,580,3.1,"00BH","Waltham Forest",NA,9180,8136,13100,21147,11043,14547,17166,17739,1863,6411,4066,-3408
"4520","Waltham Forest 027D","E01004339","E02000921","Waltham Forest 027","E09000031","Waltham Forest","E12000007","London",1814,1811,3,174.3,661,2.7,"00BH","Waltham Forest",NA,6971,7103,10553,12520,10024,12830,15863,18424,3053,5727,5310,5904
"4521","Waltham Forest 027E","E01004340","E02000921","Waltham Forest 027","E09000031","Waltham Forest","E12000007","London",1849,1831,18,71,698,2.6,"00BH","Waltham Forest",NA,1809,1406,2887,7324,2514,2228,3829,10449,705,822,942,3125
"4522","Waltham Forest 027F","E01004341","E02000921","Waltham Forest 027","E09000031","Waltham Forest","E12000007","London",1757,1757,0,116.8,665,2.6,"00BH","Waltham Forest",NA,2281,1352,4599,9480,4856,4949,7191,13840,2575,3597,2592,4360
"4435","Waltham Forest 011A","E01004342","E02000905","Waltham Forest 011","E09000031","Waltham Forest","E12000007","London",2143,2143,0,59.6,789,2.7,"00BH","Waltham Forest",NA,5605,5418,7456,12854,9117,10350,15372,15329,3512,4932,7916,2475
"4421","Waltham Forest 008A","E01004343","E02000902","Waltham Forest 008","E09000031","Waltham Forest","E12000007","London",1794,1794,0,65.6,647,2.8,"00BH","Waltham Forest",NA,15132,15570,18020,18483,15720,16480,18035,20606,588,910,15,2123
"4422","Waltham Forest 008B","E01004344","E02000902","Waltham Forest 008","E09000031","Waltham Forest","E12000007","London",1840,1838,2,48.1,667,2.8,"00BH","Waltham Forest",NA,6094,5843,11080,10192,7156,8635,11003,11948,1062,2792,-77,1756
"4431","Waltham Forest 010A","E01004345","E02000904","Waltham Forest 010","E09000031","Waltham Forest","E12000007","London",1925,1925,0,135.8,624,3.1,"00BH","Waltham Forest",NA,9096,9560,12410,13587,10165,9966,14944,11033,1069,406,2534,-2554
"4436","Waltham Forest 011B","E01004346","E02000905","Waltham Forest 011","E09000031","Waltham Forest","E12000007","London",1713,1713,0,92.5,557,3.1,"00BH","Waltham Forest",NA,9344,12568,17572,14137,13486,11638,16931,15562,4142,-930,-641,1425
"4437","Waltham Forest 011C","E01004347","E02000905","Waltham Forest 011","E09000031","Waltham Forest","E12000007","London",1983,1983,0,86.2,809,2.5,"00BH","Waltham Forest",NA,8694,14710,22091,17591,14693,13221,21831,20948,5999,-1489,-260,3357
"4432","Waltham Forest 010B","E01004348","E02000904","Waltham Forest 010","E09000031","Waltham Forest","E12000007","London",2688,2688,0,99.8,973,2.8,"00BH","Waltham Forest",NA,8962,5808,10461,16749,11569,11139,16600,17454,2607,5331,6139,705
"4385","Waltham Forest 001A","E01004349","E02000895","Waltham Forest 001","E09000031","Waltham Forest","E12000007","London",1439,1439,0,22.6,547,2.6,"00BH","Waltham Forest",NA,6151,5528,10829,9203,6154,5804,7533,11805,3,276,-3296,2602
"4386","Waltham Forest 001B","E01004350","E02000895","Waltham Forest 001","E09000031","Waltham Forest","E12000007","London",1753,1753,0,55.6,915,1.9,"00BH","Waltham Forest",NA,8093,9378,11892,16282,8094,8348,10512,15629,1,-1030,-1380,-653
"4387","Waltham Forest 001C","E01004351","E02000895","Waltham Forest 001","E09000031","Waltham Forest","E12000007","London",1601,1584,17,36.8,645,2.5,"00BH","Waltham Forest",NA,16072,18102,18994,17392,17384,17417,18233,20067,1312,-685,-761,2675
"4390","Waltham Forest 002A","E01004352","E02000896","Waltham Forest 002","E09000031","Waltham Forest","E12000007","London",1920,1842,78,13.1,813,2.3,"00BH","Waltham Forest",NA,20585,25115,26167,28296,20588,26121,26302,27787,3,1006,135,-509
"4391","Waltham Forest 002B","E01004353","E02000896","Waltham Forest 002","E09000031","Waltham Forest","E12000007","London",1806,1789,17,32,798,2.2,"00BH","Waltham Forest",NA,13417,15410,13378,19807,15958,17392,18175,21206,2541,1982,4797,1399
"4392","Waltham Forest 002C","E01004354","E02000896","Waltham Forest 002","E09000031","Waltham Forest","E12000007","London",1768,1768,0,57.9,749,2.4,"00BH","Waltham Forest",NA,13448,15239,15805,23598,15477,16728,19393,19754,2029,1489,3588,-3844
"4400","Waltham Forest 004A","E01004355","E02000898","Waltham Forest 004","E09000031","Waltham Forest","E12000007","London",1599,1599,0,65.3,673,2.4,"00BH","Waltham Forest",NA,9645,8118,13001,16053,9562,8150,11593,12691,-83,32,-1408,-3362
"4388","Waltham Forest 001D","E01004356","E02000895","Waltham Forest 001","E09000031","Waltham Forest","E12000007","London",1630,1630,0,34.5,590,2.8,"00BH","Waltham Forest",NA,9228,9910,13247,8787,8013,7475,9854,11326,-1215,-2435,-3393,2539
"4389","Waltham Forest 001E","E01004357","E02000895","Waltham Forest 001","E09000031","Waltham Forest","E12000007","London",1556,1556,0,46.8,574,2.7,"00BH","Waltham Forest",NA,10974,11514,15365,16527,13023,12046,14899,16886,2049,532,-466,359
"4393","Waltham Forest 002D","E01004358","E02000896","Waltham Forest 002","E09000031","Waltham Forest","E12000007","London",1647,1647,0,66.3,788,2.1,"00BH","Waltham Forest",NA,10635,11458,13032,19751,10786,10405,10747,21270,151,-1053,-2285,1519
"4394","Waltham Forest 002E","E01004359","E02000896","Waltham Forest 002","E09000031","Waltham Forest","E12000007","London",1673,1673,0,74.1,610,2.7,"00BH","Waltham Forest",NA,15098,15563,16082,22364,17867,15364,15194,21319,2769,-199,-888,-1045
"4401","Waltham Forest 004B","E01004360","E02000898","Waltham Forest 004","E09000031","Waltham Forest","E12000007","London",1331,1319,12,58.8,492,2.7,"00BH","Waltham Forest",NA,19501,19633,21873,22341,18048,23414,18541,15761,-1453,3781,-3332,-6580
"4405","Waltham Forest 005A","E01004361","E02000899","Waltham Forest 005","E09000031","Waltham Forest","E12000007","London",1294,1294,0,61.8,492,2.6,"00BH","Waltham Forest",NA,19370,20962,22835,17518,17087,19769,17823,15407,-2283,-1193,-5012,-2111
"4487","Waltham Forest 021A","E01004362","E02000915","Waltham Forest 021","E09000031","Waltham Forest","E12000007","London",1614,1589,25,20,676,2.4,"00BH","Waltham Forest",NA,8349,13013,11198,25669,9659,15060,15808,20338,1310,2047,4610,-5331
"4477","Waltham Forest 019A","E01004363","E02000913","Waltham Forest 019","E09000031","Waltham Forest","E12000007","London",1565,1563,2,53.1,506,3.1,"00BH","Waltham Forest",NA,12818,14083,15927,21093,14568,14283,15567,23172,1750,200,-360,2079
"4478","Waltham Forest 019B","E01004364","E02000913","Waltham Forest 019","E09000031","Waltham Forest","E12000007","London",1738,1738,0,86.4,563,3.1,"00BH","Waltham Forest",NA,4813,3870,5657,16318,5779,7545,8159,16245,966,3675,2502,-73
"4482","Waltham Forest 020A","E01004365","E02000914","Waltham Forest 020","E09000031","Waltham Forest","E12000007","London",2289,2289,0,192.2,700,3.3,"00BH","Waltham Forest",NA,5261,3570,9888,16441,5752,8527,16688,7535,491,4957,6800,-8906
"4479","Waltham Forest 019C","E01004366","E02000913","Waltham Forest 019","E09000031","Waltham Forest","E12000007","London",1891,1852,39,64,642,2.9,"00BH","Waltham Forest",NA,9462,11148,13285,19920,10535,14653,14320,18401,1073,3505,1035,-1519
"4480","Waltham Forest 019D","E01004367","E02000913","Waltham Forest 019","E09000031","Waltham Forest","E12000007","London",1637,1637,0,130.6,537,3,"00BH","Waltham Forest",NA,5865,7921,7774,15457,8729,12473,12801,11826,2864,4552,5027,-3631
"4481","Waltham Forest 019E","E01004368","E02000913","Waltham Forest 019","E09000031","Waltham Forest","E12000007","London",1875,1870,5,133.8,720,2.6,"00BH","Waltham Forest",NA,6796,7719,7793,16561,10867,14117,13935,20128,4071,6398,6142,3567
"4497","Waltham Forest 023A","E01004369","E02000917","Waltham Forest 023","E09000031","Waltham Forest","E12000007","London",1766,1766,0,180.4,615,2.9,"00BH","Waltham Forest",NA,6843,5065,12841,22045,11531,12741,21221,16333,4688,7676,8380,-5712
"4498","Waltham Forest 023B","E01004370","E02000917","Waltham Forest 023","E09000031","Waltham Forest","E12000007","London",1786,1786,0,128.7,636,2.8,"00BH","Waltham Forest",NA,8150,7591,14659,21416,13360,15675,20209,16690,5210,8084,5550,-4726
"4507","Waltham Forest 025A","E01004371","E02000919","Waltham Forest 025","E09000031","Waltham Forest","E12000007","London",1703,1693,10,156.4,615,2.8,"00BH","Waltham Forest",NA,10667,9136,15706,20941,12048,14816,15753,16651,1381,5680,47,-4290
"4499","Waltham Forest 023C","E01004372","E02000917","Waltham Forest 023","E09000031","Waltham Forest","E12000007","London",1831,1831,0,185.5,744,2.5,"00BH","Waltham Forest",NA,11219,13125,18150,18006,18073,21150,25526,20704,6854,8025,7376,2698
"4508","Waltham Forest 025B","E01004373","E02000919","Waltham Forest 025","E09000031","Waltham Forest","E12000007","London",1779,1779,0,180.2,621,2.9,"00BH","Waltham Forest",NA,6499,6143,9769,18462,7101,10476,13351,11518,602,4333,3582,-6944
"4509","Waltham Forest 025C","E01004374","E02000919","Waltham Forest 025","E09000031","Waltham Forest","E12000007","London",1890,1886,4,146.3,688,2.7,"00BH","Waltham Forest",NA,8373,7359,13046,18978,14828,15966,18904,23052,6455,8607,5858,4074
"4510","Waltham Forest 025D","E01004375","E02000919","Waltham Forest 025","E09000031","Waltham Forest","E12000007","London",1855,1848,7,158.8,647,2.9,"00BH","Waltham Forest",NA,6781,7566,12041,11773,10093,13308,18315,19849,3312,5742,6274,8076
"4511","Waltham Forest 025E","E01004376","E02000919","Waltham Forest 025","E09000031","Waltham Forest","E12000007","London",1994,1994,0,183.3,654,3,"00BH","Waltham Forest",NA,6101,6578,11833,19726,10607,14001,17073,20186,4506,7423,5240,460
"4433","Waltham Forest 010C","E01004377","E02000904","Waltham Forest 010","E09000031","Waltham Forest","E12000007","London",1782,1782,0,21.4,626,2.8,"00BH","Waltham Forest",NA,12888,14376,14623,19888,13505,15110,17035,20201,617,734,2412,313
"4434","Waltham Forest 010D","E01004378","E02000904","Waltham Forest 010","E09000031","Waltham Forest","E12000007","London",1833,1818,15,84.6,677,2.7,"00BH","Waltham Forest",NA,7992,8267,8070,16829,9342,10531,12195,16937,1350,2264,4125,108
"4415","Waltham Forest 007A","E01004379","E02000901","Waltham Forest 007","E09000031","Waltham Forest","E12000007","London",1430,1430,0,67.6,523,2.7,"00BH","Waltham Forest",NA,17628,20713,20731,24329,18587,20036,21711,24110,959,-677,980,-219
"4416","Waltham Forest 007B","E01004380","E02000901","Waltham Forest 007","E09000031","Waltham Forest","E12000007","London",1511,1511,0,29.7,607,2.5,"00BH","Waltham Forest",NA,10561,10495,12972,16635,10740,10936,13450,19086,179,441,478,2451
"4417","Waltham Forest 007C","E01004381","E02000901","Waltham Forest 007","E09000031","Waltham Forest","E12000007","London",1815,1815,0,77.6,674,2.7,"00BH","Waltham Forest",NA,11676,11553,17187,22350,16191,15517,19123,23516,4515,3964,1936,1166
"4423","Waltham Forest 008C","E01004382","E02000902","Waltham Forest 008","E09000031","Waltham Forest","E12000007","London",1350,1350,0,114.1,501,2.7,"00BH","Waltham Forest",NA,3552,1013,4660,6594,2888,2169,3580,7788,-664,1156,-1080,1194
"4418","Waltham Forest 007D","E01004383","E02000901","Waltham Forest 007","E09000031","Waltham Forest","E12000007","London",1634,1615,19,71.2,575,2.8,"00BH","Waltham Forest",NA,14953,11847,18375,19744,16104,14712,15228,20041,1151,2865,-3147,297
"4395","Waltham Forest 003A","E01004384","E02000897","Waltham Forest 003","E09000031","Waltham Forest","E12000007","London",1823,1737,86,66.9,695,2.5,"00BH","Waltham Forest",NA,5025,4219,6971,7107,5554,4988,5410,6671,529,769,-1561,-436
"4396","Waltham Forest 003B","E01004385","E02000897","Waltham Forest 003","E09000031","Waltham Forest","E12000007","London",1384,1384,0,28.5,650,2.1,"00BH","Waltham Forest",NA,5185,4499,5796,15505,6432,6752,5862,16787,1247,2253,66,1282
"4397","Waltham Forest 003C","E01004386","E02000897","Waltham Forest 003","E09000031","Waltham Forest","E12000007","London",1661,1661,0,44.2,642,2.6,"00BH","Waltham Forest",NA,22177,26321,22715,19198,24575,26522,24644,22446,2398,201,1929,3248
"4419","Waltham Forest 007E","E01004387","E02000901","Waltham Forest 007","E09000031","Waltham Forest","E12000007","London",1500,1500,0,56.6,525,2.9,"00BH","Waltham Forest",NA,22673,26115,23134,22956,26817,27616,27678,25771,4144,1501,4544,2815
"4420","Waltham Forest 007F","E01004388","E02000901","Waltham Forest 007","E09000031","Waltham Forest","E12000007","London",1481,1431,50,54.7,649,2.2,"00BH","Waltham Forest",NA,11587,11779,13965,24481,11289,11467,13187,21252,-298,-312,-778,-3229
"4398","Waltham Forest 003D","E01004389","E02000897","Waltham Forest 003","E09000031","Waltham Forest","E12000007","London",1613,1613,0,38,706,2.3,"00BH","Waltham Forest",NA,6491,5330,7450,9396,5575,5982,5679,10831,-916,652,-1771,1435
"4399","Waltham Forest 003E","E01004390","E02000897","Waltham Forest 003","E09000031","Waltham Forest","E12000007","London",1596,1596,0,49.3,652,2.4,"00BH","Waltham Forest",NA,6232,5728,6158,8327,5108,4595,5601,5000,-1124,-1133,-557,-3327
"4451","Waltham Forest 014A","E01004391","E02000908","Waltham Forest 014","E09000031","Waltham Forest","E12000007","London",1849,1849,0,24.9,846,2.2,"00BH","Waltham Forest",NA,5848,7489,13669,22241,9376,11615,15401,20471,3528,4126,1732,-1770
"4467","Waltham Forest 017A","E01004392","E02000911","Waltham Forest 017","E09000031","Waltham Forest","E12000007","London",2283,2283,0,107.2,879,2.6,"00BH","Waltham Forest",NA,5069,6070,8063,19842,6374,10028,12044,15510,1305,3958,3981,-4332
"4452","Waltham Forest 014B","E01004393","E02000908","Waltham Forest 014","E09000031","Waltham Forest","E12000007","London",2391,2391,0,169.6,1023,2.3,"00BH","Waltham Forest",NA,5819,4437,9940,18793,8971,7744,15602,22175,3152,3307,5662,3382
"4468","Waltham Forest 017B","E01004394","E02000911","Waltham Forest 017","E09000031","Waltham Forest","E12000007","London",1821,1820,1,152.3,744,2.4,"00BH","Waltham Forest",NA,3114,3327,5326,17633,4012,4541,5640,12281,898,1214,314,-5352
"4472","Waltham Forest 018A","E01004395","E02000912","Waltham Forest 018","E09000031","Waltham Forest","E12000007","London",1613,1613,0,10.8,565,2.9,"00BH","Waltham Forest",NA,11004,9242,15806,18164,11858,12401,17609,22677,854,3159,1803,4513
"4440","Waltham Forest 012A","E01004396","E02000906","Waltham Forest 012","E09000031","Waltham Forest","E12000007","London",1854,1854,0,166.6,647,2.9,"00BH","Waltham Forest",NA,8814,7069,10500,20714,12508,12523,17138,19801,3694,5454,6638,-913
"4469","Waltham Forest 017C","E01004397","E02000911","Waltham Forest 017","E09000031","Waltham Forest","E12000007","London",2316,2313,3,98.2,849,2.7,"00BH","Waltham Forest",NA,4666,6212,8413,21311,6692,8993,14799,25740,2026,2781,6386,4429
"4426","Waltham Forest 009A","E01004398","E02000903","Waltham Forest 009","E09000031","Waltham Forest","E12000007","London",1966,1966,0,45.7,679,2.9,"00BH","Waltham Forest",NA,2669,1790,4299,7164,4057,2775,4957,8913,1388,985,658,1749
"4427","Waltham Forest 009B","E01004399","E02000903","Waltham Forest 009","E09000031","Waltham Forest","E12000007","London",1733,1733,0,21.9,594,2.9,"00BH","Waltham Forest",NA,2274,984,4415,5366,1550,913,3105,5936,-724,-71,-1310,570
"4428","Waltham Forest 009C","E01004400","E02000903","Waltham Forest 009","E09000031","Waltham Forest","E12000007","London",1723,1723,0,99.8,641,2.7,"00BH","Waltham Forest",NA,6542,6812,9109,12118,6188,5560,7969,14047,-354,-1252,-1140,1929
"4453","Waltham Forest 014C","E01004401","E02000908","Waltham Forest 014","E09000031","Waltham Forest","E12000007","London",2102,2102,0,19.1,803,2.6,"00BH","Waltham Forest",NA,7542,8464,13207,13764,11226,11588,14272,13691,3684,3124,1065,-73
"4429","Waltham Forest 009D","E01004402","E02000903","Waltham Forest 009","E09000031","Waltham Forest","E12000007","London",1804,1804,0,95.2,663,2.7,"00BH","Waltham Forest",NA,4847,4398,5436,10369,5250,4239,6416,12029,403,-159,980,1660
"4430","Waltham Forest 009E","E01004403","E02000903","Waltham Forest 009","E09000031","Waltham Forest","E12000007","London",1817,1817,0,47.5,602,3,"00BH","Waltham Forest",NA,7271,6106,9971,12164,6388,6221,9581,9044,-883,115,-390,-3120
"4454","Waltham Forest 014D","E01004404","E02000908","Waltham Forest 014","E09000031","Waltham Forest","E12000007","London",2049,2049,0,132.6,882,2.3,"00BH","Waltham Forest",NA,4540,3860,5262,13511,6227,5590,9066,13922,1687,1730,3804,411
"4483","Waltham Forest 020B","E01004405","E02000914","Waltham Forest 020","E09000031","Waltham Forest","E12000007","London",1652,1616,36,135.7,566,2.9,"00BH","Waltham Forest",NA,6746,5814,7512,18771,5474,7421,9490,15113,-1272,1607,1978,-3658
"4461","Waltham Forest 016A","E01004406","E02000910","Waltham Forest 016","E09000031","Waltham Forest","E12000007","London",1859,1837,22,136.9,731,2.5,"00BH","Waltham Forest",NA,6096,6563,10295,20221,8144,11150,14277,19329,2048,4587,3982,-892
"4445","Waltham Forest 013A","E01004407","E02000907","Waltham Forest 013","E09000031","Waltham Forest","E12000007","London",1633,1370,263,179.1,493,2.8,"00BH","Waltham Forest",NA,634,627,642,9302,1532,1922,805,7069,898,1295,163,-2233
"4462","Waltham Forest 016B","E01004408","E02000910","Waltham Forest 016","E09000031","Waltham Forest","E12000007","London",1749,1743,6,148.7,676,2.6,"00BH","Waltham Forest",NA,8059,8400,11880,22382,8692,9922,10233,22760,633,1522,-1647,378
"4463","Waltham Forest 016C","E01004409","E02000910","Waltham Forest 016","E09000031","Waltham Forest","E12000007","London",1661,1638,23,106.2,711,2.3,"00BH","Waltham Forest",NA,6956,4845,9409,23148,6019,8431,9808,23282,-937,3586,399,134
"4446","Waltham Forest 013B","E01004410","E02000907","Waltham Forest 013","E09000031","Waltham Forest","E12000007","London",1898,1843,55,95.7,852,2.2,"00BH","Waltham Forest",NA,4449,3070,7726,18198,3414,3830,4863,13224,-1035,760,-2863,-4974
"4464","Waltham Forest 016D","E01004411","E02000910","Waltham Forest 016","E09000031","Waltham Forest","E12000007","London",1721,1721,0,138.8,648,2.7,"00BH","Waltham Forest",NA,7356,5930,10580,21812,8065,12557,15325,19352,709,6627,4745,-2460
"4456","Waltham Forest 015A","E01004412","E02000909","Waltham Forest 015","E09000031","Waltham Forest","E12000007","London",1739,1738,1,114.3,740,2.3,"00BH","Waltham Forest",NA,7718,7424,13271,20856,9945,12608,14325,24982,2227,5184,1054,4126
"4402","Waltham Forest 004C","E01004413","E02000898","Waltham Forest 004","E09000031","Waltham Forest","E12000007","London",1564,1529,35,47.6,685,2.2,"00BH","Waltham Forest",NA,7290,4731,7941,9115,5175,5350,6053,6494,-2115,619,-1888,-2621
"4406","Waltham Forest 005B","E01004414","E02000899","Waltham Forest 005","E09000031","Waltham Forest","E12000007","London",1607,1601,6,55.4,615,2.6,"00BH","Waltham Forest",NA,11952,15497,15445,16464,11583,11218,14045,13732,-369,-4279,-1400,-2732
"4403","Waltham Forest 004D","E01004415","E02000898","Waltham Forest 004","E09000031","Waltham Forest","E12000007","London",1559,1535,24,59.9,583,2.6,"00BH","Waltham Forest",NA,8370,8080,8169,10372,8308,6556,9060,10344,-62,-1524,891,-28
"4404","Waltham Forest 004E","E01004416","E02000898","Waltham Forest 004","E09000031","Waltham Forest","E12000007","London",1697,1695,2,36,632,2.7,"00BH","Waltham Forest",NA,11051,10505,11452,16093,11268,12764,10830,13421,217,2259,-622,-2672
"4407","Waltham Forest 005C","E01004417","E02000899","Waltham Forest 005","E09000031","Waltham Forest","E12000007","London",1663,1615,48,60.2,650,2.5,"00BH","Waltham Forest",NA,11159,10732,13398,17960,9954,9018,12523,15269,-1205,-1714,-875,-2691
"4424","Waltham Forest 008D","E01004418","E02000902","Waltham Forest 008","E09000031","Waltham Forest","E12000007","London",1653,1653,0,91.2,649,2.5,"00BH","Waltham Forest",NA,9696,9030,14462,13357,12685,10835,16895,15704,2989,1805,2433,2347
"4425","Waltham Forest 008E","E01004419","E02000902","Waltham Forest 008","E09000031","Waltham Forest","E12000007","London",1594,1594,0,61.2,637,2.5,"00BH","Waltham Forest",NA,12610,15573,15212,17140,11503,13780,15515,16552,-1107,-1793,303,-588
"4484","Waltham Forest 020C","E01004420","E02000914","Waltham Forest 020","E09000031","Waltham Forest","E12000007","London",2134,2132,2,125.9,790,2.7,"00BH","Waltham Forest",NA,3564,3917,7596,10012,3182,6431,5262,11682,-382,2514,-2334,1670
"4473","Waltham Forest 018B","E01004421","E02000912","Waltham Forest 018","E09000031","Waltham Forest","E12000007","London",2149,2086,63,170.4,604,3.5,"00BH","Waltham Forest",NA,8703,6292,14868,13848,9222,8962,12372,13846,519,2670,-2496,-2
"4492","Waltham Forest 022A","E01004422","E02000916","Waltham Forest 022","E09000031","Waltham Forest","E12000007","London",1662,1662,0,12.4,589,2.8,"00BH","Waltham Forest",NA,6580,5974,12312,14160,7161,9077,11624,8181,581,3103,-688,-5979
"4485","Waltham Forest 020D","E01004423","E02000914","Waltham Forest 020","E09000031","Waltham Forest","E12000007","London",1903,1848,55,149.5,697,2.7,"00BH","Waltham Forest",NA,2488,2917,4073,13903,3696,6109,8658,8851,1208,3192,4585,-5052
"4493","Waltham Forest 022B","E01004424","E02000916","Waltham Forest 022","E09000031","Waltham Forest","E12000007","London",1833,1830,3,84.9,627,2.9,"00BH","Waltham Forest",NA,4018,2945,4820,11767,3664,4232,5858,10442,-354,1287,1038,-1325
"4494","Waltham Forest 022C","E01004425","E02000916","Waltham Forest 022","E09000031","Waltham Forest","E12000007","London",2090,2090,0,156.9,848,2.5,"00BH","Waltham Forest",NA,6984,6590,13290,11740,7718,6849,13687,11339,734,259,397,-401
"4495","Waltham Forest 022D","E01004426","E02000916","Waltham Forest 022","E09000031","Waltham Forest","E12000007","London",1787,1787,0,144.3,590,3,"00BH","Waltham Forest",NA,8317,8542,11028,14174,8431,9834,10376,10856,114,1292,-652,-3318
"4496","Waltham Forest 022E","E01004427","E02000916","Waltham Forest 022","E09000031","Waltham Forest","E12000007","London",2113,2113,0,51.3,852,2.5,"00BH","Waltham Forest",NA,5960,6996,13513,9205,7637,10790,16469,12457,1677,3794,2956,3252
"4513","Waltham Forest 026B","E01004428","E02000920","Waltham Forest 026","E09000031","Waltham Forest","E12000007","London",1763,1763,0,109.6,653,2.7,"00BH","Waltham Forest",NA,2368,949,3121,6581,2412,1160,2743,8952,44,211,-378,2371
"4514","Waltham Forest 026C","E01004429","E02000920","Waltham Forest 026","E09000031","Waltham Forest","E12000007","London",1772,1772,0,33.3,653,2.7,"00BH","Waltham Forest",NA,4484,3549,8383,15425,7840,7495,9553,13105,3356,3946,1170,-2320
"4515","Waltham Forest 026D","E01004430","E02000920","Waltham Forest 026","E09000031","Waltham Forest","E12000007","London",2200,2200,0,42.6,827,2.7,"00BH","Waltham Forest",NA,5569,8257,12580,12332,7118,11790,15047,19569,1549,3533,2467,7237
"4500","Waltham Forest 023D","E01004432","E02000917","Waltham Forest 023","E09000031","Waltham Forest","E12000007","London",1755,1755,0,93.7,652,2.7,"00BH","Waltham Forest",NA,7247,9489,12264,17614,8690,9238,12513,16031,1443,-251,249,-1583
"4516","Waltham Forest 026E","E01004434","E02000920","Waltham Forest 026","E09000031","Waltham Forest","E12000007","London",2045,2045,0,63.5,737,2.8,"00BH","Waltham Forest",NA,6324,5359,7304,14886,6363,7060,8121,9064,39,1701,817,-5822
"4501","Waltham Forest 023E","E01004435","E02000917","Waltham Forest 023","E09000031","Waltham Forest","E12000007","London",2033,2010,23,130.2,749,2.7,"00BH","Waltham Forest",NA,4941,4892,7597,15814,4410,7696,8534,6956,-531,2804,937,-8858
"4488","Waltham Forest 021B","E01004436","E02000915","Waltham Forest 021","E09000031","Waltham Forest","E12000007","London",1712,1608,104,73.8,580,2.8,"00BH","Waltham Forest",NA,3645,6285,6734,22312,6355,11207,13884,20864,2710,4922,7150,-1448
"4489","Waltham Forest 021C","E01004437","E02000915","Waltham Forest 021","E09000031","Waltham Forest","E12000007","London",1885,1812,73,124.4,762,2.4,"00BH","Waltham Forest",NA,5422,6975,7577,20995,7500,9614,11439,20509,2078,2639,3862,-486
"4504","Waltham Forest 024C","E01004438","E02000918","Waltham Forest 024","E09000031","Waltham Forest","E12000007","London",2065,2025,40,79.9,772,2.6,"00BH","Waltham Forest",NA,7014,7634,9050,18824,11300,17057,19603,23524,4286,9423,10553,4700
"4490","Waltham Forest 021D","E01004439","E02000915","Waltham Forest 021","E09000031","Waltham Forest","E12000007","London",1678,1636,42,112.2,619,2.6,"00BH","Waltham Forest",NA,7433,5700,12464,22242,11468,10072,16310,19683,4035,4372,3846,-2559
"4505","Waltham Forest 024D","E01004440","E02000918","Waltham Forest 024","E09000031","Waltham Forest","E12000007","London",2164,2132,32,91.5,794,2.7,"00BH","Waltham Forest",NA,6443,8758,9972,19607,8422,12035,13523,21941,1979,3277,3551,2334
"4506","Waltham Forest 024E","E01004441","E02000918","Waltham Forest 024","E09000031","Waltham Forest","E12000007","London",1621,1608,13,123.8,635,2.5,"00BH","Waltham Forest",NA,11788,11373,14171,25300,14786,15475,22189,26830,2998,4102,8018,1530
"4491","Waltham Forest 021E","E01004442","E02000915","Waltham Forest 021","E09000031","Waltham Forest","E12000007","London",1754,1754,0,115.9,668,2.6,"00BH","Waltham Forest",NA,9944,11351,12465,24759,15378,18119,19068,24237,5434,6768,6603,-522
"4465","Waltham Forest 016E","E01004443","E02000910","Waltham Forest 016","E09000031","Waltham Forest","E12000007","London",1833,1833,0,142.6,586,3.1,"00BH","Waltham Forest",NA,6269,5392,8752,14650,6704,8025,11879,16176,435,2633,3127,1526
"4470","Waltham Forest 017D","E01004444","E02000911","Waltham Forest 017","E09000031","Waltham Forest","E12000007","London",2537,2537,0,127.9,966,2.6,"00BH","Waltham Forest",NA,2938,1965,6367,9666,3651,5037,9329,10150,713,3072,2962,484
"4474","Waltham Forest 018C","E01004445","E02000912","Waltham Forest 018","E09000031","Waltham Forest","E12000007","London",1741,1737,4,102.4,624,2.8,"00BH","Waltham Forest",NA,7469,6730,11076,15264,6944,8178,11939,17284,-525,1448,863,2020
"4471","Waltham Forest 017E","E01004446","E02000911","Waltham Forest 017","E09000031","Waltham Forest","E12000007","London",1915,1915,0,154.6,677,2.8,"00BH","Waltham Forest",NA,6233,4820,8269,14247,9144,10331,12909,15205,2911,5511,4640,958
"4466","Waltham Forest 016F","E01004447","E02000910","Waltham Forest 016","E09000031","Waltham Forest","E12000007","London",1875,1875,0,146,653,2.9,"00BH","Waltham Forest",NA,11294,9448,13859,23961,12790,14143,16974,19457,1496,4695,3115,-4504
"4475","Waltham Forest 018D","E01004448","E02000912","Waltham Forest 018","E09000031","Waltham Forest","E12000007","London",1897,1897,0,36.3,759,2.5,"00BH","Waltham Forest",NA,5768,5406,8137,13008,7296,9663,11322,14460,1528,4257,3185,1452
"4476","Waltham Forest 018E","E01004449","E02000912","Waltham Forest 018","E09000031","Waltham Forest","E12000007","London",1838,1810,28,100.7,599,3,"00BH","Waltham Forest",NA,1462,345,1943,7472,1908,1611,2276,6448,446,1266,333,-1024
"4410","Waltham Forest 006A","E01004450","E02000900","Waltham Forest 006","E09000031","Waltham Forest","E12000007","London",1655,1655,0,55.7,605,2.7,"00BH","Waltham Forest",NA,15089,19255,17089,16305,14739,18445,19272,15965,-350,-810,2183,-340
"4408","Waltham Forest 005D","E01004451","E02000899","Waltham Forest 005","E09000031","Waltham Forest","E12000007","London",1726,1726,0,87.5,641,2.7,"00BH","Waltham Forest",NA,13738,15953,20207,16206,14194,13435,16266,13139,456,-2518,-3941,-3067
"4409","Waltham Forest 005E","E01004452","E02000899","Waltham Forest 005","E09000031","Waltham Forest","E12000007","London",1630,1630,0,70.8,692,2.4,"00BH","Waltham Forest",NA,9693,10973,12607,10493,8617,9214,10813,11886,-1076,-1759,-1794,1393
"4411","Waltham Forest 006B","E01004453","E02000900","Waltham Forest 006","E09000031","Waltham Forest","E12000007","London",1625,1625,0,47.6,658,2.5,"00BH","Waltham Forest",NA,10427,10667,13122,15069,7604,8782,12903,14471,-2823,-1885,-219,-598
"4412","Waltham Forest 006C","E01004454","E02000900","Waltham Forest 006","E09000031","Waltham Forest","E12000007","London",1714,1714,0,90.7,640,2.7,"00BH","Waltham Forest",NA,9843,8992,12127,12318,9466,8775,14290,12686,-377,-217,2163,368
"4413","Waltham Forest 006D","E01004455","E02000900","Waltham Forest 006","E09000031","Waltham Forest","E12000007","London",1537,1511,26,32.1,544,2.8,"00BH","Waltham Forest",NA,5638,5476,7318,11607,6395,6174,8516,10988,757,698,1198,-619
"4414","Waltham Forest 006E","E01004456","E02000900","Waltham Forest 006","E09000031","Waltham Forest","E12000007","London",1557,1557,0,63.1,539,2.9,"00BH","Waltham Forest",NA,2120,702,2403,4192,3080,1382,1951,8838,960,680,-452,4646
"4441","Waltham Forest 012B","E01004457","E02000906","Waltham Forest 012","E09000031","Waltham Forest","E12000007","London",1894,1892,2,154.7,738,2.6,"00BH","Waltham Forest",NA,8620,7141,11250,17369,10245,10219,11992,21812,1625,3078,742,4443
"4442","Waltham Forest 012C","E01004458","E02000906","Waltham Forest 012","E09000031","Waltham Forest","E12000007","London",1862,1862,0,143.5,681,2.7,"00BH","Waltham Forest",NA,8009,7611,9652,17155,8009,6732,11793,13724,0,-879,2141,-3431
"4443","Waltham Forest 012D","E01004459","E02000906","Waltham Forest 012","E09000031","Waltham Forest","E12000007","London",1635,1635,0,147.3,535,3.1,"00BH","Waltham Forest",NA,3345,945,4899,6541,1552,417,2061,4540,-1793,-528,-2838,-2001
"4438","Waltham Forest 011D","E01004460","E02000905","Waltham Forest 011","E09000031","Waltham Forest","E12000007","London",1955,1885,70,139.3,671,2.8,"00BH","Waltham Forest",NA,4323,3594,7952,16942,6548,6667,10164,10592,2225,3073,2212,-6350
"4455","Waltham Forest 014E","E01004461","E02000908","Waltham Forest 014","E09000031","Waltham Forest","E12000007","London",2125,2125,0,98,794,2.7,"00BH","Waltham Forest",NA,10697,10740,12326,20272,15408,15320,21464,18123,4711,4580,9138,-2149
"4439","Waltham Forest 011E","E01004462","E02000905","Waltham Forest 011","E09000031","Waltham Forest","E12000007","London",1795,1788,7,133.5,639,2.8,"00BH","Waltham Forest",NA,6396,4412,8240,20835,9981,9635,14410,18729,3585,5223,6170,-2106
"4444","Waltham Forest 012E","E01004463","E02000906","Waltham Forest 012","E09000031","Waltham Forest","E12000007","London",2003,2003,0,139.5,906,2.2,"00BH","Waltham Forest",NA,10826,11001,15552,15800,13231,10834,18993,16602,2405,-167,3441,802
"4447","Waltham Forest 013C","E01004464","E02000907","Waltham Forest 013","E09000031","Waltham Forest","E12000007","London",1579,1579,0,138.1,643,2.5,"00BH","Waltham Forest",NA,2296,1002,3393,11455,3132,3146,4963,10439,836,2144,1570,-1016
"4457","Waltham Forest 015B","E01004465","E02000909","Waltham Forest 015","E09000031","Waltham Forest","E12000007","London",1502,1502,0,130.6,543,2.8,"00BH","Waltham Forest",NA,9872,8378,12801,22943,12050,12886,14681,25184,2178,4508,1880,2241
"4458","Waltham Forest 015C","E01004466","E02000909","Waltham Forest 015","E09000031","Waltham Forest","E12000007","London",1623,1619,4,109.9,638,2.5,"00BH","Waltham Forest",NA,12314,10803,12990,27359,14598,14385,19070,26591,2284,3582,6080,-768
"4459","Waltham Forest 015D","E01004467","E02000909","Waltham Forest 015","E09000031","Waltham Forest","E12000007","London",2155,2155,0,109.4,881,2.4,"00BH","Waltham Forest",NA,2764,2351,5547,14763,4627,5775,8865,12999,1863,3424,3318,-1764
"4460","Waltham Forest 015E","E01004468","E02000909","Waltham Forest 015","E09000031","Waltham Forest","E12000007","London",1621,1621,0,20.8,657,2.5,"00BH","Waltham Forest",NA,10349,18293,16269,23389,11707,17083,20011,23274,1358,-1210,3742,-115
"4448","Waltham Forest 013D","E01004469","E02000907","Waltham Forest 013","E09000031","Waltham Forest","E12000007","London",1640,1640,0,78.1,627,2.6,"00BH","Waltham Forest",NA,1671,1023,3179,14240,2456,2471,3266,9109,785,1448,87,-5131
"4449","Waltham Forest 013E","E01004470","E02000907","Waltham Forest 013","E09000031","Waltham Forest","E12000007","London",1524,1505,19,105.5,602,2.5,"00BH","Waltham Forest",NA,4912,3964,6846,20865,4883,5302,6901,12664,-29,1338,55,-8201
"4450","Waltham Forest 013F","E01004471","E02000907","Waltham Forest 013","E09000031","Waltham Forest","E12000007","London",1724,1697,27,127.5,668,2.5,"00BH","Waltham Forest",NA,4399,3723,5925,14227,5457,4960,8165,15036,1058,1237,2240,809
"4629","Wandsworth 021A","E01004472","E02000943","Wandsworth 021","E09000032","Wandsworth","E12000007","London",1746,1746,0,133.3,742,2.4,"00BJ","Wandsworth",NA,18232,18051,21958,28445,24288,24113,28514,30445,6056,6062,6556,2000
"4652","Wandsworth 026A","E01004473","E02000948","Wandsworth 026","E09000032","Wandsworth","E12000007","London",1698,1688,10,156.1,746,2.3,"00BJ","Wandsworth",NA,13333,13996,13987,30127,20099,20005,21963,32105,6766,6009,7976,1978
"4630","Wandsworth 021B","E01004474","E02000943","Wandsworth 021","E09000032","Wandsworth","E12000007","London",1866,1856,10,126.3,918,2,"00BJ","Wandsworth",NA,10579,12144,13294,21782,17026,17007,22621,24741,6447,4863,9327,2959
"4653","Wandsworth 026B","E01004475","E02000948","Wandsworth 026","E09000032","Wandsworth","E12000007","London",1406,1400,6,134,622,2.3,"00BJ","Wandsworth",NA,11329,11895,15917,25231,16175,16770,21014,28103,4846,4875,5097,2872
"4631","Wandsworth 021C","E01004476","E02000943","Wandsworth 021","E09000032","Wandsworth","E12000007","London",1636,1636,0,85.1,824,2,"00BJ","Wandsworth",NA,14330,16482,21337,21518,18201,17612,22038,28617,3871,1130,701,7099
"4608","Wandsworth 017A","E01004477","E02000939","Wandsworth 017","E09000032","Wandsworth","E12000007","London",1672,1668,4,81.4,607,2.7,"00BJ","Wandsworth",NA,28546,29109,31974,32312,29588,31322,32706,32841,1042,2213,732,529
"4609","Wandsworth 017B","E01004478","E02000939","Wandsworth 017","E09000032","Wandsworth","E12000007","London",1526,1526,0,161.7,538,2.8,"00BJ","Wandsworth",NA,27878,28616,30544,30607,30809,31813,32381,32792,2931,3197,1837,2185
"4610","Wandsworth 017C","E01004479","E02000939","Wandsworth 017","E09000032","Wandsworth","E12000007","London",1548,1540,8,107.3,613,2.5,"00BJ","Wandsworth",NA,22335,22410,19774,31934,25696,28096,29351,31804,3361,5686,9577,-130
"4654","Wandsworth 026C","E01004480","E02000948","Wandsworth 026","E09000032","Wandsworth","E12000007","London",1653,1653,0,209.5,678,2.4,"00BJ","Wandsworth",NA,21143,23037,27871,29516,26199,26575,32020,31825,5056,3538,4149,2309
"4669","Wandsworth 029A","E01004481","E02000951","Wandsworth 029","E09000032","Wandsworth","E12000007","London",1687,1671,16,164.3,716,2.3,"00BJ","Wandsworth",NA,13597,15438,17507,17279,16790,16986,22846,31747,3193,1548,5339,14468
"4673","Wandsworth 030A","E01004482","E02000952","Wandsworth 030","E09000032","Wandsworth","E12000007","London",1588,1588,0,134,626,2.5,"00BJ","Wandsworth",NA,14233,14020,17028,22660,14990,15221,17752,26538,757,1201,724,3878
"4655","Wandsworth 026D","E01004483","E02000948","Wandsworth 026","E09000032","Wandsworth","E12000007","London",2119,2099,20,46.7,1011,2.1,"00BJ","Wandsworth",NA,20099,18115,30795,28530,15435,16865,28589,29129,-4664,-1250,-2206,599
"4656","Wandsworth 026E","E01004484","E02000948","Wandsworth 026","E09000032","Wandsworth","E12000007","London",1523,1513,10,49,652,2.3,"00BJ","Wandsworth",NA,12063,10957,13826,18648,13086,14965,26044,19838,1023,4008,12218,1190
"4674","Wandsworth 030B","E01004485","E02000952","Wandsworth 030","E09000032","Wandsworth","E12000007","London",1668,1668,0,108.8,691,2.4,"00BJ","Wandsworth",NA,15059,15501,17996,28565,17001,15969,24898,23637,1942,468,6902,-4928
"4657","Wandsworth 026F","E01004486","E02000948","Wandsworth 026","E09000032","Wandsworth","E12000007","London",1478,1465,13,54.8,784,1.9,"00BJ","Wandsworth",NA,13099,12701,15652,23078,15055,15601,22632,27968,1956,2900,6980,4890
"4675","Wandsworth 030C","E01004487","E02000952","Wandsworth 030","E09000032","Wandsworth","E12000007","London",1560,1519,41,147.7,715,2.1,"00BJ","Wandsworth",NA,9709,11965,10013,25376,10748,12952,11823,31441,1039,987,1810,6065
"4670","Wandsworth 029B","E01004488","E02000951","Wandsworth 029","E09000032","Wandsworth","E12000007","London",1511,1486,25,140.6,625,2.4,"00BJ","Wandsworth",NA,14152,14982,12036,31105,14659,14699,17794,31405,507,-283,5758,300
"4676","Wandsworth 030D","E01004489","E02000952","Wandsworth 030","E09000032","Wandsworth","E12000007","London",1441,1430,11,79.5,612,2.3,"00BJ","Wandsworth",NA,11103,14511,17371,28787,8931,16508,13943,27653,-2172,1997,-3428,-1134
"4677","Wandsworth 031A","E01004490","E02000953","Wandsworth 031","E09000032","Wandsworth","E12000007","London",1510,1510,0,119,614,2.5,"00BJ","Wandsworth",NA,20939,23118,27285,30696,27558,29905,32044,32577,6619,6787,4759,1881
"4678","Wandsworth 031B","E01004491","E02000953","Wandsworth 031","E09000032","Wandsworth","E12000007","London",2150,1824,326,124.9,971,1.9,"00BJ","Wandsworth",NA,13856,13079,20661,20647,17952,18481,26463,21228,4096,5402,5802,581
"4679","Wandsworth 031C","E01004492","E02000953","Wandsworth 031","E09000032","Wandsworth","E12000007","London",1719,1719,0,62.2,744,2.3,"00BJ","Wandsworth",NA,11644,12752,13590,21322,16040,12909,17096,27616,4396,157,3506,6294
"4617","Wandsworth 019A","E01004493","E02000941","Wandsworth 019","E09000032","Wandsworth","E12000007","London",1761,1734,27,126.2,803,2.2,"00BJ","Wandsworth",NA,18067,15862,24625,20280,16771,13215,18892,29470,-1296,-2647,-5733,9190
"4613","Wandsworth 018A","E01004494","E02000940","Wandsworth 018","E09000032","Wandsworth","E12000007","London",1666,1645,21,137.8,762,2.2,"00BJ","Wandsworth",NA,9503,10869,13223,20993,13727,10977,14314,20819,4224,108,1091,-174
"4642","Wandsworth 024A","E01004495","E02000946","Wandsworth 024","E09000032","Wandsworth","E12000007","London",1536,1536,0,130.4,523,2.9,"00BJ","Wandsworth",NA,7850,2458,11336,14510,10979,5684,13314,16350,3129,3226,1978,1840
"4643","Wandsworth 024B","E01004496","E02000946","Wandsworth 024","E09000032","Wandsworth","E12000007","London",1956,1956,0,110.6,951,2.1,"00BJ","Wandsworth",NA,16230,17221,22721,20417,19719,21838,25777,27348,3489,4617,3056,6931
"4644","Wandsworth 024C","E01004497","E02000946","Wandsworth 024","E09000032","Wandsworth","E12000007","London",1445,1445,0,86.5,541,2.7,"00BJ","Wandsworth",NA,14223,11603,16815,17232,17577,14658,16254,28912,3354,3055,-561,11680
"4680","Wandsworth 031D","E01004498","E02000953","Wandsworth 031","E09000032","Wandsworth","E12000007","London",1705,1705,0,150.8,784,2.2,"00BJ","Wandsworth",NA,21486,22513,28127,21871,24700,21916,29237,28404,3214,-597,1110,6533
"4623","Wandsworth 020A","E01004499","E02000942","Wandsworth 020","E09000032","Wandsworth","E12000007","London",1591,1591,0,113.7,713,2.2,"00BJ","Wandsworth",NA,17276,16581,25241,31243,20171,18222,27160,23604,2895,1641,1919,-7639
"4593","Wandsworth 014A","E01004500","E02000936","Wandsworth 014","E09000032","Wandsworth","E12000007","London",1622,1591,31,102.4,807,2,"00BJ","Wandsworth",NA,15456,17120,24841,18500,19882,20657,28771,23313,4426,3537,3930,4813
"4594","Wandsworth 014B","E01004501","E02000936","Wandsworth 014","E09000032","Wandsworth","E12000007","London",1582,1582,0,96,712,2.2,"00BJ","Wandsworth",NA,13722,12170,17448,23049,16426,13653,17809,22343,2704,1483,361,-706
"4624","Wandsworth 020B","E01004502","E02000942","Wandsworth 020","E09000032","Wandsworth","E12000007","London",1655,1655,0,116.4,670,2.5,"00BJ","Wandsworth",NA,20390,23933,27603,30197,25849,27452,30244,32387,5459,3519,2641,2190
"4595","Wandsworth 014C","E01004503","E02000936","Wandsworth 014","E09000032","Wandsworth","E12000007","London",1672,1625,47,84.4,738,2.2,"00BJ","Wandsworth",NA,13840,16008,17545,29604,14128,15940,21641,21102,288,-68,4096,-8502
"4625","Wandsworth 020C","E01004504","E02000942","Wandsworth 020","E09000032","Wandsworth","E12000007","London",1523,1523,0,68.1,566,2.7,"00BJ","Wandsworth",NA,24410,18787,27576,31866,26513,24888,28778,32234,2103,6101,1202,368
"4596","Wandsworth 014D","E01004505","E02000936","Wandsworth 014","E09000032","Wandsworth","E12000007","London",1616,1616,0,81.1,838,1.9,"00BJ","Wandsworth",NA,20174,28158,31436,24653,21208,26544,31821,30683,1034,-1614,385,6030
"4579","Wandsworth 011A","E01004506","E02000933","Wandsworth 011","E09000032","Wandsworth","E12000007","London",1923,1922,1,95.2,955,2,"00BJ","Wandsworth",NA,21924,26058,27440,26813,23540,25862,29192,30193,1616,-196,1752,3380
"4597","Wandsworth 014E","E01004507","E02000936","Wandsworth 014","E09000032","Wandsworth","E12000007","London",1838,1838,0,101.5,962,1.9,"00BJ","Wandsworth",NA,20424,18118,26197,22474,24422,25679,30565,26436,3998,7561,4368,3962
"4584","Wandsworth 012A","E01004508","E02000934","Wandsworth 012","E09000032","Wandsworth","E12000007","London",2019,2019,0,146.8,986,2,"00BJ","Wandsworth",NA,14481,15815,21769,26923,21578,21956,27750,30815,7097,6141,5981,3892
"4573","Wandsworth 010A","E01004509","E02000932","Wandsworth 010","E09000032","Wandsworth","E12000007","London",2190,2190,0,56.8,1122,2,"00BJ","Wandsworth",NA,17555,19927,25276,23206,16543,19256,25248,23270,-1012,-671,-28,64
"4585","Wandsworth 012B","E01004510","E02000934","Wandsworth 012","E09000032","Wandsworth","E12000007","London",1945,1934,11,117.2,917,2.1,"00BJ","Wandsworth",NA,16250,16058,18289,19521,22533,23137,28829,27079,6283,7079,10540,7558
"4574","Wandsworth 010B","E01004511","E02000932","Wandsworth 010","E09000032","Wandsworth","E12000007","London",1722,1722,0,106.3,712,2.4,"00BJ","Wandsworth",NA,23912,27437,29821,30237,25343,30230,31798,31294,1431,2793,1977,1057
"4618","Wandsworth 019B","E01004512","E02000941","Wandsworth 019","E09000032","Wandsworth","E12000007","London",1494,1483,11,129.8,618,2.4,"00BJ","Wandsworth",NA,21042,21659,21284,31007,20412,18666,20579,28498,-630,-2993,-705,-2509
"4614","Wandsworth 018B","E01004513","E02000940","Wandsworth 018","E09000032","Wandsworth","E12000007","London",1866,1866,0,122.4,833,2.2,"00BJ","Wandsworth",NA,12689,11103,18047,22340,16489,12423,22295,20783,3800,1320,4248,-1557
"4586","Wandsworth 012C","E01004514","E02000934","Wandsworth 012","E09000032","Wandsworth","E12000007","London",1685,1672,13,102.9,799,2.1,"00BJ","Wandsworth",NA,21038,19464,23287,26757,23011,23064,27704,19194,1973,3600,4417,-7563
"4587","Wandsworth 012D","E01004515","E02000934","Wandsworth 012","E09000032","Wandsworth","E12000007","London",1692,1651,41,161.5,739,2.2,"00BJ","Wandsworth",NA,11308,8920,10319,20609,14393,13966,16290,24349,3085,5046,5971,3740
"4699","Wandsworth 036A","E01004516","E02000958","Wandsworth 036","E09000032","Wandsworth","E12000007","London",1810,1608,202,84.6,510,3.2,"00BJ","Wandsworth",NA,19782,14829,23310,30637,22329,19951,24403,30071,2547,5122,1093,-566
"4704","Wandsworth 037A","E01004517","E02000959","Wandsworth 037","E09000032","Wandsworth","E12000007","London",1964,1943,21,129.6,810,2.4,"00BJ","Wandsworth",NA,9246,6635,11548,27350,13887,10466,16225,22245,4641,3831,4677,-5105
"4700","Wandsworth 036B","E01004518","E02000958","Wandsworth 036","E09000032","Wandsworth","E12000007","London",1746,1743,3,138.1,650,2.7,"00BJ","Wandsworth",NA,16210,11868,15671,30268,19040,14648,20385,30287,2830,2780,4714,19
"4701","Wandsworth 036C","E01004519","E02000958","Wandsworth 036","E09000032","Wandsworth","E12000007","London",1767,1767,0,130,632,2.8,"00BJ","Wandsworth",NA,11740,8383,12759,24551,13387,11068,14854,23216,1647,2685,2095,-1335
"4702","Wandsworth 036D","E01004520","E02000958","Wandsworth 036","E09000032","Wandsworth","E12000007","London",1366,1366,0,120,459,3,"00BJ","Wandsworth",NA,16304,11415,19506,25127,15706,11733,16553,22231,-598,318,-2953,-2896
"4705","Wandsworth 037B","E01004521","E02000959","Wandsworth 037","E09000032","Wandsworth","E12000007","London",1952,1946,6,160.7,768,2.5,"00BJ","Wandsworth",NA,11706,6400,14343,21899,13834,10570,15489,19018,2128,4170,1146,-2881
"4706","Wandsworth 037C","E01004522","E02000959","Wandsworth 037","E09000032","Wandsworth","E12000007","London",1646,1629,17,140.8,628,2.6,"00BJ","Wandsworth",NA,11748,9024,12586,17834,14560,11120,15547,21922,2812,2096,2961,4088
"4703","Wandsworth 036E","E01004523","E02000958","Wandsworth 036","E09000032","Wandsworth","E12000007","London",1582,1581,1,52.6,722,2.2,"00BJ","Wandsworth",NA,11832,10140,14434,30024,13448,11731,17558,29461,1616,1591,3124,-563
"4707","Wandsworth 037D","E01004524","E02000959","Wandsworth 037","E09000032","Wandsworth","E12000007","London",1671,1633,38,126.3,774,2.1,"00BJ","Wandsworth",NA,5470,4134,4743,14282,3885,2478,3821,10821,-1585,-1656,-922,-3461
"4693","Wandsworth 035A","E01004525","E02000957","Wandsworth 035","E09000032","Wandsworth","E12000007","London",1850,1848,2,132.7,659,2.8,"00BJ","Wandsworth",NA,10146,9307,20785,20588,10790,13745,20466,20339,644,4438,-319,-249
"4694","Wandsworth 035B","E01004526","E02000957","Wandsworth 035","E09000032","Wandsworth","E12000007","London",1599,1558,41,154.2,655,2.4,"00BJ","Wandsworth",NA,8900,9402,16195,20997,10193,10890,17863,20007,1293,1488,1668,-990
"4695","Wandsworth 035C","E01004527","E02000957","Wandsworth 035","E09000032","Wandsworth","E12000007","London",1648,1643,5,164.1,578,2.8,"00BJ","Wandsworth",NA,14958,12068,18423,23016,14857,16933,23532,25323,-101,4865,5109,2307
"4696","Wandsworth 035D","E01004528","E02000957","Wandsworth 035","E09000032","Wandsworth","E12000007","London",1520,1488,32,107.3,655,2.3,"00BJ","Wandsworth",NA,8105,7683,10515,17505,6933,5124,7920,21343,-1172,-2559,-2595,3838
"4697","Wandsworth 035E","E01004529","E02000957","Wandsworth 035","E09000032","Wandsworth","E12000007","London",2086,2079,7,170.4,902,2.3,"00BJ","Wandsworth",NA,13407,10967,20155,26582,17703,15151,23845,28529,4296,4184,3690,1947
"4698","Wandsworth 035F","E01004530","E02000957","Wandsworth 035","E09000032","Wandsworth","E12000007","London",1886,1880,6,138.6,789,2.4,"00BJ","Wandsworth",NA,13900,13929,12586,27283,18753,16930,19778,29729,4853,3001,7192,2446
"4685","Wandsworth 033A","E01004531","E02000955","Wandsworth 033","E09000032","Wandsworth","E12000007","London",1724,1724,0,199.3,649,2.7,"00BJ","Wandsworth",NA,9013,5560,12201,20907,10915,6182,12800,24651,1902,622,599,3744
"4681","Wandsworth 032A","E01004532","E02000954","Wandsworth 032","E09000032","Wandsworth","E12000007","London",1487,1487,0,165,644,2.3,"00BJ","Wandsworth",NA,14552,9773,13429,25756,16697,12151,17511,26446,2145,2378,4082,690
"4686","Wandsworth 033B","E01004533","E02000955","Wandsworth 033","E09000032","Wandsworth","E12000007","London",1398,1398,0,159.8,569,2.5,"00BJ","Wandsworth",NA,9832,4986,11054,19217,8704,6334,10341,15501,-1128,1348,-713,-3716
"4563","Wandsworth 008A","E01004534","E02000930","Wandsworth 008","E09000032","Wandsworth","E12000007","London",1850,1850,0,72.1,825,2.2,"00BJ","Wandsworth",NA,14428,17776,21117,25529,18089,23314,29319,29960,3661,5538,8202,4431
"4559","Wandsworth 007A","E01004535","E02000929","Wandsworth 007","E09000032","Wandsworth","E12000007","London",1758,1758,0,228.9,731,2.4,"00BJ","Wandsworth",NA,3651,1088,3091,12537,4070,1684,3647,16484,419,596,556,3947
"4564","Wandsworth 008B","E01004536","E02000930","Wandsworth 008","E09000032","Wandsworth","E12000007","London",2050,2029,21,135.9,928,2.2,"00BJ","Wandsworth",NA,6020,5952,9032,13213,9091,8526,15402,23080,3071,2574,6370,9867
"4560","Wandsworth 007B","E01004537","E02000929","Wandsworth 007","E09000032","Wandsworth","E12000007","London",1881,1881,0,159.7,799,2.4,"00BJ","Wandsworth",NA,4840,2900,4524,8214,5712,4941,8022,16440,872,2041,3498,8226
"4561","Wandsworth 007C","E01004538","E02000929","Wandsworth 007","E09000032","Wandsworth","E12000007","London",2001,2001,0,176,909,2.2,"00BJ","Wandsworth",NA,7566,3145,9648,13835,9892,6285,13279,16796,2326,3140,3631,2961
"4540","Wandsworth 003A","E01004539","E02000925","Wandsworth 003","E09000032","Wandsworth","E12000007","London",2098,2098,0,154.5,800,2.6,"00BJ","Wandsworth",NA,3655,1673,2938,12946,4653,2859,6430,15922,998,1186,3492,2976
"4541","Wandsworth 003B","E01004540","E02000925","Wandsworth 003","E09000032","Wandsworth","E12000007","London",2083,2083,0,150.3,1002,2.1,"00BJ","Wandsworth",NA,4993,5725,4875,19357,8456,7779,9102,25610,3463,2054,4227,6253
"4562","Wandsworth 007D","E01004541","E02000929","Wandsworth 007","E09000032","Wandsworth","E12000007","London",1637,1637,0,172.9,762,2.1,"00BJ","Wandsworth",NA,4534,3497,3770,13255,3115,2465,3126,17633,-1419,-1032,-644,4378
"4632","Wandsworth 021D","E01004542","E02000943","Wandsworth 021","E09000032","Wandsworth","E12000007","London",1621,1621,0,123,618,2.6,"00BJ","Wandsworth",NA,25901,26176,27473,28737,27766,26444,30057,32345,1865,268,2584,3608
"4658","Wandsworth 027A","E01004543","E02000949","Wandsworth 027","E09000032","Wandsworth","E12000007","London",1791,1781,10,85.4,717,2.5,"00BJ","Wandsworth",NA,21940,22893,25189,28883,23995,28088,30711,32162,2055,5195,5522,3279
"4633","Wandsworth 021E","E01004544","E02000943","Wandsworth 021","E09000032","Wandsworth","E12000007","London",1533,1529,4,149.3,606,2.5,"00BJ","Wandsworth",NA,19041,17656,19468,30779,22422,22796,26715,32408,3381,5140,7247,1629
"4659","Wandsworth 027B","E01004545","E02000949","Wandsworth 027","E09000032","Wandsworth","E12000007","London",1578,1578,0,107.5,850,1.9,"00BJ","Wandsworth",NA,20592,26187,25556,24349,20216,29315,30605,26607,-376,3128,5049,2258
"4660","Wandsworth 027C","E01004546","E02000949","Wandsworth 027","E09000032","Wandsworth","E12000007","London",1506,1502,4,164.6,640,2.3,"00BJ","Wandsworth",NA,23680,22794,26764,31885,26688,28049,29208,30789,3008,5255,2444,-1096
"4671","Wandsworth 029C","E01004547","E02000951","Wandsworth 029","E09000032","Wandsworth","E12000007","London",1400,1331,69,121.3,551,2.4,"00BJ","Wandsworth",NA,10187,7984,8703,24347,11276,10346,9422,26526,1089,2362,719,2179
"4672","Wandsworth 029D","E01004548","E02000951","Wandsworth 029","E09000032","Wandsworth","E12000007","London",2052,2034,18,123.6,1054,1.9,"00BJ","Wandsworth",NA,11284,15355,18192,27592,14535,14866,19246,19410,3251,-489,1054,-8182
"4661","Wandsworth 027D","E01004549","E02000949","Wandsworth 027","E09000032","Wandsworth","E12000007","London",1664,1593,71,134.5,672,2.4,"00BJ","Wandsworth",NA,10382,14100,11839,28814,14789,16039,14304,20588,4407,1939,2465,-8226
"4611","Wandsworth 017D","E01004550","E02000939","Wandsworth 017","E09000032","Wandsworth","E12000007","London",1534,1363,171,106.6,570,2.4,"00BJ","Wandsworth",NA,18244,12888,24217,25800,17555,12027,25021,31137,-689,-861,804,5337
"4588","Wandsworth 012E","E01004551","E02000934","Wandsworth 012","E09000032","Wandsworth","E12000007","London",1764,1764,0,82.7,884,2,"00BJ","Wandsworth",NA,6709,7692,10314,13549,11738,14992,21939,21179,5029,7300,11625,7630
"4565","Wandsworth 008C","E01004552","E02000930","Wandsworth 008","E09000032","Wandsworth","E12000007","London",1982,1982,0,185.8,913,2.2,"00BJ","Wandsworth",NA,16587,25553,28075,28331,21639,30094,32007,28918,5052,4541,3932,587
"4598","Wandsworth 015A","E01004553","E02000937","Wandsworth 015","E09000032","Wandsworth","E12000007","London",1640,1640,0,82.2,766,2.1,"00BJ","Wandsworth",NA,17456,20180,23988,22203,20257,22828,28949,32024,2801,2648,4961,9821
"4568","Wandsworth 009A","E01004554","E02000931","Wandsworth 009","E09000032","Wandsworth","E12000007","London",1607,1607,0,39.4,653,2.5,"00BJ","Wandsworth",NA,25842,30776,32032,31110,26141,31140,32493,31761,299,364,461,651
"4612","Wandsworth 017E","E01004555","E02000939","Wandsworth 017","E09000032","Wandsworth","E12000007","London",1688,1663,25,120.5,587,2.8,"00BJ","Wandsworth",NA,24940,27355,19663,30795,29422,29466,31401,32267,4482,2111,11738,1472
"4569","Wandsworth 009B","E01004556","E02000931","Wandsworth 009","E09000032","Wandsworth","E12000007","London",1612,1612,0,161.8,590,2.7,"00BJ","Wandsworth",NA,28835,29369,32163,30784,29625,31647,32624,32504,790,2278,461,1720
"4599","Wandsworth 015B","E01004557","E02000937","Wandsworth 015","E09000032","Wandsworth","E12000007","London",1540,1530,10,142.3,650,2.4,"00BJ","Wandsworth",NA,20240,20286,22946,25041,24427,26221,25564,30438,4187,5935,2618,5397
"4600","Wandsworth 015C","E01004558","E02000937","Wandsworth 015","E09000032","Wandsworth","E12000007","London",1710,1707,3,75.5,675,2.5,"00BJ","Wandsworth",NA,21667,21138,27823,25504,27317,26948,30005,30915,5650,5810,2182,5411
"4601","Wandsworth 015D","E01004559","E02000937","Wandsworth 015","E09000032","Wandsworth","E12000007","London",1397,1397,0,78.9,503,2.8,"00BJ","Wandsworth",NA,23668,24548,26797,32013,27401,28843,29798,30211,3733,4295,3001,-1802
"4529","Wandsworth 001A","E01004560","E02000923","Wandsworth 001","E09000032","Wandsworth","E12000007","London",1954,1954,0,28.3,959,2,"00BJ","Wandsworth",NA,11213,14961,17501,13719,14978,21466,27032,28267,3765,6505,9531,14548
"4533","Wandsworth 002B","E01004562","E02000924","Wandsworth 002","E09000032","Wandsworth","E12000007","London",1764,1764,0,26.8,754,2.3,"00BJ","Wandsworth",NA,9046,5453,9865,16604,9441,6094,10680,14125,395,641,815,-2479
"4534","Wandsworth 002C","E01004563","E02000924","Wandsworth 002","E09000032","Wandsworth","E12000007","London",1961,1961,0,126.8,879,2.2,"00BJ","Wandsworth",NA,4617,2563,5901,9863,6775,7800,9723,19053,2158,5237,3822,9190
"4535","Wandsworth 002D","E01004564","E02000924","Wandsworth 002","E09000032","Wandsworth","E12000007","London",1768,1768,0,46.3,820,2.2,"00BJ","Wandsworth",NA,12468,12253,13790,23132,16278,15260,19134,22375,3810,3007,5344,-757
"4550","Wandsworth 005A","E01004565","E02000927","Wandsworth 005","E09000032","Wandsworth","E12000007","London",1679,1679,0,192.1,815,2.1,"00BJ","Wandsworth",NA,10453,12474,18581,18473,12379,13656,18207,17065,1926,1182,-374,-1408
"4530","Wandsworth 001B","E01004566","E02000923","Wandsworth 001","E09000032","Wandsworth","E12000007","London",1567,1567,0,164.8,821,1.9,"00BJ","Wandsworth",NA,22241,24164,28059,31320,19952,24903,31266,30104,-2289,739,3207,-1216
"4536","Wandsworth 002E","E01004567","E02000924","Wandsworth 002","E09000032","Wandsworth","E12000007","London",2343,2343,0,194.4,982,2.4,"00BJ","Wandsworth",NA,3532,1212,2169,9071,5555,2934,6489,17294,2023,1722,4320,8223
"4589","Wandsworth 013A","E01004568","E02000935","Wandsworth 013","E09000032","Wandsworth","E12000007","London",1665,1064,601,72.1,458,2.3,"00BJ","Wandsworth",NA,6621,4068,6689,15089,9637,7787,14934,10698,3016,3719,8245,-4391
"4638","Wandsworth 023A","E01004569","E02000945","Wandsworth 023","E09000032","Wandsworth","E12000007","London",2439,1969,470,84.8,737,2.7,"00BJ","Wandsworth",NA,8123,5754,8192,17355,10693,10099,12267,16904,2570,4345,4075,-451
"4639","Wandsworth 023B","E01004570","E02000945","Wandsworth 023","E09000032","Wandsworth","E12000007","London",1904,1873,31,162,745,2.5,"00BJ","Wandsworth",NA,4027,2145,2949,8615,6281,4789,7613,8641,2254,2644,4664,26
"4640","Wandsworth 023C","E01004571","E02000945","Wandsworth 023","E09000032","Wandsworth","E12000007","London",1681,1681,0,137,651,2.6,"00BJ","Wandsworth",NA,7699,4479,8917,8967,8238,5546,10136,17015,539,1067,1219,8048
"4603","Wandsworth 016A","E01004572","E02000938","Wandsworth 016","E09000032","Wandsworth","E12000007","London",1662,1649,13,21.1,706,2.3,"00BJ","Wandsworth",NA,12547,9758,15088,23868,11966,11468,15583,22034,-581,1710,495,-1834
"4641","Wandsworth 023D","E01004573","E02000945","Wandsworth 023","E09000032","Wandsworth","E12000007","London",1596,1521,75,9.5,631,2.4,"00BJ","Wandsworth",NA,9048,9298,13248,17017,8489,12199,12365,17195,-559,2901,-883,178
"4590","Wandsworth 013B","E01004574","E02000935","Wandsworth 013","E09000032","Wandsworth","E12000007","London",1811,1811,0,86.1,727,2.5,"00BJ","Wandsworth",NA,6308,2315,5794,11423,4917,2121,8032,7695,-1391,-194,2238,-3728
"4591","Wandsworth 013C","E01004575","E02000935","Wandsworth 013","E09000032","Wandsworth","E12000007","London",1810,1528,282,33.5,691,2.2,"00BJ","Wandsworth",NA,7817,6875,10815,9254,9768,7679,11571,21931,1951,804,756,12677
"4592","Wandsworth 013D","E01004576","E02000935","Wandsworth 013","E09000032","Wandsworth","E12000007","London",1564,1543,21,35.1,592,2.6,"00BJ","Wandsworth",NA,7905,5780,6595,12847,9928,8066,10795,18100,2023,2286,4200,5253
"4542","Wandsworth 003C","E01004577","E02000925","Wandsworth 003","E09000032","Wandsworth","E12000007","London",1957,1928,29,168.9,907,2.1,"00BJ","Wandsworth",NA,14249,14355,19428,17885,16951,18827,28341,29551,2702,4472,8913,11666
"4544","Wandsworth 004B","E01004579","E02000926","Wandsworth 004","E09000032","Wandsworth","E12000007","London",1615,1615,0,137.6,744,2.2,"00BJ","Wandsworth",NA,11671,12526,13661,17877,14717,14647,16124,26886,3046,2121,2463,9009
"4545","Wandsworth 004C","E01004580","E02000926","Wandsworth 004","E09000032","Wandsworth","E12000007","London",2092,2032,60,192.6,892,2.3,"00BJ","Wandsworth",NA,10778,12850,15941,19261,11566,13476,21163,28596,788,626,5222,9335
"4546","Wandsworth 004D","E01004581","E02000926","Wandsworth 004","E09000032","Wandsworth","E12000007","London",1817,1817,0,159.4,892,2,"00BJ","Wandsworth",NA,13032,12773,13672,18449,16650,14730,20410,22489,3618,1957,6738,4040
"4531","Wandsworth 001C","E01004582","E02000923","Wandsworth 001","E09000032","Wandsworth","E12000007","London",2147,2147,0,159.7,976,2.2,"00BJ","Wandsworth",NA,20056,18790,22378,22874,25385,23475,30024,29510,5329,4685,7646,6636
"4532","Wandsworth 001D","E01004583","E02000923","Wandsworth 001","E09000032","Wandsworth","E12000007","London",1806,1669,137,119.8,876,1.9,"00BJ","Wandsworth",NA,17743,16971,22340,29729,18486,17464,25925,29199,743,493,3585,-530
"4543","Wandsworth 003D","E01004584","E02000925","Wandsworth 003","E09000032","Wandsworth","E12000007","London",1710,1702,8,331.4,703,2.4,"00BJ","Wandsworth",NA,3488,1757,2656,9947,4097,2159,5107,10409,609,402,2451,462
"4566","Wandsworth 008D","E01004585","E02000930","Wandsworth 008","E09000032","Wandsworth","E12000007","London",1840,1835,5,142.2,858,2.1,"00BJ","Wandsworth",NA,16858,20996,24690,28536,21140,24322,29279,31033,4282,3326,4589,2497
"4570","Wandsworth 009C","E01004586","E02000931","Wandsworth 009","E09000032","Wandsworth","E12000007","London",1812,1812,0,207.8,848,2.1,"00BJ","Wandsworth",NA,16508,22052,23987,26647,21174,27216,30893,25229,4666,5164,6906,-1418
"4571","Wandsworth 009D","E01004587","E02000931","Wandsworth 009","E09000032","Wandsworth","E12000007","London",1743,1743,0,161.5,735,2.4,"00BJ","Wandsworth",NA,17879,22383,27766,16886,24248,26674,30291,30850,6369,4291,2525,13964
"4567","Wandsworth 008E","E01004588","E02000930","Wandsworth 008","E09000032","Wandsworth","E12000007","London",1954,1953,1,116.9,858,2.3,"00BJ","Wandsworth",NA,17100,23758,22037,29140,19549,27154,29315,30727,2449,3396,7278,1587
"4572","Wandsworth 009E","E01004589","E02000931","Wandsworth 009","E09000032","Wandsworth","E12000007","London",1700,1700,0,182,706,2.4,"00BJ","Wandsworth",NA,20206,27847,29453,27563,23107,30471,31748,32021,2901,2624,2295,4458
"4551","Wandsworth 005B","E01004590","E02000927","Wandsworth 005","E09000032","Wandsworth","E12000007","London",1749,1749,0,122.3,807,2.2,"00BJ","Wandsworth",NA,8541,7200,8576,15906,9529,9178,9747,19389,988,1978,1171,3483
"4552","Wandsworth 005C","E01004591","E02000927","Wandsworth 005","E09000032","Wandsworth","E12000007","London",1734,1734,0,140,811,2.1,"00BJ","Wandsworth",NA,9654,11446,11517,22835,12516,12745,15504,26323,2862,1299,3987,3488
"4553","Wandsworth 005D","E01004592","E02000927","Wandsworth 005","E09000032","Wandsworth","E12000007","London",1628,1628,0,169.9,795,2,"00BJ","Wandsworth",NA,7843,7864,8086,13998,9426,10013,9507,18559,1583,2149,1421,4561
"4647","Wandsworth 025A","E01004593","E02000947","Wandsworth 025","E09000032","Wandsworth","E12000007","London",1830,1830,0,85.2,852,2.1,"00BJ","Wandsworth",NA,20277,23161,27809,27370,26181,24132,27888,30974,5904,971,79,3604
"4626","Wandsworth 020D","E01004594","E02000942","Wandsworth 020","E09000032","Wandsworth","E12000007","London",1657,1657,0,115.3,590,2.8,"00BJ","Wandsworth",NA,29158,28240,30879,31617,29897,30867,32422,32521,739,2627,1543,904
"4648","Wandsworth 025B","E01004595","E02000947","Wandsworth 025","E09000032","Wandsworth","E12000007","London",1757,1757,0,78.2,796,2.2,"00BJ","Wandsworth",NA,23491,19536,29168,24661,27172,26189,30128,30574,3681,6653,960,5913
"4627","Wandsworth 020E","E01004596","E02000942","Wandsworth 020","E09000032","Wandsworth","E12000007","London",1621,1621,0,137.5,646,2.5,"00BJ","Wandsworth",NA,28166,30982,30546,32261,28862,31315,31544,32703,696,333,998,442
"4649","Wandsworth 025C","E01004597","E02000947","Wandsworth 025","E09000032","Wandsworth","E12000007","London",1813,1813,0,129.7,779,2.3,"00BJ","Wandsworth",NA,19376,14808,21303,25338,21238,15961,20725,31808,1862,1153,-578,6470
"4650","Wandsworth 025D","E01004598","E02000947","Wandsworth 025","E09000032","Wandsworth","E12000007","London",1760,1760,0,123.4,818,2.2,"00BJ","Wandsworth",NA,22704,21698,27672,25887,28109,27428,31008,30433,5405,5730,3336,4546
"4651","Wandsworth 025E","E01004599","E02000947","Wandsworth 025","E09000032","Wandsworth","E12000007","London",1515,1515,0,136.7,575,2.6,"00BJ","Wandsworth",NA,30037,30819,30664,30551,31765,31903,32395,32764,1728,1084,1731,2213
"4615","Wandsworth 018C","E01004600","E02000940","Wandsworth 018","E09000032","Wandsworth","E12000007","London",2062,2062,0,167.2,893,2.3,"00BJ","Wandsworth",NA,6242,2870,7464,14558,8274,5355,8935,20891,2032,2485,1471,6333
"4616","Wandsworth 018D","E01004601","E02000940","Wandsworth 018","E09000032","Wandsworth","E12000007","London",2241,2241,0,73.7,1006,2.2,"00BJ","Wandsworth",NA,12349,9358,19105,20252,15132,12348,20804,25833,2783,2990,1699,5581
"4575","Wandsworth 010C","E01004602","E02000932","Wandsworth 010","E09000032","Wandsworth","E12000007","London",1640,1640,0,118.8,706,2.3,"00BJ","Wandsworth",NA,24936,28140,31271,29352,25195,31136,32576,32418,259,2996,1305,3066
"4554","Wandsworth 006A","E01004604","E02000928","Wandsworth 006","E09000032","Wandsworth","E12000007","London",1686,1686,0,44.9,593,2.8,"00BJ","Wandsworth",NA,27744,30245,31592,32012,27775,31859,32090,32810,31,1614,498,798
"4555","Wandsworth 006B","E01004605","E02000928","Wandsworth 006","E09000032","Wandsworth","E12000007","London",1728,1726,2,88.8,785,2.2,"00BJ","Wandsworth",NA,16326,13537,17668,27010,21250,15668,22122,29916,4924,2131,4454,2906
"4556","Wandsworth 006C","E01004606","E02000928","Wandsworth 006","E09000032","Wandsworth","E12000007","London",1633,1625,8,154.3,754,2.2,"00BJ","Wandsworth",NA,24331,29734,31898,20801,27768,32002,32645,32366,3437,2268,747,11565
"4557","Wandsworth 006D","E01004607","E02000928","Wandsworth 006","E09000032","Wandsworth","E12000007","London",1729,1729,0,102.9,718,2.4,"00BJ","Wandsworth",NA,27897,31219,31244,32354,28654,31193,31981,32693,757,-26,737,339
"4558","Wandsworth 006E","E01004608","E02000928","Wandsworth 006","E09000032","Wandsworth","E12000007","London",1682,1682,0,174.8,785,2.1,"00BJ","Wandsworth",NA,17674,16004,22422,22368,18247,15851,22859,29399,573,-153,437,7031
"4576","Wandsworth 010E","E01004609","E02000932","Wandsworth 010","E09000032","Wandsworth","E12000007","London",2147,2147,0,104.3,996,2.2,"00BJ","Wandsworth",NA,23263,29608,31562,32254,21662,30624,32559,32772,-1601,1016,997,518
"4687","Wandsworth 033C","E01004610","E02000955","Wandsworth 033","E09000032","Wandsworth","E12000007","London",1978,1976,2,69.1,632,3.1,"00BJ","Wandsworth",NA,11488,9210,16418,29004,13440,12397,19146,27925,1952,3187,2728,-1079
"4682","Wandsworth 032B","E01004611","E02000954","Wandsworth 032","E09000032","Wandsworth","E12000007","London",1602,1602,0,130.6,570,2.8,"00BJ","Wandsworth",NA,15634,10833,17593,24780,12903,10397,16303,24663,-2731,-436,-1290,-117
"4683","Wandsworth 032C","E01004612","E02000954","Wandsworth 032","E09000032","Wandsworth","E12000007","London",1788,1785,3,148.5,558,3.2,"00BJ","Wandsworth",NA,12960,7712,16068,26673,12714,11170,20031,24996,-246,3458,3963,-1677
"4688","Wandsworth 033D","E01004613","E02000955","Wandsworth 033","E09000032","Wandsworth","E12000007","London",1614,1614,0,160.4,677,2.4,"00BJ","Wandsworth",NA,7279,5225,11232,19000,4747,4482,9992,18312,-2532,-743,-1240,-688
"4689","Wandsworth 034A","E01004614","E02000956","Wandsworth 034","E09000032","Wandsworth","E12000007","London",2065,2065,0,145.2,855,2.4,"00BJ","Wandsworth",NA,10281,10537,13705,18932,13063,10987,14341,22282,2782,450,636,3350
"4690","Wandsworth 034B","E01004615","E02000956","Wandsworth 034","E09000032","Wandsworth","E12000007","London",1798,1795,3,101.2,757,2.4,"00BJ","Wandsworth",NA,4932,2520,4799,13812,4593,3128,6845,11077,-339,608,2046,-2735
"4691","Wandsworth 034C","E01004616","E02000956","Wandsworth 034","E09000032","Wandsworth","E12000007","London",2162,2159,3,204.3,816,2.6,"00BJ","Wandsworth",NA,13520,12385,14132,21854,14669,14086,20587,28476,1149,1701,6455,6622
"4692","Wandsworth 034D","E01004617","E02000956","Wandsworth 034","E09000032","Wandsworth","E12000007","London",1680,1645,35,38.9,638,2.6,"00BJ","Wandsworth",NA,10487,9630,15900,12872,9962,11040,14012,14558,-525,1410,-1888,1686
"4684","Wandsworth 032D","E01004618","E02000954","Wandsworth 032","E09000032","Wandsworth","E12000007","London",1552,1552,0,132.5,527,2.9,"00BJ","Wandsworth",NA,15787,16882,21416,28435,19202,19498,27362,31959,3415,2616,5946,3524
"4602","Wandsworth 015E","E01004619","E02000937","Wandsworth 015","E09000032","Wandsworth","E12000007","London",1437,1437,0,27.5,536,2.7,"00BJ","Wandsworth",NA,24927,30424,30588,32121,20071,31848,29439,32753,-4856,1424,-1149,632
"4619","Wandsworth 019C","E01004620","E02000941","Wandsworth 019","E09000032","Wandsworth","E12000007","London",1647,1642,5,153.6,702,2.3,"00BJ","Wandsworth",NA,21208,19675,24537,24937,20564,20155,24464,25470,-644,480,-73,533
"4620","Wandsworth 019D","E01004621","E02000941","Wandsworth 019","E09000032","Wandsworth","E12000007","London",1686,1635,51,38.5,659,2.5,"00BJ","Wandsworth",NA,14179,16199,18786,25527,16774,22182,26516,29452,2595,5983,7730,3925
"4645","Wandsworth 024D","E01004622","E02000946","Wandsworth 024","E09000032","Wandsworth","E12000007","London",2266,1092,1174,112,533,2,"00BJ","Wandsworth",NA,7031,9109,8364,19727,13101,19755,24021,10873,6070,10646,15657,-8854
"4621","Wandsworth 019E","E01004623","E02000941","Wandsworth 019","E09000032","Wandsworth","E12000007","London",1733,1733,0,116.3,712,2.4,"00BJ","Wandsworth",NA,20351,19984,24272,24188,24749,22722,28302,31521,4398,2738,4030,7333
"4646","Wandsworth 024E","E01004624","E02000946","Wandsworth 024","E09000032","Wandsworth","E12000007","London",1592,1592,0,39.6,624,2.6,"00BJ","Wandsworth",NA,15111,13792,18848,20024,15918,18779,20593,21018,807,4987,1745,994
"4662","Wandsworth 027E","E01004625","E02000949","Wandsworth 027","E09000032","Wandsworth","E12000007","London",1397,1397,0,56.1,469,3,"00BJ","Wandsworth",NA,29028,31715,32128,32117,26878,32602,32614,32775,-2150,887,486,658
"4663","Wandsworth 027F","E01004626","E02000949","Wandsworth 027","E09000032","Wandsworth","E12000007","London",1869,1674,195,32.3,724,2.3,"00BJ","Wandsworth",NA,18290,25331,13757,32034,19388,22503,24537,32033,1098,-2828,10780,-1
"4622","Wandsworth 019F","E01004627","E02000941","Wandsworth 019","E09000032","Wandsworth","E12000007","London",1620,1614,6,145.6,631,2.6,"00BJ","Wandsworth",NA,17520,18362,22992,24602,22531,22511,27151,31787,5011,4149,4159,7185
"4634","Wandsworth 022A","E01004628","E02000944","Wandsworth 022","E09000032","Wandsworth","E12000007","London",2300,2102,198,101,911,2.3,"00BJ","Wandsworth",NA,5708,6511,3500,12765,11719,11661,14095,27296,6011,5150,10595,14531
"4628","Wandsworth 020F","E01004629","E02000942","Wandsworth 020","E09000032","Wandsworth","E12000007","London",1618,1586,32,66.3,609,2.6,"00BJ","Wandsworth",NA,19056,21667,19944,31606,22941,22112,25531,31717,3885,445,5587,111
"4635","Wandsworth 022B","E01004630","E02000944","Wandsworth 022","E09000032","Wandsworth","E12000007","London",1751,1751,0,154.1,679,2.6,"00BJ","Wandsworth",NA,5695,1945,5770,14013,8043,4050,8035,13298,2348,2105,2265,-715
"4636","Wandsworth 022C","E01004631","E02000944","Wandsworth 022","E09000032","Wandsworth","E12000007","London",1537,1452,85,95,643,2.3,"00BJ","Wandsworth",NA,11355,8485,18293,18243,11815,9642,13940,25838,460,1157,-4353,7595
"4664","Wandsworth 028A","E01004632","E02000950","Wandsworth 028","E09000032","Wandsworth","E12000007","London",1527,1527,0,55.1,593,2.6,"00BJ","Wandsworth",NA,25777,22269,30075,28641,26351,22320,28895,30736,574,51,-1180,2095
"4637","Wandsworth 022D","E01004633","E02000944","Wandsworth 022","E09000032","Wandsworth","E12000007","London",1618,1618,0,195.9,623,2.6,"00BJ","Wandsworth",NA,9131,4957,10617,13697,8910,4464,9402,18134,-221,-493,-1215,4437
"4665","Wandsworth 028B","E01004634","E02000950","Wandsworth 028","E09000032","Wandsworth","E12000007","London",1473,1465,8,119.5,697,2.1,"00BJ","Wandsworth",NA,16347,13581,17599,16125,19590,15492,18991,29186,3243,1911,1392,13061
"4666","Wandsworth 028C","E01004635","E02000950","Wandsworth 028","E09000032","Wandsworth","E12000007","London",1645,1616,29,100.5,691,2.3,"00BJ","Wandsworth",NA,18214,15531,24243,16333,21184,16293,20037,29556,2970,762,-4206,13223
"4667","Wandsworth 028D","E01004636","E02000950","Wandsworth 028","E09000032","Wandsworth","E12000007","London",1462,1462,0,95.4,650,2.2,"00BJ","Wandsworth",NA,16067,11255,17980,22065,19602,14511,20150,25225,3535,3256,2170,3160
"4668","Wandsworth 028E","E01004637","E02000950","Wandsworth 028","E09000032","Wandsworth","E12000007","London",1471,1471,0,103.9,602,2.4,"00BJ","Wandsworth",NA,15669,12660,18660,18591,19563,13025,17019,26683,3894,365,-1641,8092
"4580","Wandsworth 011B","E01004638","E02000933","Wandsworth 011","E09000032","Wandsworth","E12000007","London",1449,1438,11,53,519,2.8,"00BJ","Wandsworth",NA,18953,25417,28919,31421,27696,30265,31278,32683,8743,4848,2359,1262
"4581","Wandsworth 011C","E01004639","E02000933","Wandsworth 011","E09000032","Wandsworth","E12000007","London",1724,1715,9,76.5,783,2.2,"00BJ","Wandsworth",NA,21092,19547,23266,28696,20573,24721,28410,30484,-519,5174,5144,1788
"4582","Wandsworth 011D","E01004640","E02000933","Wandsworth 011","E09000032","Wandsworth","E12000007","London",1775,1775,0,106.9,797,2.2,"00BJ","Wandsworth",NA,28177,30311,30349,31830,28557,30714,32133,30521,380,403,1784,-1309
"4583","Wandsworth 011E","E01004641","E02000933","Wandsworth 011","E09000032","Wandsworth","E12000007","London",1910,1910,0,92,818,2.3,"00BJ","Wandsworth",NA,16770,14984,18103,27172,14867,12793,15585,28159,-1903,-2191,-2518,987
"4604","Wandsworth 016B","E01004642","E02000938","Wandsworth 016","E09000032","Wandsworth","E12000007","London",1856,1734,122,84.4,761,2.3,"00BJ","Wandsworth",NA,13142,10129,11868,18142,12359,12867,15422,18640,-783,2738,3554,498
"4605","Wandsworth 016C","E01004643","E02000938","Wandsworth 016","E09000032","Wandsworth","E12000007","London",2013,1981,32,99.6,851,2.3,"00BJ","Wandsworth",NA,9391,6392,8343,19527,11841,8354,10812,23233,2450,1962,2469,3706
"4606","Wandsworth 016D","E01004644","E02000938","Wandsworth 016","E09000032","Wandsworth","E12000007","London",1937,1924,13,49.3,870,2.2,"00BJ","Wandsworth",NA,13782,10489,11251,24879,14233,13109,17996,21648,451,2620,6745,-3231
"4607","Wandsworth 016E","E01004645","E02000938","Wandsworth 016","E09000032","Wandsworth","E12000007","London",2078,1983,95,131,844,2.3,"00BJ","Wandsworth",NA,8621,4401,7787,17433,8479,5416,10241,13186,-142,1015,2454,-4247
"4712","Westminster 002A","E01004646","E02000961","Westminster 002","E09000033","Westminster","E12000007","London",1653,1653,0,77,616,2.7,"00BK","Westminster",NA,13928,19919,26283,29816,16031,19663,26842,28175,2103,-256,559,-1641
"4708","Westminster 001A","E01004647","E02000960","Westminster 001","E09000033","Westminster","E12000007","London",1480,1480,0,75.9,685,2.2,"00BK","Westminster",NA,16932,18696,24219,26836,15574,13445,19961,25048,-1358,-5251,-4258,-1788
"4713","Westminster 002B","E01004648","E02000961","Westminster 002","E09000033","Westminster","E12000007","London",2398,2398,0,112.1,1122,2.1,"00BK","Westminster",NA,14643,15780,17807,22988,14895,15597,21318,20068,252,-183,3511,-2920
"4709","Westminster 001B","E01004649","E02000960","Westminster 001","E09000033","Westminster","E12000007","London",1708,1593,115,87.4,716,2.2,"00BK","Westminster",NA,20916,28948,31888,20627,24238,24446,31410,27649,3322,-4502,-478,7022
"4714","Westminster 002C","E01004650","E02000961","Westminster 002","E09000033","Westminster","E12000007","London",1996,1992,4,113.5,932,2.1,"00BK","Westminster",NA,21380,25795,30019,29633,21201,26606,29909,30238,-179,811,-110,605
"4717","Westminster 003A","E01004651","E02000962","Westminster 003","E09000033","Westminster","E12000007","London",2015,2015,0,201.9,1137,1.8,"00BK","Westminster",NA,20449,27188,30811,23671,16569,22567,30258,12207,-3880,-4621,-553,-11464
"4793","Westminster 017A","E01004652","E02000976","Westminster 017","E09000033","Westminster","E12000007","London",1840,1840,0,391.5,958,1.9,"00BK","Westminster",NA,15045,18441,26392,27296,12051,13961,22109,30779,-2994,-4480,-4283,3483
"4776","Westminster 014A","E01004653","E02000973","Westminster 014","E09000033","Westminster","E12000007","London",1812,1812,0,199.6,929,2,"00BK","Westminster",NA,15539,17935,20695,27437,17599,23993,24584,28010,2060,6058,3889,573
"4777","Westminster 014B","E01004654","E02000973","Westminster 014","E09000033","Westminster","E12000007","London",2274,2225,49,192.4,1204,1.8,"00BK","Westminster",NA,11616,16289,13875,28927,15215,19782,21605,32221,3599,3493,7730,3294
"4778","Westminster 014D","E01004656","E02000973","Westminster 014","E09000033","Westminster","E12000007","London",2107,2107,0,139.3,1178,1.8,"00BK","Westminster",NA,8232,12883,11192,30328,7137,11525,11039,27578,-1095,-1358,-153,-2750
"4766","Westminster 012A","E01004657","E02000971","Westminster 012","E09000033","Westminster","E12000007","London",1480,1471,9,119.2,827,1.8,"00BK","Westminster",NA,15766,30467,31362,27109,15565,30002,32365,30112,-201,-465,1003,3003
"4767","Westminster 012B","E01004658","E02000971","Westminster 012","E09000033","Westminster","E12000007","London",1557,1391,166,153.1,744,1.9,"00BK","Westminster",NA,17118,26691,30765,22321,9897,12301,20342,22606,-7221,-14390,-10423,285
"4744","Westminster 008A","E01004659","E02000967","Westminster 008","E09000033","Westminster","E12000007","London",1802,1769,33,157.9,961,1.8,"00BK","Westminster",NA,19281,25811,29109,23695,19376,22293,29880,27796,95,-3518,771,4101
"4745","Westminster 008B","E01004660","E02000967","Westminster 008","E09000033","Westminster","E12000007","London",1781,1781,0,261.5,873,2,"00BK","Westminster",NA,22753,29610,32057,26054,20960,28198,32110,30854,-1793,-1412,53,4800
"4768","Westminster 012C","E01004661","E02000971","Westminster 012","E09000033","Westminster","E12000007","London",1847,1817,30,139.2,892,2,"00BK","Westminster",NA,14727,20340,19725,26609,8996,10149,12188,23855,-5731,-10191,-7537,-2754
"4769","Westminster 012D","E01004662","E02000971","Westminster 012","E09000033","Westminster","E12000007","London",1876,1876,0,209.6,1040,1.8,"00BK","Westminster",NA,16733,24475,28564,31560,16358,24408,30377,32133,-375,-67,1813,573
"4770","Westminster 012E","E01004663","E02000971","Westminster 012","E09000033","Westminster","E12000007","London",1648,1636,12,177.8,851,1.9,"00BK","Westminster",NA,16068,19359,22645,28592,12665,15704,19600,28370,-3403,-3655,-3045,-222
"4830","Westminster 024A","E01004665","E02000983","Westminster 024","E09000033","Westminster","E12000007","London",1478,1478,0,309.2,611,2.4,"00BK","Westminster",NA,5719,2529,6531,16090,1778,550,2724,10422,-3941,-1979,-3807,-5668
"4824","Westminster 023B","E01004666","E02000982","Westminster 023","E09000033","Westminster","E12000007","London",1103,1103,0,128.7,553,2,"00BK","Westminster",NA,11034,10319,11870,23189,8300,7942,8998,27652,-2734,-2377,-2872,4463
"4825","Westminster 023C","E01004667","E02000982","Westminster 023","E09000033","Westminster","E12000007","London",1348,1348,0,102.8,743,1.8,"00BK","Westminster",NA,10614,12460,10222,23343,6839,8596,7615,21906,-3775,-3864,-2607,-1437
"4826","Westminster 023D","E01004668","E02000982","Westminster 023","E09000033","Westminster","E12000007","London",1443,1443,0,261.9,645,2.2,"00BK","Westminster",NA,12230,10583,15310,21732,11612,10394,10918,26958,-618,-189,-4392,5226
"4831","Westminster 024B","E01004669","E02000983","Westminster 024","E09000033","Westminster","E12000007","London",1683,1683,0,234.7,758,2.2,"00BK","Westminster",NA,6543,5408,7237,16656,4405,3565,5758,14341,-2138,-1843,-1479,-2315
"4748","Westminster 009A","E01004670","E02000968","Westminster 009","E09000033","Westminster","E12000007","London",2709,2709,0,326,948,2.9,"00BK","Westminster",NA,3095,653,5777,16236,1120,255,1250,8973,-1975,-398,-4527,-7263
"4727","Westminster 005A","E01004674","E02000964","Westminster 005","E09000033","Westminster","E12000007","London",2107,2093,14,240,843,2.5,"00BK","Westminster",NA,1496,683,2246,17003,3067,2082,3630,17404,1571,1399,1384,401
"4728","Westminster 005B","E01004675","E02000964","Westminster 005","E09000033","Westminster","E12000007","London",2284,2279,5,253.5,1098,2.1,"00BK","Westminster",NA,1739,1393,2086,23953,2579,1820,3852,24158,840,427,1766,205
"4733","Westminster 006A","E01004676","E02000965","Westminster 006","E09000033","Westminster","E12000007","London",1685,1685,0,204.7,794,2.1,"00BK","Westminster",NA,8075,7189,11664,19950,8752,7274,11302,23139,677,85,-362,3189
"4729","Westminster 005C","E01004677","E02000964","Westminster 005","E09000033","Westminster","E12000007","London",1815,1795,20,255.3,876,2,"00BK","Westminster",NA,4131,3335,4290,18848,8913,6693,9292,24050,4782,3358,5002,5202
"4730","Westminster 005D","E01004678","E02000964","Westminster 005","E09000033","Westminster","E12000007","London",2000,1997,3,230.4,889,2.2,"00BK","Westminster",NA,5381,3206,5251,19253,7623,5695,8688,21747,2242,2489,3437,2494
"4731","Westminster 005E","E01004679","E02000964","Westminster 005","E09000033","Westminster","E12000007","London",2143,2118,25,280.1,935,2.3,"00BK","Westminster",NA,2924,3342,4693,21748,4347,4286,7080,18573,1423,944,2387,-3175
"4782","Westminster 015A","E01004680","E02000974","Westminster 015","E09000033","Westminster","E12000007","London",1488,1451,37,130.6,708,2,"00BK","Westminster",NA,21698,31608,32234,30649,18017,28934,32322,31146,-3681,-2674,88,497
"4788","Westminster 016A","E01004681","E02000975","Westminster 016","E09000033","Westminster","E12000007","London",2126,2126,0,120.9,1150,1.8,"00BK","Westminster",NA,16930,20311,28068,29579,15758,18332,27628,24355,-1172,-1979,-440,-5224
"4789","Westminster 016B","E01004682","E02000975","Westminster 016","E09000033","Westminster","E12000007","London",1542,1336,206,165.1,765,1.7,"00BK","Westminster",NA,14108,21991,26314,21086,13094,22939,28056,31361,-1014,948,1742,10275
"4783","Westminster 015B","E01004683","E02000974","Westminster 015","E09000033","Westminster","E12000007","London",1662,1657,5,127.9,767,2.2,"00BK","Westminster",NA,22154,31787,32409,29647,20777,31966,32740,28243,-1377,179,331,-1404
"4784","Westminster 015C","E01004684","E02000974","Westminster 015","E09000033","Westminster","E12000007","London",1617,1401,216,201.9,701,2,"00BK","Westminster",NA,9204,15541,24730,27645,7859,10491,16365,24103,-1345,-5050,-8365,-3542
"4785","Westminster 015E","E01004686","E02000974","Westminster 015","E09000033","Westminster","E12000007","London",1529,1529,0,243.1,848,1.8,"00BK","Westminster",NA,7261,9868,8908,20769,6098,7160,9423,15867,-1163,-2708,515,-4902
"4803","Westminster 019A","E01004687","E02000978","Westminster 019","E09000033","Westminster","E12000007","London",1669,1665,4,90.1,799,2.1,"00BK","Westminster",NA,25711,32457,32465,29431,24722,32690,32839,32481,-989,233,374,3050
"4804","Westminster 019B","E01004688","E02000978","Westminster 019","E09000033","Westminster","E12000007","London",1950,878,1072,26.1,486,1.8,"00BK","Westminster",NA,19453,32478,32475,16995,26187,32838,32837,27478,6734,360,362,10483
"4805","Westminster 019C","E01004689","E02000978","Westminster 019","E09000033","Westminster","E12000007","London",1173,1015,158,6.1,510,2,"00BK","Westminster",NA,19551,32473,32468,19937,14816,32830,32830,19579,-4735,357,362,-358
"4806","Westminster 019D","E01004690","E02000978","Westminster 019","E09000033","Westminster","E12000007","London",1400,1400,0,59.2,627,2.2,"00BK","Westminster",NA,24256,32470,32470,29222,25096,32685,32810,29484,840,215,340,262
"4807","Westminster 019E","E01004691","E02000978","Westminster 019","E09000033","Westminster","E12000007","London",1508,1508,0,43.2,816,1.8,"00BK","Westminster",NA,21269,32392,32441,20686,19460,32683,32819,30459,-1809,291,378,9773
"4808","Westminster 019F","E01004692","E02000978","Westminster 019","E09000033","Westminster","E12000007","London",1570,1396,174,103.9,644,2.2,"00BK","Westminster",NA,22066,32464,32469,30357,22866,32804,32801,32111,800,340,332,1754
"4794","Westminster 017B","E01004693","E02000976","Westminster 017","E09000033","Westminster","E12000007","London",1398,1398,0,171.1,735,1.9,"00BK","Westminster",NA,19503,30286,31862,28491,16478,30031,31123,32139,-3025,-255,-739,3648
"4790","Westminster 016C","E01004694","E02000975","Westminster 016","E09000033","Westminster","E12000007","London",1813,1717,96,177.2,949,1.8,"00BK","Westminster",NA,12852,21341,21063,23405,12101,20638,23733,13971,-751,-703,2670,-9434
"4795","Westminster 017C","E01004695","E02000976","Westminster 017","E09000033","Westminster","E12000007","London",1297,1274,23,230.8,669,1.9,"00BK","Westminster",NA,16460,30001,32100,13905,13915,23180,26245,22066,-2545,-6821,-5855,8161
"4796","Westminster 017D","E01004696","E02000976","Westminster 017","E09000033","Westminster","E12000007","London",1586,1585,1,237.8,760,2.1,"00BK","Westminster",NA,6834,5963,8316,20890,4269,3326,4172,24304,-2565,-2637,-4144,3414
"4791","Westminster 016D","E01004697","E02000975","Westminster 016","E09000033","Westminster","E12000007","London",1513,1504,9,273.1,816,1.8,"00BK","Westminster",NA,13353,20701,26691,14855,12128,18467,25063,23483,-1225,-2234,-1628,8628
"4797","Westminster 017E","E01004698","E02000976","Westminster 017","E09000033","Westminster","E12000007","London",1558,1428,130,166.6,754,1.9,"00BK","Westminster",NA,10017,19474,20309,25337,9747,19107,21363,31258,-270,-367,1054,5921
"4798","Westminster 017F","E01004699","E02000976","Westminster 017","E09000033","Westminster","E12000007","London",2267,2241,26,194.4,1165,1.9,"00BK","Westminster",NA,11290,15205,20466,28072,12293,19712,25257,31433,1003,4507,4791,3361
"4792","Westminster 016E","E01004700","E02000975","Westminster 016","E09000033","Westminster","E12000007","London",1763,1708,55,307.1,941,1.8,"00BK","Westminster",NA,16363,29690,30736,27182,15770,24487,29856,30862,-593,-5203,-880,3680
"4738","Westminster 007A","E01004701","E02000966","Westminster 007","E09000033","Westminster","E12000007","London",1618,1618,0,204.3,843,1.9,"00BK","Westminster",NA,15902,23218,27569,30752,16093,19985,28870,20874,191,-3233,1301,-9878
"4749","Westminster 009E","E01004702","E02000968","Westminster 009","E09000033","Westminster","E12000007","London",2598,2597,1,158.1,994,2.6,"00BK","Westminster",NA,1670,963,4319,15125,1700,1180,2977,14380,30,217,-1342,-745
"4739","Westminster 007B","E01004703","E02000966","Westminster 007","E09000033","Westminster","E12000007","London",2308,2308,0,111.1,1027,2.2,"00BK","Westminster",NA,13004,21623,24647,27858,17593,22769,29690,28205,4589,1146,5043,347
"4740","Westminster 007D","E01004705","E02000966","Westminster 007","E09000033","Westminster","E12000007","London",1469,1469,0,215.1,700,2.1,"00BK","Westminster",NA,19891,31228,31640,28197,22850,28304,32105,26486,2959,-2924,465,-1711
"4734","Westminster 006B","E01004706","E02000965","Westminster 006","E09000033","Westminster","E12000007","London",1600,1600,0,114.7,735,2.2,"00BK","Westminster",NA,18660,26522,31842,28145,18209,24083,31028,24558,-451,-2439,-814,-3587
"4735","Westminster 006C","E01004707","E02000965","Westminster 006","E09000033","Westminster","E12000007","London",1954,1954,0,151.6,798,2.4,"00BK","Westminster",NA,24592,30251,32125,30016,23304,22013,32062,31647,-1288,-8238,-63,1631
"4736","Westminster 006D","E01004708","E02000965","Westminster 006","E09000033","Westminster","E12000007","London",1588,1569,19,195.6,788,2,"00BK","Westminster",NA,7975,9927,10805,15039,7532,9926,9956,22591,-443,-1,-849,7552
"4741","Westminster 007E","E01004709","E02000966","Westminster 007","E09000033","Westminster","E12000007","London",1673,1673,0,188.4,765,2.2,"00BK","Westminster",NA,11236,10369,14624,20837,8648,5414,8905,23663,-2588,-4955,-5719,2826
"4715","Westminster 002D","E01004710","E02000961","Westminster 002","E09000033","Westminster","E12000007","London",1648,1603,45,128.2,635,2.5,"00BK","Westminster",NA,6437,5484,8335,17732,3275,2184,4791,17941,-3162,-3300,-3544,209
"4716","Westminster 002E","E01004711","E02000961","Westminster 002","E09000033","Westminster","E12000007","London",1747,1734,13,220,759,2.3,"00BK","Westminster",NA,8190,4877,11620,22755,6039,3832,6143,13559,-2151,-1045,-5477,-9196
"4746","Westminster 008C","E01004712","E02000967","Westminster 008","E09000033","Westminster","E12000007","London",1680,1545,135,167.3,842,1.8,"00BK","Westminster",NA,18280,19605,29463,28282,18052,24630,31884,31179,-228,5025,2421,2897
"4761","Westminster 011A","E01004713","E02000970","Westminster 011","E09000033","Westminster","E12000007","London",1829,1779,50,105.2,939,1.9,"00BK","Westminster",NA,25367,31688,32425,31971,23040,32559,32744,31195,-2327,871,319,-776
"4762","Westminster 011B","E01004714","E02000970","Westminster 011","E09000033","Westminster","E12000007","London",2150,2141,9,63.3,1177,1.8,"00BK","Westminster",NA,20032,30239,31677,31415,17566,23408,30310,32274,-2466,-6831,-1367,859
"4771","Westminster 013A","E01004715","E02000972","Westminster 013","E09000033","Westminster","E12000007","London",1773,1514,259,161.3,824,1.8,"00BK","Westminster",NA,13925,14862,19562,28524,12211,14808,17132,23703,-1714,-54,-2430,-4821
"4763","Westminster 011C","E01004716","E02000970","Westminster 011","E09000033","Westminster","E12000007","London",1423,1419,4,79.7,724,2,"00BK","Westminster",NA,23683,31382,32438,29793,21811,32618,32818,30215,-1872,1236,380,422
"4764","Westminster 011D","E01004717","E02000970","Westminster 011","E09000033","Westminster","E12000007","London",1511,1511,0,153.2,898,1.7,"00BK","Westminster",NA,18676,31301,31686,26365,18584,32566,32750,32467,-92,1265,1064,6102
"4722","Westminster 004A","E01004718","E02000963","Westminster 004","E09000033","Westminster","E12000007","London",1962,1962,0,265.5,850,2.3,"00BK","Westminster",NA,3127,2738,3206,15820,5797,5836,7000,14612,2670,3098,3794,-1208
"4723","Westminster 004B","E01004719","E02000963","Westminster 004","E09000033","Westminster","E12000007","London",1909,1896,13,197.2,786,2.4,"00BK","Westminster",NA,4910,2468,5849,18414,6209,4781,5552,18726,1299,2313,-297,312
"4724","Westminster 004C","E01004720","E02000963","Westminster 004","E09000033","Westminster","E12000007","London",2000,1991,9,169.1,777,2.6,"00BK","Westminster",NA,2714,2715,4408,14024,4131,3263,5018,10672,1417,548,610,-3352
"4725","Westminster 004D","E01004721","E02000963","Westminster 004","E09000033","Westminster","E12000007","London",1998,1998,0,170,879,2.3,"00BK","Westminster",NA,927,326,2128,12918,2113,2149,3640,15063,1186,1823,1512,2145
"4726","Westminster 004E","E01004722","E02000963","Westminster 004","E09000033","Westminster","E12000007","London",2494,2456,38,310.6,849,2.9,"00BK","Westminster",NA,940,42,2126,12862,2876,1385,2998,11669,1936,1343,872,-1193
"4732","Westminster 005F","E01004723","E02000964","Westminster 005","E09000033","Westminster","E12000007","London",2200,2176,24,228.2,997,2.2,"00BK","Westminster",NA,1907,1286,1831,20489,5439,3408,6862,19719,3532,2122,5031,-770
"4710","Westminster 001C","E01004724","E02000960","Westminster 001","E09000033","Westminster","E12000007","London",1761,1761,0,218.2,850,2.1,"00BK","Westminster",NA,16801,16368,24090,22251,17233,16900,22024,26709,432,532,-2066,4458
"4718","Westminster 003B","E01004725","E02000962","Westminster 003","E09000033","Westminster","E12000007","London",1615,1611,4,59.2,799,2,"00BK","Westminster",NA,8782,7633,15082,25301,5042,3720,9438,19981,-3740,-3913,-5644,-5320
"4719","Westminster 003C","E01004726","E02000962","Westminster 003","E09000033","Westminster","E12000007","London",1798,1792,6,96.8,824,2.2,"00BK","Westminster",NA,19928,26741,31830,26429,18369,24709,30994,28488,-1559,-2032,-836,2059
"4747","Westminster 008D","E01004727","E02000967","Westminster 008","E09000033","Westminster","E12000007","London",2026,1998,28,17.9,977,2,"00BK","Westminster",NA,17484,32215,32462,31216,21366,29906,32822,32310,3882,-2309,360,1094
"4720","Westminster 003D","E01004728","E02000962","Westminster 003","E09000033","Westminster","E12000007","London",1558,1558,0,208,808,1.9,"00BK","Westminster",NA,13364,13561,22211,26536,12376,10547,19842,28519,-988,-3014,-2369,1983
"4721","Westminster 003E","E01004729","E02000962","Westminster 003","E09000033","Westminster","E12000007","London",1638,1638,0,270.7,856,1.9,"00BK","Westminster",NA,7339,6584,9840,20955,5920,3738,5680,26512,-1419,-2846,-4160,5557
"4711","Westminster 001D","E01004730","E02000960","Westminster 001","E09000033","Westminster","E12000007","London",1671,1665,6,37.1,804,2.1,"00BK","Westminster",NA,18229,28772,32052,32275,21045,22594,29916,30717,2816,-6178,-2136,-1558
"4809","Westminster 020A","E01004731","E02000979","Westminster 020","E09000033","Westminster","E12000007","London",1781,1658,123,26.4,910,1.8,"00BK","Westminster",NA,13204,18259,10894,26904,16929,22924,29982,13659,3725,4665,19088,-13245
"4810","Westminster 020B","E01004732","E02000979","Westminster 020","E09000033","Westminster","E12000007","London",1456,1314,142,208.6,697,1.9,"00BK","Westminster",NA,4487,6065,1429,16345,1598,1632,327,15221,-2889,-4433,-1102,-1124
"4811","Westminster 020C","E01004733","E02000979","Westminster 020","E09000033","Westminster","E12000007","London",2046,1796,250,45.3,926,1.9,"00BK","Westminster",NA,12798,15025,9363,22973,13801,16090,12342,28219,1003,1065,2979,5246
"4799","Westminster 018A","E01004734","E02000977","Westminster 018","E09000033","Westminster","E12000007","London",1972,1931,41,60.7,1104,1.7,"00BK","Westminster",NA,8236,13578,13384,26273,7056,12448,14577,28905,-1180,-1130,1193,2632
"4800","Westminster 018B","E01004735","E02000977","Westminster 018","E09000033","Westminster","E12000007","London",1829,1601,228,38.2,977,1.6,"00BK","Westminster",NA,7761,9488,9189,20681,8764,13661,11673,23103,1003,4173,2484,2422
"4801","Westminster 018C","E01004736","E02000977","Westminster 018","E09000033","Westminster","E12000007","London",1744,1265,479,14.7,729,1.7,"00BK","Westminster",NA,19869,32388,32453,31108,16419,32775,32811,20379,-3450,387,358,-10729
"4832","Westminster 024C","E01004737","E02000983","Westminster 024","E09000033","Westminster","E12000007","London",1301,1301,0,161.2,683,1.9,"00BK","Westminster",NA,14704,14924,19729,19214,13031,11504,13939,23213,-1673,-3420,-5790,3999
"4833","Westminster 024D","E01004738","E02000983","Westminster 024","E09000033","Westminster","E12000007","London",1351,1306,45,146.8,722,1.8,"00BK","Westminster",NA,17376,27213,27705,20458,18644,26307,29450,32625,1268,-906,1745,12167
"4834","Westminster 024E","E01004739","E02000983","Westminster 024","E09000033","Westminster","E12000007","London",1348,1348,0,463.2,950,1.4,"00BK","Westminster",NA,23570,27458,29076,27962,21239,25331,30324,32348,-2331,-2127,1248,4386
"4814","Westminster 021A","E01004740","E02000980","Westminster 021","E09000033","Westminster","E12000007","London",1494,1494,0,306.1,776,1.9,"00BK","Westminster",NA,6947,6014,8522,22487,4565,3889,6187,22925,-2382,-2125,-2335,438
"4835","Westminster 024F","E01004741","E02000983","Westminster 024","E09000033","Westminster","E12000007","London",1273,1273,0,226.1,698,1.8,"00BK","Westminster",NA,11582,11939,17131,26433,9189,10508,14545,24002,-2393,-1431,-2586,-2431
"4819","Westminster 022A","E01004742","E02000981","Westminster 022","E09000033","Westminster","E12000007","London",1391,1381,10,297.9,779,1.8,"00BK","Westminster",NA,15981,25578,26788,24118,19902,26539,27499,30991,3921,961,711,6873
"4815","Westminster 021B","E01004743","E02000980","Westminster 021","E09000033","Westminster","E12000007","London",1396,1396,0,284.9,713,2,"00BK","Westminster",NA,9316,8273,10046,19197,9539,7977,9734,25497,223,-296,-312,6300
"4812","Westminster 020D","E01004744","E02000979","Westminster 020","E09000033","Westminster","E12000007","London",1347,1311,36,124.5,744,1.8,"00BK","Westminster",NA,10166,12447,7814,23589,8323,9773,8572,26124,-1843,-2674,758,2535
"4816","Westminster 021C","E01004745","E02000980","Westminster 021","E09000033","Westminster","E12000007","London",2114,2114,0,104.8,1125,1.9,"00BK","Westminster",NA,13442,13506,16289,28482,14045,15127,17711,31067,603,1621,1422,2585
"4817","Westminster 021D","E01004746","E02000980","Westminster 021","E09000033","Westminster","E12000007","London",1440,1440,0,356.4,757,1.9,"00BK","Westminster",NA,6187,6224,6394,17135,4943,5857,6583,15587,-1244,-367,189,-1548
"4818","Westminster 021E","E01004747","E02000980","Westminster 021","E09000033","Westminster","E12000007","London",2240,2182,58,206.6,1127,1.9,"00BK","Westminster",NA,10204,9949,10913,27599,9341,9232,10868,29002,-863,-717,-45,1403
"4813","Westminster 020E","E01004748","E02000979","Westminster 020","E09000033","Westminster","E12000007","London",1451,1238,213,166.2,615,2,"00BK","Westminster",NA,14110,22117,10526,25874,19199,26241,28121,28713,5089,4124,17595,2839
"4820","Westminster 022B","E01004749","E02000981","Westminster 022","E09000033","Westminster","E12000007","London",2445,2337,108,177.6,1185,2,"00BK","Westminster",NA,15628,16376,18804,30670,16965,20706,25270,30160,1337,4330,6466,-510
"4827","Westminster 023E","E01004750","E02000982","Westminster 023","E09000033","Westminster","E12000007","London",1769,1741,28,69,951,1.8,"00BK","Westminster",NA,12131,12637,20182,24062,10083,6329,11868,26389,-2048,-6308,-8314,2327
"4821","Westminster 022C","E01004751","E02000981","Westminster 022","E09000033","Westminster","E12000007","London",1773,1768,5,210.6,943,1.9,"00BK","Westminster",NA,17913,24380,22337,30151,16354,20450,24294,29545,-1559,-3930,1957,-606
"4822","Westminster 022D","E01004752","E02000981","Westminster 022","E09000033","Westminster","E12000007","London",1569,1567,2,437,905,1.7,"00BK","Westminster",NA,8071,10711,8751,26734,9528,11439,9790,28226,1457,728,1039,1492
"4823","Westminster 022E","E01004753","E02000981","Westminster 022","E09000033","Westminster","E12000007","London",1813,1813,0,306.3,1041,1.7,"00BK","Westminster",NA,11862,15894,14585,30297,13632,15233,13671,29581,1770,-661,-914,-716
"4756","Westminster 010A","E01004754","E02000969","Westminster 010","E09000033","Westminster","E12000007","London",1629,1528,101,196.3,600,2.5,"00BK","Westminster",NA,1481,1285,4523,9818,641,251,1181,11723,-840,-1034,-3342,1905
"4757","Westminster 010B","E01004755","E02000969","Westminster 010","E09000033","Westminster","E12000007","London",2207,2147,60,191.9,963,2.2,"00BK","Westminster",NA,4579,2813,8633,23203,6294,4473,6105,22102,1715,1660,-2528,-1101
"4737","Westminster 006E","E01004756","E02000965","Westminster 006","E09000033","Westminster","E12000007","London",1800,1796,4,303,866,2.1,"00BK","Westminster",NA,6218,5702,8239,19239,9274,7864,10792,29238,3056,2162,2553,9999
"4758","Westminster 010C","E01004757","E02000969","Westminster 010","E09000033","Westminster","E12000007","London",1598,1594,4,129.3,600,2.7,"00BK","Westminster",NA,2610,1445,4943,15879,1484,835,2967,13563,-1126,-610,-1976,-2316
"4779","Westminster 014E","E01004760","E02000973","Westminster 014","E09000033","Westminster","E12000007","London",1630,1630,0,227,771,2.1,"00BK","Westminster",NA,5877,4694,8485,24695,7489,6399,9760,25408,1612,1705,1275,713
"4802","Westminster 018D","E01004761","E02000977","Westminster 018","E09000033","Westminster","E12000007","London",1945,1922,23,37.4,1085,1.8,"00BK","Westminster",NA,23359,31402,31837,26453,19747,32077,32042,24308,-3612,675,205,-2145
"4765","Westminster 011E","E01004762","E02000970","Westminster 011","E09000033","Westminster","E12000007","London",2070,2066,4,70.6,1136,1.8,"00BK","Westminster",NA,20059,26501,27611,28392,19920,27439,30279,28230,-139,938,2668,-162
"4772","Westminster 013B","E01004763","E02000972","Westminster 013","E09000033","Westminster","E12000007","London",2127,1731,396,72.4,1076,1.6,"00BK","Westminster",NA,6978,16386,8880,24367,7808,16500,15645,31945,830,114,6765,7578
"4773","Westminster 013D","E01004765","E02000972","Westminster 013","E09000033","Westminster","E12000007","London",2023,1967,56,75.5,1103,1.8,"00BK","Westminster",NA,13326,16198,16893,20557,12463,16973,17944,29085,-863,775,1051,8528
"4759","Westminster 010F","E01032512","E02000969","Westminster 010","E09000033","Westminster","E12000007","London",2540,2480,60,151.1,989,2.5,NA,NA,NA,NA,NA,NA,NA,1213,577,1596,14562,NA,NA,NA,NA
"4760","Westminster 010G","E01032513","E02000969","Westminster 010","E09000033","Westminster","E12000007","London",1355,1311,44,254.2,567,2.3,NA,NA,NA,NA,NA,NA,NA,1744,1060,2956,16867,NA,NA,NA,NA
"827","Bromley 040D","E01032562","E02006782","Bromley 040","E09000006","Bromley","E12000007","London",1507,1507,0,65.5,623,2.4,NA,NA,NA,NA,NA,NA,NA,5929,5042,4868,9202,NA,NA,NA,NA
"828","Bromley 040E","E01032563","E02006782","Bromley 040","E09000006","Bromley","E12000007","London",1483,1400,83,39.6,568,2.5,NA,NA,NA,NA,NA,NA,NA,26575,27201,27245,28830,NA,NA,NA,NA
"3379","Lewisham 037E","E01032564","E02006783","Lewisham 037","E09000023","Lewisham","E12000007","London",1312,1312,0,86,508,2.6,NA,NA,NA,NA,NA,NA,NA,3969,3502,4277,10295,NA,NA,NA,NA
"3384","Lewisham 038E","E01032565","E02006784","Lewisham 038","E09000023","Lewisham","E12000007","London",1392,1392,0,64.4,644,2.2,NA,NA,NA,NA,NA,NA,NA,4170,3278,4458,6136,NA,NA,NA,NA
"467","Bexley 029D","E01032566","E02006785","Bexley 029","E09000004","Bexley","E12000007","London",1684,1684,0,30.4,747,2.3,NA,NA,NA,NA,NA,NA,NA,10716,9360,9525,9619,NA,NA,NA,NA
"1703","Greenwich 033D","E01032567","E02006786","Greenwich 033","E09000011","Greenwich","E12000007","London",1651,1651,0,40,589,2.8,NA,NA,NA,NA,NA,NA,NA,16565,14667,17406,16759,NA,NA,NA,NA
"833","Bromley 041E","E01032568","E02006787","Bromley 041","E09000006","Bromley","E12000007","London",1488,1488,0,40.5,647,2.3,NA,NA,NA,NA,NA,NA,NA,8525,7080,8615,9763,NA,NA,NA,NA
"1196","Croydon 045E","E01032569","E02006788","Croydon 045","E09000008","Croydon","E12000007","London",1731,1731,0,55.3,660,2.6,NA,NA,NA,NA,NA,NA,NA,3594,2986,5340,4750,NA,NA,NA,NA
"837","Bromley 042D","E01032570","E02006789","Bromley 042","E09000006","Bromley","E12000007","London",1548,1541,7,34,669,2.3,NA,NA,NA,NA,NA,NA,NA,21472,16643,17450,20325,NA,NA,NA,NA
"1392","Ealing 040D","E01032572","E02006791","Ealing 040","E09000009","Ealing","E12000007","London",1575,1575,0,70.2,758,2.1,NA,NA,NA,NA,NA,NA,NA,18001,18396,23351,25660,NA,NA,NA,NA
"2718","Hounslow 029E","E01032573","E02006792","Hounslow 029","E09000018","Hounslow","E12000007","London",1614,1614,0,69.8,860,1.9,NA,NA,NA,NA,NA,NA,NA,20515,24752,27862,28562,NA,NA,NA,NA
"1575","Enfield 037E","E01032574","E02006793","Enfield 037","E09000010","Enfield","E12000007","London",2059,2059,0,56.5,695,3,NA,NA,NA,NA,NA,NA,NA,6764,5668,10911,7735,NA,NA,NA,NA
"2128","Haringey 037D","E01032575","E02006794","Haringey 037","E09000014","Haringey","E12000007","London",1908,1889,19,131.8,672,2.8,NA,NA,NA,NA,NA,NA,NA,2143,1913,3709,5531,NA,NA,NA,NA
"2256","Harrow 032E","E01032576","E02006795","Harrow 032","E09000015","Harrow","E12000007","London",1667,1667,0,73.7,520,3.2,NA,NA,NA,NA,NA,NA,NA,28529,23531,27268,30183,NA,NA,NA,NA
"2576","Hillingdon 033E","E01032577","E02006796","Hillingdon 033","E09000017","Hillingdon","E12000007","London",1683,1683,0,46.6,601,2.8,NA,NA,NA,NA,NA,NA,NA,22155,20592,21331,16027,NA,NA,NA,NA
"3389","Lewisham 039E","E01032579","E02006798","Lewisham 039","E09000023","Lewisham","E12000007","London",1460,1460,0,83.5,711,2.1,NA,NA,NA,NA,NA,NA,NA,3917,4741,5380,19894,NA,NA,NA,NA
"110","Barking and Dagenham 023F","E01032580","E02006799","Barking and Dagenham 023","E09000002","Barking and Dagenham","E12000007","London",1354,1354,0,105.9,471,2.9,NA,NA,NA,NA,NA,NA,NA,5427,3841,6493,12789,NA,NA,NA,NA
"3822","Redbridge 034G","E01032581","E02006800","Redbridge 034","E09000026","Redbridge","E12000007","London",1652,1652,0,57.1,699,2.4,NA,NA,NA,NA,NA,NA,NA,7776,6342,8106,14619,NA,NA,NA,NA
"3220","Lambeth 036E","E01032582","E02006801","Lambeth 036","E09000022","Lambeth","E12000007","London",1893,1893,0,59.6,920,2.1,NA,NA,NA,NA,NA,NA,NA,8167,11009,14029,16389,NA,NA,NA,NA
"4118","Southwark 034D","E01032583","E02006802","Southwark 034","E09000028","Southwark","E12000007","London",1587,1343,244,104.4,644,2.1,NA,NA,NA,NA,NA,NA,NA,9032,8831,10162,25329,NA,NA,NA,NA
"4119","Southwark 034E","E01032584","E02006802","Southwark 034","E09000028","Southwark","E12000007","London",1282,1275,7,147.7,577,2.2,NA,NA,NA,NA,NA,NA,NA,7807,8116,8041,23198,NA,NA,NA,NA
"4240","Sutton 025E","E01032623","E02006836","Sutton 025","E09000029","Sutton","E12000007","London",1825,1751,74,22.2,619,2.8,NA,NA,NA,NA,NA,NA,NA,31738,31695,31956,32381,NA,NA,NA,NA
"3966","Southwark 003F","E01032637","E02000809","Southwark 003","E09000028","Southwark","E12000007","London",1247,1080,167,311,641,1.7,NA,NA,NA,NA,NA,NA,NA,23977,32805,32829,24342,NA,NA,NA,NA
"3967","Southwark 003G","E01032638","E02000809","Southwark 003","E09000028","Southwark","E12000007","London",1159,1159,0,285.5,653,1.8,NA,NA,NA,NA,NA,NA,NA,29827,32799,32836,29826,NA,NA,NA,NA
"4019","Southwark 014F","E01032639","E02000820","Southwark 014","E09000028","Southwark","E12000007","London",1643,1509,134,184.4,688,2.2,NA,NA,NA,NA,NA,NA,NA,10990,14899,21921,20630,NA,NA,NA,NA
"3968","Southwark 003H","E01032640","E02000809","Southwark 003","E09000028","Southwark","E12000007","London",1248,1248,0,282.4,672,1.9,NA,NA,NA,NA,NA,NA,NA,27588,32769,32841,24781,NA,NA,NA,NA
"3969","Southwark 003I","E01032646","E02000809","Southwark 003","E09000028","Southwark","E12000007","London",1569,1569,0,127.7,737,2.1,NA,NA,NA,NA,NA,NA,NA,17462,20470,23222,28322,NA,NA,NA,NA
"4020","Southwark 014G","E01032719","E02000820","Southwark 014","E09000028","Southwark","E12000007","London",1211,1211,0,291.8,623,1.9,NA,NA,NA,NA,NA,NA,NA,6726,7372,9614,17440,NA,NA,NA,NA
"3996","Southwark 009F","E01032720","E02000815","Southwark 009","E09000028","Southwark","E12000007","London",1732,1656,76,101.9,681,2.4,NA,NA,NA,NA,NA,NA,NA,4667,8017,12798,15646,NA,NA,NA,NA
"4009","Southwark 012F","E01032722","E02000818","Southwark 012","E09000028","Southwark","E12000007","London",2133,2131,2,108.5,932,2.3,NA,NA,NA,NA,NA,NA,NA,4878,6756,9140,14964,NA,NA,NA,NA
"975","City of London 001F","E01032739","E02000001","City of London 001","E09000001","City of London","E12000007","London",1044,1002,42,6.3,676,1.5,NA,NA,NA,NA,NA,NA,NA,20497,32750,32793,31302,NA,NA,NA,NA
"976","City of London 001G","E01032740","E02000001","City of London 001","E09000001","City of London","E12000007","London",1099,1049,50,17.2,719,1.5,NA,NA,NA,NA,NA,NA,NA,18868,31643,31733,32835,NA,NA,NA,NA
"2331","Havering 013E","E01032741","E02000476","Havering 013","E09000016","Havering","E12000007","London",1078,1078,0,38.6,663,1.6,NA,NA,NA,NA,NA,NA,NA,14043,15203,21300,15399,NA,NA,NA,NA
"2332","Havering 013F","E01032742","E02000476","Havering 013","E09000016","Havering","E12000007","London",1310,1260,50,58,644,2,NA,NA,NA,NA,NA,NA,NA,10897,9545,11828,18794,NA,NA,NA,NA
"1244","Ealing 010F","E01032743","E02000247","Ealing 010","E09000009","Ealing","E12000007","London",2173,2173,0,226.8,818,2.7,NA,NA,NA,NA,NA,NA,NA,8979,5814,11708,17069,NA,NA,NA,NA
"1245","Ealing 010G","E01032744","E02000247","Ealing 010","E09000009","Ealing","E12000007","London",1526,1378,148,76.8,486,2.8,NA,NA,NA,NA,NA,NA,NA,6479,5759,10610,12160,NA,NA,NA,NA
"4257","Tower Hamlets 004E","E01032764","E02000867","Tower Hamlets 004","E09000030","Tower Hamlets","E12000007","London",1302,1302,0,40,643,2,NA,NA,NA,NA,NA,NA,NA,7235,7588,14079,22161,NA,NA,NA,NA
"4258","Tower Hamlets 004F","E01032765","E02000867","Tower Hamlets 004","E09000030","Tower Hamlets","E12000007","London",1488,1488,0,183.7,645,2.3,NA,NA,NA,NA,NA,NA,NA,5258,3510,7261,15778,NA,NA,NA,NA
"4332","Tower Hamlets 021E","E01032766","E02000884","Tower Hamlets 021","E09000030","Tower Hamlets","E12000007","London",1307,1307,0,162,601,2.2,NA,NA,NA,NA,NA,NA,NA,10232,12222,24432,16644,NA,NA,NA,NA
"4333","Tower Hamlets 021F","E01032767","E02000884","Tower Hamlets 021","E09000030","Tower Hamlets","E12000007","London",1584,1584,0,117.9,767,2.1,NA,NA,NA,NA,NA,NA,NA,16541,23817,31916,22478,NA,NA,NA,NA
"4349","Tower Hamlets 025E","E01032768","E02000888","Tower Hamlets 025","E09000030","Tower Hamlets","E12000007","London",1307,1307,0,185.1,696,1.9,NA,NA,NA,NA,NA,NA,NA,17971,28708,31293,25675,NA,NA,NA,NA
"4350","Tower Hamlets 025F","E01032769","E02000888","Tower Hamlets 025","E09000030","Tower Hamlets","E12000007","London",1235,1230,5,119.8,593,2.1,NA,NA,NA,NA,NA,NA,NA,12420,13171,21795,29660,NA,NA,NA,NA
"4377","Tower Hamlets 032B","E01032770","E02006853","Tower Hamlets 032","E09000030","Tower Hamlets","E12000007","London",1191,1191,0,271.9,572,2.1,NA,NA,NA,NA,NA,NA,NA,14561,15228,26819,25880,NA,NA,NA,NA
"4382","Tower Hamlets 033B","E01032771","E02006854","Tower Hamlets 033","E09000030","Tower Hamlets","E12000007","London",1104,1104,0,31.4,546,2,NA,NA,NA,NA,NA,NA,NA,13596,10914,20611,17768,NA,NA,NA,NA
"4378","Tower Hamlets 032C","E01032772","E02006853","Tower Hamlets 032","E09000030","Tower Hamlets","E12000007","London",1135,1135,0,139.4,544,2.1,NA,NA,NA,NA,NA,NA,NA,4753,3711,8282,21004,NA,NA,NA,NA
"4379","Tower Hamlets 032D","E01032773","E02006853","Tower Hamlets 032","E09000030","Tower Hamlets","E12000007","London",1561,1561,0,461.8,852,1.8,NA,NA,NA,NA,NA,NA,NA,11408,7753,23345,27385,NA,NA,NA,NA
"4380","Tower Hamlets 032E","E01032774","E02006853","Tower Hamlets 032","E09000030","Tower Hamlets","E12000007","London",1298,1297,1,63.6,583,2.2,NA,NA,NA,NA,NA,NA,NA,7690,7769,9835,14578,NA,NA,NA,NA
"4374","Tower Hamlets 031F","E01032775","E02000894","Tower Hamlets 031","E09000030","Tower Hamlets","E12000007","London",1108,1108,0,316.6,600,1.8,NA,NA,NA,NA,NA,NA,NA,22216,25030,29647,22859,NA,NA,NA,NA
"4361","Tower Hamlets 028E","E01032776","E02000891","Tower Hamlets 028","E09000030","Tower Hamlets","E12000007","London",1076,1076,0,133.5,631,1.7,NA,NA,NA,NA,NA,NA,NA,20502,30901,31892,25020,NA,NA,NA,NA
"4362","Tower Hamlets 028F","E01032777","E02000891","Tower Hamlets 028","E09000030","Tower Hamlets","E12000007","London",1141,1141,0,98.4,514,2.2,NA,NA,NA,NA,NA,NA,NA,12470,10537,17102,18507,NA,NA,NA,NA
"4363","Tower Hamlets 028G","E01032778","E02000891","Tower Hamlets 028","E09000030","Tower Hamlets","E12000007","London",1108,1108,0,35.4,564,2,NA,NA,NA,NA,NA,NA,NA,12847,19523,26505,13106,NA,NA,NA,NA
"4364","Tower Hamlets 028H","E01032779","E02000891","Tower Hamlets 028","E09000030","Tower Hamlets","E12000007","London",1089,1089,0,365.4,565,1.9,NA,NA,NA,NA,NA,NA,NA,15447,13847,29714,24716,NA,NA,NA,NA
"4365","Tower Hamlets 028I","E01032780","E02000891","Tower Hamlets 028","E09000030","Tower Hamlets","E12000007","London",1333,1333,0,37.8,647,2.1,NA,NA,NA,NA,NA,NA,NA,18301,24629,32383,28399,NA,NA,NA,NA
"4383","Tower Hamlets 033C","E01032781","E02006854","Tower Hamlets 033","E09000030","Tower Hamlets","E12000007","London",1535,1535,0,281.7,771,2,NA,NA,NA,NA,NA,NA,NA,20445,21030,28682,25786,NA,NA,NA,NA
"4384","Tower Hamlets 033D","E01032782","E02006854","Tower Hamlets 033","E09000030","Tower Hamlets","E12000007","London",1614,1614,0,210.4,776,2.1,NA,NA,NA,NA,NA,NA,NA,10260,7993,18520,20293,NA,NA,NA,NA
"4375","Tower Hamlets 031G","E01032783","E02000894","Tower Hamlets 031","E09000030","Tower Hamlets","E12000007","London",1383,1383,0,167.8,661,2.1,NA,NA,NA,NA,NA,NA,NA,15041,11425,19923,26732,NA,NA,NA,NA
"4259","Tower Hamlets 004G","E01032784","E02000867","Tower Hamlets 004","E09000030","Tower Hamlets","E12000007","London",1516,1516,0,234,692,2.2,NA,NA,NA,NA,NA,NA,NA,8299,6911,20569,22662,NA,NA,NA,NA
"4284","Tower Hamlets 010E","E01032785","E02000873","Tower Hamlets 010","E09000030","Tower Hamlets","E12000007","London",1348,1348,0,185.4,616,2.2,NA,NA,NA,NA,NA,NA,NA,9707,6352,13937,25495,NA,NA,NA,NA
"4285","Tower Hamlets 010F","E01032786","E02000873","Tower Hamlets 010","E09000030","Tower Hamlets","E12000007","London",1561,1561,0,267.8,674,2.3,NA,NA,NA,NA,NA,NA,NA,7544,6443,7946,17431,NA,NA,NA,NA
"4289","Tower Hamlets 011F","E01032787","E02000874","Tower Hamlets 011","E09000030","Tower Hamlets","E12000007","London",2567,2567,0,241.9,793,3.2,NA,NA,NA,NA,NA,NA,NA,3440,2946,7249,6965,NA,NA,NA,NA
"1973","Hammersmith and Fulham 023D","E01032788","E02000394","Hammersmith and Fulham 023","E09000013","Hammersmith and Fulham","E12000007","London",1106,1099,7,94.9,496,2.2,NA,NA,NA,NA,NA,NA,NA,9990,6853,12114,20684,NA,NA,NA,NA
"1974","Hammersmith and Fulham 023E","E01032789","E02000394","Hammersmith and Fulham 023","E09000013","Hammersmith and Fulham","E12000007","London",1151,1151,0,384.9,586,2,NA,NA,NA,NA,NA,NA,NA,15473,19253,25576,28587,NA,NA,NA,NA
"1975","Hammersmith and Fulham 023F","E01032790","E02000394","Hammersmith and Fulham 023","E09000013","Hammersmith and Fulham","E12000007","London",1118,1118,0,141.5,557,2,NA,NA,NA,NA,NA,NA,NA,13312,8619,23453,27522,NA,NA,NA,NA
"3970","Southwark 003J","E01032803","E02000809","Southwark 003","E09000028","Southwark","E12000007","London",1331,1331,0,220.4,658,2,NA,NA,NA,NA,NA,NA,NA,14791,18777,27844,27533,NA,NA,NA,NA
"4060","Southwark 022F","E01032805","E02000828","Southwark 022","E09000028","Southwark","E12000007","London",2551,2538,13,146.2,940,2.7,NA,NA,NA,NA,NA,NA,NA,4166,3151,5116,12539,NA,NA,NA,NA
"3971","Southwark 003K","E01032834","E02000809","Southwark 003","E09000028","Southwark","E12000007","London",1130,1122,8,321,666,1.7,NA,NA,NA,NA,NA,NA,NA,23002,32739,32809,15266,NA,NA,NA,NA
"2698","Hounslow 025F","E01033000","E02000550","Hounslow 025","E09000018","Hounslow","E12000007","London",1785,1785,0,212.2,663,2.7,NA,NA,NA,NA,NA,NA,NA,4942,4590,7052,7996,NA,NA,NA,NA
"2699","Hounslow 025G","E01033030","E02000550","Hounslow 025","E09000018","Hounslow","E12000007","London",1723,1723,0,239,773,2.2,NA,NA,NA,NA,NA,NA,NA,14529,18569,27968,15352,NA,NA,NA,NA
"2586","Hounslow 003F","E01033081","E02000528","Hounslow 003","E09000018","Hounslow","E12000007","London",1242,1242,0,125.5,649,1.9,NA,NA,NA,NA,NA,NA,NA,11224,11358,13650,19920,NA,NA,NA,NA
"2587","Hounslow 003G","E01033082","E02000528","Hounslow 003","E09000018","Hounslow","E12000007","London",1223,1223,0,50.2,659,1.9,NA,NA,NA,NA,NA,NA,NA,9916,8418,13855,24618,NA,NA,NA,NA
"2661","Hounslow 018F","E01033083","E02000543","Hounslow 018","E09000018","Hounslow","E12000007","London",1664,1664,0,122.5,643,2.6,NA,NA,NA,NA,NA,NA,NA,16971,28413,32345,30955,NA,NA,NA,NA
"2662","Hounslow 018G","E01033084","E02000543","Hounslow 018","E09000018","Hounslow","E12000007","London",1722,1711,11,127.4,648,2.6,NA,NA,NA,NA,NA,NA,NA,8861,15540,18021,17769,NA,NA,NA,NA
"2059","Haringey 020E","E01033085","E02000416","Haringey 020","E09000014","Haringey","E12000007","London",1780,1780,0,113.9,908,2,NA,NA,NA,NA,NA,NA,NA,5606,8427,14193,16486,NA,NA,NA,NA
"2060","Haringey 020F","E01033086","E02000416","Haringey 020","E09000014","Haringey","E12000007","London",1091,1091,0,180.9,488,2.2,NA,NA,NA,NA,NA,NA,NA,2086,1091,2605,6332,NA,NA,NA,NA
"4577","Wandsworth 010F","E01033093","E02000932","Wandsworth 010","E09000032","Wandsworth","E12000007","London",1526,1526,0,55.6,766,2,NA,NA,NA,NA,NA,NA,NA,22359,32193,31007,30849,NA,NA,NA,NA
"4537","Wandsworth 002F","E01033098","E02000924","Wandsworth 002","E09000032","Wandsworth","E12000007","London",1012,1009,3,30.8,629,1.6,NA,NA,NA,NA,NA,NA,NA,15470,32592,32814,14141,NA,NA,NA,NA
"4547","Wandsworth 004E","E01033099","E02000926","Wandsworth 004","E09000032","Wandsworth","E12000007","London",1028,1028,0,99.2,456,2.3,NA,NA,NA,NA,NA,NA,NA,10199,7760,16379,25787,NA,NA,NA,NA
"4538","Wandsworth 002G","E01033100","E02000924","Wandsworth 002","E09000032","Wandsworth","E12000007","London",1243,1243,0,108.7,612,2,NA,NA,NA,NA,NA,NA,NA,8082,8289,11931,22610,NA,NA,NA,NA
"4548","Wandsworth 004F","E01033101","E02000926","Wandsworth 004","E09000032","Wandsworth","E12000007","London",1191,1191,0,94.2,663,1.8,NA,NA,NA,NA,NA,NA,NA,26445,30240,30709,31032,NA,NA,NA,NA
"4539","Wandsworth 002H","E01033132","E02000924","Wandsworth 002","E09000032","Wandsworth","E12000007","London",1040,1040,0,39.3,619,1.7,NA,NA,NA,NA,NA,NA,NA,9229,12956,21325,16459,NA,NA,NA,NA
"4549","Wandsworth 004G","E01033133","E02000926","Wandsworth 004","E09000032","Wandsworth","E12000007","London",1193,1193,0,200.2,636,1.9,NA,NA,NA,NA,NA,NA,NA,21069,21332,29162,31399,NA,NA,NA,NA
"4578","Wandsworth 010G","E01033135","E02000932","Wandsworth 010","E09000032","Wandsworth","E12000007","London",1071,1071,0,106.1,475,2.3,NA,NA,NA,NA,NA,NA,NA,28966,32444,32636,32779,NA,NA,NA,NA
"1515","Enfield 025F","E01033146","E02000301","Enfield 025","E09000010","Enfield","E12000007","London",1586,1586,0,114.6,593,2.7,NA,NA,NA,NA,NA,NA,NA,3294,1896,5109,6026,NA,NA,NA,NA
"1406","Enfield 003F","E01033148","E02000279","Enfield 003","E09000010","Enfield","E12000007","London",1950,1950,0,43.3,661,3,NA,NA,NA,NA,NA,NA,NA,4362,2575,6452,9388,NA,NA,NA,NA
"1407","Enfield 003G","E01033150","E02000279","Enfield 003","E09000010","Enfield","E12000007","London",1656,1656,0,100.8,702,2.4,NA,NA,NA,NA,NA,NA,NA,7248,3007,11349,13083,NA,NA,NA,NA
"1516","Enfield 025G","E01033151","E02000301","Enfield 025","E09000010","Enfield","E12000007","London",1483,1483,0,22.3,541,2.7,NA,NA,NA,NA,NA,NA,NA,3556,1954,4258,5769,NA,NA,NA,NA
"4486","Waltham Forest 020G","E01033153","E02000914","Waltham Forest 020","E09000031","Waltham Forest","E12000007","London",2616,2614,2,161.4,936,2.8,NA,NA,NA,NA,NA,NA,NA,2438,984,3300,6718,NA,NA,NA,NA
"3057","Lambeth 004F","E01033207","E02000621","Lambeth 004","E09000022","Lambeth","E12000007","London",1708,1635,73,70.7,766,2.1,NA,NA,NA,NA,NA,NA,NA,2943,5160,5278,16441,NA,NA,NA,NA
"3058","Lambeth 004G","E01033208","E02000621","Lambeth 004","E09000022","Lambeth","E12000007","London",1723,1723,0,344.6,1018,1.7,NA,NA,NA,NA,NA,NA,NA,10754,15021,22627,30627,NA,NA,NA,NA
"3294","Lewisham 017E","E01033320","E02000669","Lewisham 017","E09000023","Lewisham","E12000007","London",1496,1463,33,102,645,2.3,NA,NA,NA,NA,NA,NA,NA,13032,11387,12949,23096,NA,NA,NA,NA
"3295","Lewisham 017F","E01033322","E02000669","Lewisham 017","E09000023","Lewisham","E12000007","London",1267,1238,29,181,594,2.1,NA,NA,NA,NA,NA,NA,NA,15070,13079,19907,22341,NA,NA,NA,NA
"3254","Lewisham 008E","E01033324","E02000660","Lewisham 008","E09000023","Lewisham","E12000007","London",1597,1597,0,89,642,2.5,NA,NA,NA,NA,NA,NA,NA,6919,8261,10280,18088,NA,NA,NA,NA
"3255","Lewisham 008F","E01033325","E02000660","Lewisham 008","E09000023","Lewisham","E12000007","London",1205,1205,0,198.2,706,1.7,NA,NA,NA,NA,NA,NA,NA,14997,26023,32353,31050,NA,NA,NA,NA
"3273","Lewisham 012F","E01033327","E02000664","Lewisham 012","E09000023","Lewisham","E12000007","London",1527,1507,20,46.9,679,2.2,NA,NA,NA,NA,NA,NA,NA,5988,11832,11047,22983,NA,NA,NA,NA
"3274","Lewisham 012G","E01033341","E02000664","Lewisham 012","E09000023","Lewisham","E12000007","London",1303,1298,5,102.2,551,2.4,NA,NA,NA,NA,NA,NA,NA,6321,5841,9370,17325,NA,NA,NA,NA
"552","Brent 017F","E01033424","E02000109","Brent 017","E09000005","Brent","E12000007","London",1508,1358,150,35.1,638,2.1,NA,NA,NA,NA,NA,NA,NA,10426,9790,16727,22289,NA,NA,NA,NA
"624","Brent 031G","E01033455","E02000123","Brent 031","E09000005","Brent","E12000007","London",1189,1151,38,191.5,501,2.3,NA,NA,NA,NA,NA,NA,NA,2293,4035,4980,5302,NA,NA,NA,NA
"603","Brent 027F","E01033456","E02000119","Brent 027","E09000005","Brent","E12000007","London",2208,2200,8,83.4,743,3,NA,NA,NA,NA,NA,NA,NA,1534,369,1137,10241,NA,NA,NA,NA
"553","Brent 017G","E01033457","E02000109","Brent 017","E09000005","Brent","E12000007","London",1712,1700,12,95.1,562,3,NA,NA,NA,NA,NA,NA,NA,16629,20552,25599,24367,NA,NA,NA,NA
"483","Brent 003G","E01033463","E02000095","Brent 003","E09000005","Brent","E12000007","London",2939,2805,134,70.2,848,3.3,NA,NA,NA,NA,NA,NA,NA,18192,15885,20235,23803,NA,NA,NA,NA
"517","Brent 010F","E01033464","E02000102","Brent 010","E09000005","Brent","E12000007","London",3022,3018,4,125.3,813,3.7,NA,NA,NA,NA,NA,NA,NA,7812,5230,7945,8593,NA,NA,NA,NA
"625","Brent 031H","E01033485","E02000123","Brent 031","E09000005","Brent","E12000007","London",1991,1982,9,137.8,789,2.5,NA,NA,NA,NA,NA,NA,NA,3631,4910,4978,9458,NA,NA,NA,NA
"2773","Islington 011E","E01033486","E02000564","Islington 011","E09000019","Islington","E12000007","London",1036,1022,14,155.3,425,2.4,NA,NA,NA,NA,NA,NA,NA,4442,4837,4939,13967,NA,NA,NA,NA
"2774","Islington 011F","E01033487","E02000564","Islington 011","E09000019","Islington","E12000007","London",1226,1226,0,502.5,595,2.1,NA,NA,NA,NA,NA,NA,NA,19644,20444,32228,28251,NA,NA,NA,NA
"2775","Islington 011G","E01033488","E02000564","Islington 011","E09000019","Islington","E12000007","London",1205,1205,0,119.8,557,2.2,NA,NA,NA,NA,NA,NA,NA,5149,6099,9996,17052,NA,NA,NA,NA
"2835","Islington 022G","E01033489","E02000575","Islington 022","E09000019","Islington","E12000007","London",1832,1288,544,194.1,776,1.7,NA,NA,NA,NA,NA,NA,NA,15583,25696,32030,13418,NA,NA,NA,NA
"2836","Islington 022H","E01033490","E02000575","Islington 022","E09000019","Islington","E12000007","London",1693,1232,461,141,703,1.8,NA,NA,NA,NA,NA,NA,NA,11372,15378,25331,19276,NA,NA,NA,NA
"2776","Islington 011H","E01033491","E02000564","Islington 011","E09000019","Islington","E12000007","London",1680,1680,0,89.6,869,1.9,NA,NA,NA,NA,NA,NA,NA,5216,6396,8894,24154,NA,NA,NA,NA
"2777","Islington 011I","E01033492","E02000564","Islington 011","E09000019","Islington","E12000007","London",1348,1348,0,90.2,687,2,NA,NA,NA,NA,NA,NA,NA,9642,19090,27325,21535,NA,NA,NA,NA
"2751","Islington 006F","E01033493","E02000559","Islington 006","E09000019","Islington","E12000007","London",1301,1301,0,359.4,701,1.9,NA,NA,NA,NA,NA,NA,NA,23836,30417,32721,20003,NA,NA,NA,NA
"2752","Islington 006G","E01033494","E02000559","Islington 006","E09000019","Islington","E12000007","London",1498,1498,0,140.5,630,2.4,NA,NA,NA,NA,NA,NA,NA,15406,17287,21362,30846,NA,NA,NA,NA
"2964","Kingston upon Thames 004F","E01033568","E02000601","Kingston upon Thames 004","E09000021","Kingston upon Thames","E12000007","London",1461,1461,0,112.3,718,2,NA,NA,NA,NA,NA,NA,NA,22442,16809,27291,31648,NA,NA,NA,NA
"2965","Kingston upon Thames 004G","E01033569","E02000601","Kingston upon Thames 004","E09000021","Kingston upon Thames","E12000007","London",1662,1564,98,99.3,696,2.2,NA,NA,NA,NA,NA,NA,NA,27719,29063,29892,29268,NA,NA,NA,NA
"3864","Richmond upon Thames 004G","E01033570","E02000787","Richmond upon Thames 004","E09000027","Richmond upon Thames","E12000007","London",1552,1552,0,32.8,709,2.2,NA,NA,NA,NA,NA,NA,NA,19676,20905,27834,29133,NA,NA,NA,NA
"3865","Richmond upon Thames 004H","E01033571","E02000787","Richmond upon Thames 004","E09000027","Richmond upon Thames","E12000007","London",1538,1538,0,45.7,624,2.5,NA,NA,NA,NA,NA,NA,NA,19410,15662,18276,27905,NA,NA,NA,NA
"265","Barnet 030E","E01033572","E02000053","Barnet 030","E09000003","Barnet","E12000007","London",1588,1588,0,23.2,571,2.8,NA,NA,NA,NA,NA,NA,NA,12733,7473,16640,17741,NA,NA,NA,NA
"266","Barnet 030F","E01033573","E02000053","Barnet 030","E09000003","Barnet","E12000007","London",1622,1192,430,115.8,607,2,NA,NA,NA,NA,NA,NA,NA,14259,14939,27690,26556,NA,NA,NA,NA
"3658","Newham 034F","E01033574","E02000747","Newham 034","E09000025","Newham","E12000007","London",1095,1095,0,81.7,579,1.9,NA,NA,NA,NA,NA,NA,NA,16658,32101,32816,13933,NA,NA,NA,NA
"3659","Newham 034G","E01033575","E02000747","Newham 034","E09000025","Newham","E12000007","London",1021,1021,0,66.3,545,1.9,NA,NA,NA,NA,NA,NA,NA,16502,31531,32782,26467,NA,NA,NA,NA
"3660","Newham 034H","E01033576","E02000747","Newham 034","E09000025","Newham","E12000007","London",1295,1295,0,34.3,618,2.1,NA,NA,NA,NA,NA,NA,NA,10589,14284,23756,15062,NA,NA,NA,NA
"3674","Newham 037E","E01033577","E02000750","Newham 037","E09000025","Newham","E12000007","London",1489,1489,0,22.6,608,2.4,NA,NA,NA,NA,NA,NA,NA,15432,13006,21943,17884,NA,NA,NA,NA
"3566","Newham 013E","E01033578","E02000726","Newham 013","E09000025","Newham","E12000007","London",1273,1273,0,22.4,603,2.1,NA,NA,NA,NA,NA,NA,NA,4925,6932,15350,15432,NA,NA,NA,NA
"3567","Newham 013F","E01033579","E02000726","Newham 013","E09000025","Newham","E12000007","London",1293,1293,0,29.4,618,2.1,NA,NA,NA,NA,NA,NA,NA,12936,20671,27512,30295,NA,NA,NA,NA
"3675","Newham 037F","E01033580","E02000750","Newham 037","E09000025","Newham","E12000007","London",1522,1522,0,181.4,659,2.3,NA,NA,NA,NA,NA,NA,NA,23575,31105,32325,22841,NA,NA,NA,NA
"3676","Newham 037G","E01033581","E02000750","Newham 037","E09000025","Newham","E12000007","London",1782,1782,0,13.6,714,2.5,NA,NA,NA,NA,NA,NA,NA,6200,5868,8183,17588,NA,NA,NA,NA
"3677","Newham 037H","E01033582","E02000750","Newham 037","E09000025","Newham","E12000007","London",1381,1381,0,84.6,631,2.2,NA,NA,NA,NA,NA,NA,NA,18020,26624,32045,28610,NA,NA,NA,NA
"3568","Newham 013G","E01033583","E02000726","Newham 013","E09000025","Newham","E12000007","London",3081,3063,18,19.5,1205,2.5,NA,NA,NA,NA,NA,NA,NA,7511,11167,16339,18679,NA,NA,NA,NA
"3661","Newham 034I","E01033584","E02000747","Newham 034","E09000025","Newham","E12000007","London",1595,1595,0,105.9,564,2.8,NA,NA,NA,NA,NA,NA,NA,3098,1745,5956,9898,NA,NA,NA,NA
"3662","Newham 034J","E01033585","E02000747","Newham 034","E09000025","Newham","E12000007","London",2445,2445,0,83.4,954,2.6,NA,NA,NA,NA,NA,NA,NA,3139,3362,5794,11531,NA,NA,NA,NA
"3569","Newham 013H","E01033586","E02000726","Newham 013","E09000025","Newham","E12000007","London",1410,1410,0,20,597,2.4,NA,NA,NA,NA,NA,NA,NA,5307,4972,9597,16683,NA,NA,NA,NA
"99","Barking and Dagenham 021E","E01033587","E02000022","Barking and Dagenham 021","E09000002","Barking and Dagenham","E12000007","London",1630,1573,57,61.3,631,2.5,NA,NA,NA,NA,NA,NA,NA,5615,6582,9903,14749,NA,NA,NA,NA
"100","Barking and Dagenham 021F","E01033588","E02000022","Barking and Dagenham 021","E09000002","Barking and Dagenham","E12000007","London",1617,1581,36,115.9,618,2.6,NA,NA,NA,NA,NA,NA,NA,4907,4811,8372,11036,NA,NA,NA,NA
"3798","Redbridge 030H","E01033589","E02000780","Redbridge 030","E09000026","Redbridge","E12000007","London",1676,1676,0,137.5,660,2.5,NA,NA,NA,NA,NA,NA,NA,12438,20291,29218,26837,NA,NA,NA,NA
"3762","Redbridge 019H","E01033590","E02000769","Redbridge 019","E09000026","Redbridge","E12000007","London",1111,1098,13,113.7,434,2.5,NA,NA,NA,NA,NA,NA,NA,10680,7298,13367,14981,NA,NA,NA,NA
"3799","Redbridge 030I","E01033591","E02000780","Redbridge 030","E09000026","Redbridge","E12000007","London",1908,1898,10,75,630,3,NA,NA,NA,NA,NA,NA,NA,6065,4982,8236,12470,NA,NA,NA,NA
"3763","Redbridge 019I","E01033592","E02000769","Redbridge 019","E09000026","Redbridge","E12000007","London",1908,1908,0,126.4,633,3,NA,NA,NA,NA,NA,NA,NA,15029,12576,18782,23243,NA,NA,NA,NA
"4786","Westminster 015F","E01033593","E02000974","Westminster 015","E09000033","Westminster","E12000007","London",1130,1130,0,122.4,645,1.8,NA,NA,NA,NA,NA,NA,NA,6880,9104,19261,23854,NA,NA,NA,NA
"4787","Westminster 015G","E01033594","E02000974","Westminster 015","E09000033","Westminster","E12000007","London",1368,1280,88,65.1,711,1.8,NA,NA,NA,NA,NA,NA,NA,6674,8142,10592,22564,NA,NA,NA,NA
"4774","Westminster 013E","E01033595","E02000972","Westminster 013","E09000033","Westminster","E12000007","London",1175,1174,1,22.9,755,1.6,NA,NA,NA,NA,NA,NA,NA,11373,21601,22642,13427,NA,NA,NA,NA
"4775","Westminster 013F","E01033596","E02000972","Westminster 013","E09000033","Westminster","E12000007","London",1235,1231,4,114.7,745,1.7,NA,NA,NA,NA,NA,NA,NA,7048,9244,12881,28528,NA,NA,NA,NA
"4828","Westminster 023F","E01033597","E02000982","Westminster 023","E09000033","Westminster","E12000007","London",990,990,0,168.9,621,1.6,NA,NA,NA,NA,NA,NA,NA,6515,10020,7669,25158,NA,NA,NA,NA
"4750","Westminster 009F","E01033598","E02000968","Westminster 009","E09000033","Westminster","E12000007","London",1242,1242,0,233.9,502,2.5,NA,NA,NA,NA,NA,NA,NA,785,354,856,9818,NA,NA,NA,NA
"4829","Westminster 023G","E01033599","E02000982","Westminster 023","E09000033","Westminster","E12000007","London",1573,1573,0,239.1,630,2.5,NA,NA,NA,NA,NA,NA,NA,3831,1909,5952,16035,NA,NA,NA,NA
"4742","Westminster 007F","E01033600","E02000966","Westminster 007","E09000033","Westminster","E12000007","London",1224,1224,0,192.5,644,1.9,NA,NA,NA,NA,NA,NA,NA,17305,20588,21499,29290,NA,NA,NA,NA
"4751","Westminster 009G","E01033601","E02000968","Westminster 009","E09000033","Westminster","E12000007","London",1569,1569,0,287.9,589,2.7,NA,NA,NA,NA,NA,NA,NA,4179,3406,6056,13987,NA,NA,NA,NA
"4752","Westminster 009H","E01033602","E02000968","Westminster 009","E09000033","Westminster","E12000007","London",1625,1625,0,280.2,645,2.5,NA,NA,NA,NA,NA,NA,NA,1692,720,2765,11915,NA,NA,NA,NA
"4753","Westminster 009I","E01033603","E02000968","Westminster 009","E09000033","Westminster","E12000007","London",1333,1217,116,267.7,600,2,NA,NA,NA,NA,NA,NA,NA,2473,2876,1899,23127,NA,NA,NA,NA
"4754","Westminster 009J","E01033604","E02000968","Westminster 009","E09000033","Westminster","E12000007","London",1236,1236,0,171.4,620,2,NA,NA,NA,NA,NA,NA,NA,2594,4301,4519,17393,NA,NA,NA,NA
"4755","Westminster 009K","E01033605","E02000968","Westminster 009","E09000033","Westminster","E12000007","London",2046,2004,42,277.6,815,2.5,NA,NA,NA,NA,NA,NA,NA,1411,977,2239,13400,NA,NA,NA,NA
"4780","Westminster 014F","E01033606","E02000973","Westminster 014","E09000033","Westminster","E12000007","London",1068,1064,4,394.1,614,1.7,NA,NA,NA,NA,NA,NA,NA,11467,17147,19080,19510,NA,NA,NA,NA
"4781","Westminster 014G","E01033607","E02000973","Westminster 014","E09000033","Westminster","E12000007","London",1199,1193,6,143.9,616,1.9,NA,NA,NA,NA,NA,NA,NA,8772,12164,12929,30977,NA,NA,NA,NA
"4743","Westminster 007G","E01033608","E02000966","Westminster 007","E09000033","Westminster","E12000007","London",1416,1369,47,269.7,735,1.9,NA,NA,NA,NA,NA,NA,NA,13230,15518,16122,31038,NA,NA,NA,NA
"1824","Hackney 021F","E01033698","E02000365","Hackney 021","E09000012","Hackney","E12000007","London",1259,1259,0,208.8,613,2.1,NA,NA,NA,NA,NA,NA,NA,3438,2455,5127,14361,NA,NA,NA,NA
"1825","Hackney 021G","E01033699","E02000365","Hackney 021","E09000012","Hackney","E12000007","London",1217,1217,0,129.2,585,2.1,NA,NA,NA,NA,NA,NA,NA,6924,10348,12664,26995,NA,NA,NA,NA
"1826","Hackney 021H","E01033700","E02000365","Hackney 021","E09000012","Hackney","E12000007","London",1566,1510,56,142.4,697,2.2,NA,NA,NA,NA,NA,NA,NA,5827,8662,11644,19859,NA,NA,NA,NA
"1735","Hackney 002F","E01033701","E02000346","Hackney 002","E09000012","Hackney","E12000007","London",1849,1818,31,74.1,760,2.4,NA,NA,NA,NA,NA,NA,NA,1634,1828,3772,6920,NA,NA,NA,NA
"1864","Hackney 028C","E01033702","E02006918","Hackney 028","E09000012","Hackney","E12000007","London",1193,1193,0,119.2,480,2.5,NA,NA,NA,NA,NA,NA,NA,4232,2449,6812,12992,NA,NA,NA,NA
"1770","Hackney 010F","E01033703","E02000354","Hackney 010","E09000012","Hackney","E12000007","London",1410,1395,15,215.6,625,2.2,NA,NA,NA,NA,NA,NA,NA,4283,4788,6923,21810,NA,NA,NA,NA
"1837","Hackney 023F","E01033704","E02000367","Hackney 023","E09000012","Hackney","E12000007","London",1631,1631,0,74.5,763,2.1,NA,NA,NA,NA,NA,NA,NA,9396,14971,18636,28511,NA,NA,NA,NA
"1865","Hackney 028D","E01033705","E02006918","Hackney 028","E09000012","Hackney","E12000007","London",1417,1417,0,88.5,576,2.5,NA,NA,NA,NA,NA,NA,NA,4529,4674,8078,18535,NA,NA,NA,NA
"1858","Hackney 027F","E01033706","E02000371","Hackney 027","E09000012","Hackney","E12000007","London",1539,1539,0,114,764,2,NA,NA,NA,NA,NA,NA,NA,9051,23086,31108,19071,NA,NA,NA,NA
"1827","Hackney 021I","E01033707","E02000365","Hackney 021","E09000012","Hackney","E12000007","London",1303,1303,0,125.9,614,2.1,NA,NA,NA,NA,NA,NA,NA,4611,7084,10586,23549,NA,NA,NA,NA
"1859","Hackney 027G","E01033708","E02000371","Hackney 027","E09000012","Hackney","E12000007","London",1599,1509,90,44.8,862,1.8,NA,NA,NA,NA,NA,NA,NA,13223,26048,31284,25221,NA,NA,NA,NA
"1860","Hackney 027H","E01033709","E02000371","Hackney 027","E09000012","Hackney","E12000007","London",1670,1599,71,190.2,789,2,NA,NA,NA,NA,NA,NA,NA,7557,9338,15663,20627,NA,NA,NA,NA
"1866","Hackney 028E","E01033710","E02006918","Hackney 028","E09000012","Hackney","E12000007","London",1159,1159,0,274,532,2.2,NA,NA,NA,NA,NA,NA,NA,7321,6754,15108,9516,NA,NA,NA,NA
"1861","Hackney 027I","E01033711","E02000371","Hackney 027","E09000012","Hackney","E12000007","London",1105,943,162,143.3,501,1.9,NA,NA,NA,NA,NA,NA,NA,13769,17452,30935,27144,NA,NA,NA,NA
"1838","Hackney 023G","E01033712","E02000367","Hackney 023","E09000012","Hackney","E12000007","London",1578,1578,0,97.2,661,2.4,NA,NA,NA,NA,NA,NA,NA,5841,7621,12228,22975,NA,NA,NA,NA
"1771","Hackney 010G","E01033713","E02000354","Hackney 010","E09000012","Hackney","E12000007","London",1346,1324,22,51.4,601,2.2,NA,NA,NA,NA,NA,NA,NA,4274,7307,8363,16208,NA,NA,NA,NA
"2488","Hillingdon 016F","E01033724","E02000509","Hillingdon 016","E09000017","Hillingdon","E12000007","London",4933,2761,2172,61.8,1051,2.6,NA,NA,NA,NA,NA,NA,NA,24212,21362,29708,22569,NA,NA,NA,NA
"2484","Hillingdon 015F","E01033725","E02000508","Hillingdon 015","E09000017","Hillingdon","E12000007","London",2386,2350,36,26,945,2.5,NA,NA,NA,NA,NA,NA,NA,11884,10509,14820,17957,NA,NA,NA,NA
"1708","Greenwich 034E","E01033726","E02006927","Greenwich 034","E09000011","Greenwich","E12000007","London",2493,2439,54,24.2,818,3,NA,NA,NA,NA,NA,NA,NA,5352,4522,5304,9494,NA,NA,NA,NA
"1710","Greenwich 035B","E01033727","E02006928","Greenwich 035","E09000011","Greenwich","E12000007","London",2567,1861,706,163.6,802,2.3,NA,NA,NA,NA,NA,NA,NA,11440,8658,15299,18644,NA,NA,NA,NA
"1711","Greenwich 035C","E01033728","E02006928","Greenwich 035","E09000011","Greenwich","E12000007","London",1226,1226,0,160.5,641,1.9,NA,NA,NA,NA,NA,NA,NA,22634,27735,32672,28133,NA,NA,NA,NA
"1691","Greenwich 030E","E01033729","E02000342","Greenwich 030","E09000011","Greenwich","E12000007","London",2969,1895,1074,43,802,2.4,NA,NA,NA,NA,NA,NA,NA,10198,8105,13573,5780,NA,NA,NA,NA
"1712","Greenwich 035D","E01033730","E02006928","Greenwich 035","E09000011","Greenwich","E12000007","London",1214,1214,0,71.8,653,1.9,NA,NA,NA,NA,NA,NA,NA,10858,11102,18583,29913,NA,NA,NA,NA
"1595","Greenwich 004E","E01033731","E02000316","Greenwich 004","E09000011","Greenwich","E12000007","London",1017,1017,0,49.7,559,1.8,NA,NA,NA,NA,NA,NA,NA,13562,23102,30864,20111,NA,NA,NA,NA
"1716","Greenwich 036D","E01033732","E02006929","Greenwich 036","E09000011","Greenwich","E12000007","London",1053,1053,0,99.7,472,2.2,NA,NA,NA,NA,NA,NA,NA,14168,12478,20056,26340,NA,NA,NA,NA
"1717","Greenwich 036E","E01033733","E02006929","Greenwich 036","E09000011","Greenwich","E12000007","London",1134,1134,0,27.1,548,2.1,NA,NA,NA,NA,NA,NA,NA,20651,26187,32082,15897,NA,NA,NA,NA
"1596","Greenwich 004F","E01033734","E02000316","Greenwich 004","E09000011","Greenwich","E12000007","London",1320,1320,0,135,579,2.3,NA,NA,NA,NA,NA,NA,NA,15955,14478,24830,21217,NA,NA,NA,NA
"1597","Greenwich 004G","E01033735","E02000316","Greenwich 004","E09000011","Greenwich","E12000007","London",1073,1073,0,103.1,555,1.9,NA,NA,NA,NA,NA,NA,NA,6655,9309,14076,19552,NA,NA,NA,NA
"1598","Greenwich 004H","E01033736","E02000316","Greenwich 004","E09000011","Greenwich","E12000007","London",1125,1125,0,87.6,608,1.9,NA,NA,NA,NA,NA,NA,NA,19297,27381,31847,12776,NA,NA,NA,NA
"1599","Greenwich 004I","E01033737","E02000316","Greenwich 004","E09000011","Greenwich","E12000007","London",1495,1495,0,63.3,602,2.5,NA,NA,NA,NA,NA,NA,NA,4599,3446,5020,12466,NA,NA,NA,NA
"1721","Greenwich 037D","E01033738","E02006930","Greenwich 037","E09000011","Greenwich","E12000007","London",1216,1216,0,42,519,2.3,NA,NA,NA,NA,NA,NA,NA,16709,18434,22362,25127,NA,NA,NA,NA
"1582","Greenwich 002E","E01033739","E02000314","Greenwich 002","E09000011","Greenwich","E12000007","London",1443,1443,0,122.8,571,2.5,NA,NA,NA,NA,NA,NA,NA,12495,11136,17200,25529,NA,NA,NA,NA
"1583","Greenwich 002F","E01033740","E02000314","Greenwich 002","E09000011","Greenwich","E12000007","London",1577,1577,0,95.3,550,2.9,NA,NA,NA,NA,NA,NA,NA,13346,9097,17416,27229,NA,NA,NA,NA
"1584","Greenwich 002G","E01033741","E02000314","Greenwich 002","E09000011","Greenwich","E12000007","London",2457,1681,776,43.1,559,3,NA,NA,NA,NA,NA,NA,NA,13737,10079,16062,16041,NA,NA,NA,NA
"1614","Greenwich 007F","E01033742","E02000319","Greenwich 007","E09000011","Greenwich","E12000007","London",1352,1352,0,107.6,581,2.3,NA,NA,NA,NA,NA,NA,NA,17931,15882,24684,24959,NA,NA,NA,NA
"1585","Greenwich 002H","E01033743","E02000314","Greenwich 002","E09000011","Greenwich","E12000007","London",2038,2038,0,20.4,663,3.1,NA,NA,NA,NA,NA,NA,NA,9683,8069,15731,25136,NA,NA,NA,NA
"1615","Greenwich 007G","E01033744","E02000319","Greenwich 007","E09000011","Greenwich","E12000007","London",1845,1728,117,125.8,646,2.7,NA,NA,NA,NA,NA,NA,NA,7824,7499,9029,11010,NA,NA,NA,NA
"1586","Greenwich 002I","E01033745","E02000314","Greenwich 002","E09000011","Greenwich","E12000007","London",1820,1820,0,32.3,591,3.1,NA,NA,NA,NA,NA,NA,NA,12163,8161,12814,23221,NA,NA,NA,NA
"1726","Greenwich 038E","E01033746","E02006931","Greenwich 038","E09000011","Greenwich","E12000007","London",1464,1436,28,115.3,715,2,NA,NA,NA,NA,NA,NA,NA,12540,13149,16780,28754,NA,NA,NA,NA
